date,home_team,away_team,home_score,away_score,tournament,city,country,neutral,home_rank,home_rank_pts,away_rank,away_rank_pts,rank_diff,rank_pts_diff,outcome,outcome_num,home_game,away_game
2010-05-26 00:00:00.000000,Hungary,Italy,6,1,Friendly,Budapest,Hungary,0,57,565,5,1184,52,-619,W,0,1,0
2010-05-27 00:00:00.000000,Argentina,Chile,3,1,Friendly,Buenos Aires,Argentina,0,7,1076,18,888,-11,188,W,0,1,0
2010-05-29 00:00:00.000000,Chile,Uruguay,0,3,Friendly,Buenos Aires,Argentina,1,18,888,16,899,2,-11,L,2,0,0
2010-06-05 00:00:00.000000,Argentina,Chile,5,1,Friendly,Buenos Aires,Argentina,0,7,1076,18,888,-11,188,W,0,1,0
2010-06-12 00:00:00.000000,Argentina,Uruguay,4,1,Friendly,Buenos Aires,Argentina,0,7,1076,16,899,-9,177,W,0,1,0
2010-08-15 00:00:00.000000,Uruguay,Argentina,3,1,Copa Lipton,Montevideo,Uruguay,0,6,1152,5,1288,1,-136,W,0,1,0
2010-09-11 00:00:00.000000,Chile,Argentina,0,3,Friendly,Viña del Mar,Chile,0,10,988,5,1288,5,-300,L,2,1,0
2010-09-11 00:00:00.000000,Norway,Sweden,0,4,Friendly,Kristiania,Norway,0,22,878,35,747,-13,131,L,2,1,0
2010-10-16 00:00:00.000000,Germany,Netherlands,1,2,Friendly,Kleve,Germany,0,4,1464,2,1659,2,-195,L,2,1,0
2010-11-06 00:00:00.000000,Hungary,Austria,3,0,Friendly,Budapest,Hungary,0,62,534,60,536,2,-2,W,0,1,0
2010-11-13 00:00:00.000000,Argentina,Uruguay,1,1,Copa Premio Honor Argentino,Buenos Aires,Argentina,0,5,1288,6,1152,-1,136,D,1,1,0
2010-11-27 00:00:00.000000,Argentina,Uruguay,2,6,Copa Premio Honor Argentino,Buenos Aires,Argentina,0,5,1353,7,1174,-2,179,L,2,1,0
2011-01-01 00:00:00.000000,France,Hungary,0,3,Friendly,Maisons-Alfort,France,0,21,852,43,615,-22,237,L,2,1,0
2011-01-06 00:00:00.000000,Italy,Hungary,0,1,Friendly,Milan,Italy,0,14,995,43,615,-29,380,L,2,1,0
2011-01-08 00:00:00.000000,Switzerland,Hungary,2,0,Friendly,Zürich,Switzerland,0,21,852,43,615,-22,237,W,0,1,0
2011-01-28 00:00:00.000000,Northern Ireland,Wales,1,2,British Championship,Belfast,Ireland,0,43,615,113,261,-70,354,L,2,0,0
2011-02-11 00:00:00.000000,England,Northern Ireland,2,1,British Championship,Derby,England,0,6,1195,43,615,-37,580,W,0,1,0
2011-03-06 00:00:00.000000,Wales,Scotland,2,2,British Championship,Cardiff,Wales,0,113,261,52,542,61,-281,D,1,1,0
2011-03-13 00:00:00.000000,England,Wales,3,0,British Championship,London,England,0,6,1195,113,261,-107,934,W,0,1,0
2011-03-18 00:00:00.000000,Scotland,Northern Ireland,2,0,British Championship,Glasgow,Scotland,0,52,542,43,615,9,-73,W,0,1,0
2011-03-19 00:00:00.000000,Belgium,Netherlands,1,5,Friendly,Antwerp,Belgium,0,58,526,2,1723,56,-1197,L,2,1,0
2011-03-26 00:00:00.000000,Germany,Switzerland,6,2,Friendly,Stuttgart,Germany,0,3,1485,22,841,-19,644,W,0,1,0
2011-04-01 00:00:00.000000,England,Scotland,1,1,British Championship,Liverpool,England,0,6,1195,52,542,-46,653,D,1,1,0
2011-04-02 00:00:00.000000,Netherlands,Belgium,3,1,Friendly,Dordrecht,Netherlands,0,2,1723,58,526,-56,1197,W,0,1,0
2011-04-09 00:00:00.000000,France,Italy,2,2,Friendly,Saint-Ouen,France,0,18,867,14,965,4,-98,D,1,1,0
2011-04-23 00:00:00.000000,Belgium,Germany,2,1,Friendly,Liège,Belgium,0,58,526,3,1485,55,-959,W,0,1,0
2011-04-23 00:00:00.000000,Switzerland,France,5,2,Friendly,Geneva,Switzerland,0,22,841,18,867,4,-26,W,0,1,0
2011-04-30 00:00:00.000000,Belgium,France,7,1,Friendly,Uccle,Belgium,0,58,526,18,867,40,-341,W,0,1,0
2011-05-07 00:00:00.000000,Austria,Hungary,3,1,Friendly,Vienna,Austria,0,46,569,41,632,5,-63,W,0,1,0
2011-05-07 00:00:00.000000,Italy,Switzerland,2,2,Friendly,Milan,Italy,0,14,965,22,841,-8,124,D,1,1,0
2011-05-21 00:00:00.000000,Switzerland,Italy,3,0,Friendly,La Chaux-de-Fonds,Switzerland,0,25,819,9,1019,16,-200,W,0,1,0
2011-06-18 00:00:00.000000,Sweden,Germany,2,4,Friendly,Solna,Sweden,0,28,802,4,1413,24,-611,L,2,1,0
2011-08-15 00:00:00.000000,Argentina,Uruguay,0,2,Copa Lipton,Buenos Aires,Argentina,0,5,1267,7,1094,-2,173,L,2,1,0
2011-09-17 00:00:00.000000,Sweden,Norway,4,1,Friendly,Solna,Sweden,0,18,889,12,943,6,-54,W,0,1,0
2011-09-17 00:00:00.000000,Uruguay,Argentina,2,3,Copa Newton,Montevideo,Uruguay,0,5,1174,9,1017,-4,157,L,2,1,0
2011-10-08 00:00:00.000000,Uruguay,Argentina,1,1,Copa Premio Honor Uruguayo,Montevideo,Uruguay,0,4,1184,10,1024,-6,160,D,1,1,0
2011-10-09 00:00:00.000000,Germany,Austria,1,2,Friendly,Dresden,Germany,0,3,1290,77,442,-74,848,L,2,1,0
2011-10-22 00:00:00.000000,Argentina,Uruguay,2,0,Copa Premio Honor Argentino,Buenos Aires,Argentina,0,10,1030,4,1230,6,-200,W,0,1,0
2011-10-22 00:00:00.000000,Finland,Sweden,2,5,Friendly,Helsinki,Finland,0,78,438,14,955,64,-517,L,2,1,0
2011-10-29 00:00:00.000000,Germany,Sweden,1,3,Friendly,Hamburg,Germany,0,3,1352,14,955,-11,397,L,2,1,0
2011-10-29 00:00:00.000000,Hungary,Switzerland,9,0,Friendly,Budapest,Hungary,0,36,701,18,920,18,-219,W,0,1,0
2011-10-29 00:00:00.000000,Luxembourg,France,1,4,Friendly,Luxembourg,Luxembourg,0,118,263,15,953,103,-690,L,2,1,0
2011-10-29 00:00:00.000000,Uruguay,Argentina,3,0,Copa Premio Honor Uruguayo,Montevideo,Uruguay,0,4,1230,10,1030,-6,200,W,0,1,0
2011-11-05 00:00:00.000000,Hungary,Austria,2,0,Friendly,Budapest,Hungary,0,36,701,72,458,-36,243,W,0,1,0
2011-12-17 00:00:00.000000,Germany,Hungary,1,4,Friendly,Munich,Germany,0,3,1345,37,665,-34,680,L,2,1,0
2012-01-28 00:00:00.000000,France,Belgium,1,1,Friendly,Saint-Ouen,France,0,15,915,40,647,-25,268,D,1,1,0
2012-02-10 00:00:00.000000,Northern Ireland,England,1,6,British Championship,Dublin,Ireland,0,87,403,5,1173,82,-770,L,2,0,0
2012-02-18 00:00:00.000000,France,Switzerland,4,1,Friendly,Saint-Ouen,France,0,17,930,16,950,1,-20,W,0,1,0
2012-02-20 00:00:00.000000,Belgium,Switzerland,9,2,Friendly,Antwerp,Belgium,0,39,663,16,950,23,-287,W,0,1,0
2012-03-02 00:00:00.000000,Scotland,Wales,1,0,British Championship,Edinburgh,Scotland,0,48,602,42,635,6,-33,W,0,1,0
2012-03-10 00:00:00.000000,Belgium,Netherlands,1,2,Friendly,Antwerp,Belgium,0,40,642,2,1379,38,-737,L,2,1,0
2012-03-11 00:00:00.000000,Wales,England,0,2,British Championship,Wrexham,Wales,0,48,580,6,1121,42,-541,L,2,1,0
2012-03-16 00:00:00.000000,Northern Ireland,Scotland,1,4,British Championship,Belfast,Ireland,0,87,400,51,574,36,-174,L,2,0,0
2012-03-17 00:00:00.000000,Italy,France,3,4,Friendly,Turin,Italy,0,9,1062,16,938,-7,124,L,2,1,0
2012-03-23 00:00:00.000000,Scotland,England,1,1,British Championship,Glasgow,Scotland,0,51,574,6,1121,45,-547,D,1,1,0
2012-03-24 00:00:00.000000,Netherlands,Germany,5,5,Friendly,Zwolle,Netherlands,0,2,1379,3,1332,-1,47,D,1,1,0
2012-04-13 00:00:00.000000,Wales,Northern Ireland,2,3,British Championship,Cardiff,Wales,0,41,635,100,338,-59,297,L,2,1,0
2012-04-14 00:00:00.000000,Hungary,Germany,4,4,Friendly,Budapest,Hungary,0,36,692,2,1345,34,-653,D,1,1,0
2012-04-28 00:00:00.000000,Netherlands,Belgium,4,3,Friendly,Dordrecht,Netherlands,0,4,1207,44,604,-40,603,W,0,1,0
2012-05-05 00:00:00.000000,Austria,Hungary,1,1,Friendly,Vienna,Austria,0,73,475,36,692,37,-217,D,1,1,0
2012-05-05 00:00:00.000000,Switzerland,Germany,1,2,Friendly,St. Gallen,Switzerland,0,18,891,2,1345,16,-454,L,2,1,0
2012-06-16 00:00:00.000000,Norway,Sweden,1,2,Friendly,Kristiania,Norway,0,26,787,17,910,9,-123,L,2,1,0
2012-06-20 00:00:00.000000,Sweden,Hungary,2,2,Friendly,Gothenburg,Sweden,0,17,910,31,735,-14,175,D,1,1,0
2012-06-23 00:00:00.000000,Norway,Hungary,0,6,Friendly,Kristiania,Norway,0,26,787,31,735,-5,52,L,2,1,0
2012-06-27 00:00:00.000000,Sweden,Finland,7,1,Friendly,Solna,Sweden,0,17,910,75,464,-58,446,W,0,1,0
2012-07-12 00:00:00.000000,Russia,Hungary,0,9,Friendly,Moscow,Russia,0,13,981,31,716,-18,265,L,2,1,0
2012-07-14 00:00:00.000000,Russia,Hungary,0,12,Friendly,Moscow,Russia,0,13,981,31,716,-18,265,L,2,1,0
2012-08-15 00:00:00.000000,Uruguay,Argentina,2,0,Copa Lipton,Montevideo,Uruguay,0,4,1236,7,1098,-3,138,W,0,1,0
2012-08-25 00:00:00.000000,Uruguay,Argentina,3,0,Copa Premio Honor Uruguayo,Montevideo,Uruguay,0,4,1236,7,1098,-3,138,W,0,1,0
2012-09-22 00:00:00.000000,Argentina,Uruguay,0,1,Copa Premio Honor Argentino,Buenos Aires,Argentina,0,7,1121,5,1217,2,-96,L,2,1,0
2012-10-06 00:00:00.000000,Argentina,Uruguay,3,3,Copa Newton,Avellaneda,Argentina,0,4,1208,7,1140,-3,68,D,1,1,0
2012-10-06 00:00:00.000000,Denmark,Germany,3,1,Friendly,Copenhagen,Denmark,0,18,944,2,1459,16,-515,W,0,1,0
2012-11-03 00:00:00.000000,Hungary,Austria,4,0,Friendly,Budapest,Hungary,0,49,593,59,528,-10,65,W,0,1,0
2012-11-03 00:00:00.000000,Sweden,Norway,4,2,Friendly,Gothenburg,Sweden,0,21,859,26,764,-5,95,W,0,1,0
2012-11-17 00:00:00.000000,Germany,Netherlands,2,3,Friendly,Leipzig,Germany,0,2,1421,7,1128,-5,293,L,2,1,0
2012-12-01 00:00:00.000000,Uruguay,Argentina,1,3,Friendly,Montevideo,Uruguay,0,11,1047,3,1349,8,-302,L,2,1,0
2012-12-22 00:00:00.000000,Italy,Austria,1,3,Friendly,Genoa,Italy,0,4,1165,70,492,-66,673,L,2,1,0
2013-01-12 00:00:00.000000,France,Italy,1,0,Friendly,Saint-Ouen,France,0,17,949,4,1165,13,-216,W,0,1,0
2013-01-18 00:00:00.000000,Northern Ireland,Wales,0,1,British Championship,Belfast,Ireland,0,98,367,81,435,17,-68,L,2,0,0
2013-02-15 00:00:00.000000,Northern Ireland,England,2,1,British Championship,Belfast,Ireland,0,102,354,4,1160,98,-806,W,0,0,0
2013-02-16 00:00:00.000000,Belgium,France,3,0,Friendly,Brussels,Belgium,0,20,864,17,929,3,-65,W,0,1,0
2013-03-03 00:00:00.000000,Wales,Scotland,0,0,British Championship,Wrexham,Wales,0,68,493,64,511,4,-18,D,1,1,0
2013-03-09 00:00:00.000000,Belgium,Netherlands,3,3,Friendly,Antwerp,Belgium,0,20,864,8,1108,12,-244,D,1,1,0
2013-03-09 00:00:00.000000,Switzerland,France,1,4,Friendly,Geneva,Switzerland,0,14,993,17,929,-3,64,L,2,1,0
2013-03-15 00:00:00.000000,Northern Ireland,Scotland,1,2,British Championship,Dublin,Ireland,0,97,367,66,501,31,-134,L,2,0,0
2013-03-17 00:00:00.000000,England,Wales,4,3,British Championship,Bristol,England,0,4,1174,71,491,-67,683,W,0,1,0
2013-04-05 00:00:00.000000,England,Scotland,1,0,British Championship,London,England,0,4,1174,66,501,-62,673,W,0,1,0
2013-04-20 00:00:00.000000,France,Luxembourg,8,0,Friendly,Saint-Ouen,France,0,18,914,147,182,-129,732,W,0,1,0
2013-04-20 00:00:00.000000,Netherlands,Belgium,2,4,Friendly,Zwolle,Netherlands,0,9,1093,16,953,-7,140,L,2,1,0
2013-04-27 00:00:00.000000,Austria,Hungary,1,4,Friendly,Vienna,Austria,0,71,472,33,749,38,-277,L,2,1,0
2013-05-01 00:00:00.000000,Italy,Belgium,1,0,Friendly,Turin,Italy,0,8,1117,16,953,-8,164,W,0,1,0
2013-05-04 00:00:00.000000,Russia,Sweden,1,4,Friendly,Moscow,Russia,0,11,1052,24,838,-13,214,L,2,1,0
2013-05-04 00:00:00.000000,Switzerland,Belgium,1,2,Friendly,Basel,Switzerland,0,15,967,16,953,-1,14,L,2,1,0
2013-05-18 00:00:00.000000,Germany,Switzerland,1,2,Friendly,Freiburg,Germany,0,2,1428,14,967,-12,461,L,2,1,0
2013-05-18 00:00:00.000000,Hungary,Sweden,2,0,Friendly,Budapest,Hungary,0,33,749,24,838,9,-89,W,0,1,0
2013-05-25 00:00:00.000000,Denmark,Sweden,8,0,Friendly,Copenhagen,Denmark,0,20,900,24,838,-4,62,W,0,1,0
2013-06-08 00:00:00.000000,Sweden,Norway,9,0,Friendly,Stockholm,Sweden,0,27,830,29,794,-2,36,W,0,1,0
2013-06-15 00:00:00.000000,Argentina,Uruguay,1,1,Friendly,Avellaneda,Argentina,0,3,1287,19,913,-16,374,D,1,1,0
2013-06-15 00:00:00.000000,Austria,Italy,2,0,Friendly,Vienna,Austria,0,76,469,8,1097,68,-628,W,0,1,0
2013-07-09 00:00:00.000000,Argentina,Uruguay,2,1,Friendly,Avellaneda,Argentina,0,4,1204,12,1016,-8,188,W,0,1,0
2013-08-15 00:00:00.000000,Argentina,Uruguay,4,0,Copa Lipton,Avellaneda,Argentina,0,4,1210,12,998,-8,212,W,0,1,0
2013-08-31 00:00:00.000000,Argentina,Uruguay,2,0,Copa Premio Honor Argentino,Buenos Aires,Argentina,0,4,1210,12,998,-8,212,W,0,1,0
2013-09-14 00:00:00.000000,Russia,Norway,1,1,Friendly,Moscow,Russia,0,15,968,40,699,-25,269,D,1,1,0
2013-09-21 00:00:00.000000,Chile,Argentina,0,2,Friendly,Viña del Mar,Chile,0,16,967,2,1263,14,-296,L,2,1,0
2013-10-05 00:00:00.000000,Sweden,Denmark,0,10,Friendly,Stockholm,Sweden,0,22,836,23,825,-1,11,L,2,1,0
2013-10-05 00:00:00.000000,Uruguay,Argentina,1,0,Copa Premio Honor Uruguayo,Montevideo,Uruguay,0,7,1126,2,1263,5,-137,W,0,1,0
2013-10-26 00:00:00.000000,Germany,Denmark,1,4,Friendly,Hamburg,Germany,0,2,1311,26,824,-24,487,L,2,1,0
2013-10-26 00:00:00.000000,Hungary,Austria,4,3,Friendly,Budapest,Hungary,0,43,636,53,596,-10,40,W,0,1,0
2013-10-26 00:00:00.000000,Norway,Sweden,1,1,Friendly,Kristiania,Norway,0,47,632,25,850,22,-218,D,1,1,0
2013-10-26 00:00:00.000000,Uruguay,Argentina,1,0,Copa Newton,Montevideo,Uruguay,0,6,1164,3,1266,3,-102,W,0,1,0
2013-11-02 00:00:00.000000,Belgium,Switzerland,2,0,Friendly,Verviers,Belgium,0,5,1175,7,1138,-2,37,W,0,1,0
2013-11-23 00:00:00.000000,Belgium,Germany,6,2,Friendly,Antwerp,Belgium,0,5,1175,2,1311,3,-136,W,0,1,0
2014-01-11 00:00:00.000000,Italy,Austria,0,0,Friendly,Milan,Italy,0,7,1120,46,648,-39,472,D,1,1,0
2014-01-19 00:00:00.000000,Wales,Northern Ireland,1,2,British Championship,Wrexham,Wales,0,55,574,90,381,-35,193,L,2,1,0
2014-01-25 00:00:00.000000,France,Belgium,4,3,Friendly,Lille,France,0,20,893,11,1098,9,-205,W,0,1,0
2014-02-08 00:00:00.000000,Luxembourg,France,5,4,Friendly,Luxembourg,Luxembourg,0,122,243,20,893,102,-650,W,0,1,0
2014-02-14 00:00:00.000000,England,Northern Ireland,0,3,British Championship,Middlesbrough,England,0,15,1032,85,397,-70,635,L,2,1,0
2014-02-28 00:00:00.000000,Scotland,Wales,0,0,British Championship,Glasgow,Scotland,0,34,742,51,598,-17,144,D,1,1,0
2014-03-08 00:00:00.000000,France,Switzerland,2,2,Friendly,Saint-Ouen,France,0,18,917,6,1159,12,-242,D,1,1,0
2014-03-14 00:00:00.000000,Northern Ireland,Scotland,1,1,British Championship,Belfast,Ireland,0,86,388,37,721,49,-333,D,1,0,0
2014-03-15 00:00:00.000000,Belgium,Netherlands,2,4,Friendly,Antwerp,Belgium,0,10,1084,11,1077,-1,7,L,2,1,0
2014-03-16 00:00:00.000000,Wales,England,0,2,British Championship,Cardiff,Wales,0,49,609,12,1045,37,-436,L,2,1,0
2014-03-29 00:00:00.000000,Italy,France,2,0,Friendly,Turin,Italy,0,8,1112,17,929,-9,183,W,0,1,0
2014-04-05 00:00:00.000000,Italy,Switzerland,1,1,Friendly,Genoa,Italy,0,8,1112,7,1123,1,-11,D,1,1,0
2014-04-05 00:00:00.000000,Netherlands,Germany,4,4,Friendly,Amsterdam,Netherlands,0,11,1077,2,1336,9,-259,D,1,1,0
2014-04-26 00:00:00.000000,Netherlands,Belgium,4,2,Friendly,Amsterdam,Netherlands,0,15,967,12,1039,3,-72,W,0,1,0
2014-05-03 00:00:00.000000,Austria,Hungary,2,0,Friendly,Vienna,Austria,0,40,673,44,623,-4,50,W,0,1,0
2014-05-17 00:00:00.000000,Denmark,Netherlands,4,3,Friendly,Copenhagen,Denmark,0,23,819,15,967,8,-148,W,0,1,0
2014-05-17 00:00:00.000000,Switzerland,Italy,0,1,Friendly,Berne,Switzerland,0,8,1161,9,1115,-1,46,L,2,1,0
2014-05-24 00:00:00.000000,Sweden,Finland,4,3,Friendly,Solna,Sweden,0,25,795,52,578,-27,217,W,0,1,0
2014-05-31 00:00:00.000000,Hungary,France,5,1,Friendly,Budapest,Hungary,0,45,623,16,935,29,-312,W,0,1,0
2014-06-21 00:00:00.000000,Sweden,Hungary,1,1,Friendly,Solna,Sweden,0,32,741,47,624,-15,117,D,1,1,0
2014-06-28 00:00:00.000000,Norway,Sweden,0,1,Friendly,Kristiania,Norway,0,55,562,32,741,23,-179,L,2,1,0
2014-07-05 00:00:00.000000,Sweden,Russia,2,2,Friendly,Solna,Sweden,0,32,741,19,893,13,-152,D,1,1,0
2014-07-12 00:00:00.000000,Norway,Russia,1,1,Friendly,Kristiania,Norway,0,55,562,19,893,36,-331,D,1,1,0
2014-08-30 00:00:00.000000,Uruguay,Argentina,3,2,Copa Premio Honor Uruguayo,Montevideo,Uruguay,0,6,1316,2,1604,4,-288,W,0,1,0
2014-09-13 00:00:00.000000,Argentina,Uruguay,2,1,Copa Premio Honor Argentino,Buenos Aires,Argentina,0,2,1604,6,1316,-4,288,W,0,1,0
2014-09-20 00:00:00.000000,Argentina,Brazil,3,0,Friendly,Buenos Aires,Argentina,0,2,1631,6,1291,-4,340,W,0,1,0
2014-09-27 00:00:00.000000,Argentina,Brazil,0,1,Copa Roca,Buenos Aires,Argentina,0,2,1631,6,1291,-4,340,L,2,1,0
2014-10-04 00:00:00.000000,Hungary,Austria,2,2,Friendly,Budapest,Hungary,0,54,548,39,622,15,-74,D,1,1,0
2014-10-25 00:00:00.000000,Sweden,Norway,7,0,Friendly,Solna,Sweden,0,39,646,68,481,-29,165,W,0,1,0
2014-11-08 00:00:00.000000,Austria,Hungary,1,2,Friendly,Vienna,Austria,0,29,810,50,561,-21,249,L,2,1,0
2015-01-31 00:00:00.000000,Italy,Switzerland,3,1,Friendly,Turin,Italy,0,11,1103,12,1091,-1,12,W,0,1,0
2015-05-02 00:00:00.000000,Hungary,Austria,2,5,Friendly,Budapest,Hungary,0,43,665,25,891,18,-226,L,2,1,0
2015-05-30 00:00:00.000000,Austria,Hungary,1,2,Friendly,Vienna,Austria,0,25,891,43,665,-18,226,L,2,1,0
2015-06-06 00:00:00.000000,Denmark,Sweden,2,0,Friendly,Copenhagen,Denmark,0,29,808,39,737,-10,71,W,0,1,0
2015-06-27 00:00:00.000000,Norway,Sweden,1,1,Friendly,Kristiania,Norway,0,64,528,39,737,25,-209,D,1,1,0
2015-07-18 00:00:00.000000,Uruguay,Argentina,2,3,Copa Premio Honor Uruguayo,Montevideo,Uruguay,0,13,1036,1,1473,12,-437,L,2,1,0
2015-08-15 00:00:00.000000,Argentina,Uruguay,2,1,Copa Lipton,Buenos Aires,Argentina,0,1,1425,18,988,-17,437,W,0,1,0
2015-09-12 00:00:00.000000,Uruguay,Argentina,2,0,Copa Newton,Montevideo,Uruguay,0,18,1002,1,1442,17,-440,W,0,1,0
2015-09-19 00:00:00.000000,Denmark,Norway,8,1,Friendly,Copenhagen,Denmark,0,22,901,69,496,-47,405,W,0,1,0
2015-10-03 00:00:00.000000,Austria,Hungary,4,2,Friendly,Vienna,Austria,0,11,1100,33,741,-22,359,W,0,1,0
2015-10-24 00:00:00.000000,Sweden,Norway,5,2,Friendly,Stockholm,Sweden,0,45,672,34,739,11,-67,W,0,1,0
2015-10-31 00:00:00.000000,Sweden,Denmark,0,2,Friendly,Stockholm,Sweden,0,45,672,28,835,17,-163,L,2,1,0
2015-11-07 00:00:00.000000,Hungary,Austria,6,2,Friendly,Budapest,Hungary,0,33,759,10,1130,23,-371,W,0,1,0
2016-05-07 00:00:00.000000,Austria,Hungary,3,1,Friendly,Vienna,Austria,0,11,1067,18,925,-7,142,W,0,1,0
2016-06-04 00:00:00.000000,Denmark,Sweden,2,0,Friendly,Copenhagen,Denmark,0,38,697,35,735,3,-38,W,0,1,0
2016-06-04 00:00:00.000000,Hungary,Austria,2,1,Friendly,Budapest,Hungary,0,20,886,10,1077,10,-191,W,0,1,0
2016-06-25 00:00:00.000000,Norway,Denmark,0,2,Friendly,Kristiania,Norway,0,51,593,38,697,13,-104,L,2,1,0
2016-07-02 00:00:00.000000,Chile,Uruguay,0,4,Copa América,Buenos Aires,Argentina,1,5,1293,9,1150,-4,143,L,2,0,0
2016-07-02 00:00:00.000000,Sweden,Norway,6,0,Friendly,Stockholm,Sweden,0,35,735,51,593,-16,142,W,0,1,0
2016-07-06 00:00:00.000000,Argentina,Chile,6,1,Copa América,Buenos Aires,Argentina,0,1,1503,5,1293,-4,210,W,0,1,0
2016-07-08 00:00:00.000000,Brazil,Chile,1,1,Copa América,Buenos Aires,Argentina,1,7,1257,5,1293,2,-36,D,1,0,0
2016-07-10 00:00:00.000000,Argentina,Brazil,1,1,Copa América,Buenos Aires,Argentina,0,1,1503,7,1257,-6,246,D,1,1,0
2016-07-12 00:00:00.000000,Argentina,Chile,1,0,Friendly,Buenos Aires,Argentina,0,1,1503,5,1293,-4,210,W,0,1,0
2016-07-12 00:00:00.000000,Brazil,Uruguay,1,2,Copa América,Buenos Aires,Argentina,1,7,1257,9,1150,-2,107,L,2,0,0
2016-07-14 00:00:00.000000,Uruguay,Chile,4,1,Friendly,Montevideo,Uruguay,0,12,1130,5,1316,7,-186,W,0,1,0
2016-07-17 00:00:00.000000,Argentina,Uruguay,0,0,Copa América,Avellaneda,Argentina,0,1,1585,12,1130,-11,455,D,1,1,0
2016-07-18 00:00:00.000000,Uruguay,Brazil,0,1,Friendly,Montevideo,Uruguay,0,12,1130,9,1156,3,-26,L,2,1,0
2016-08-15 00:00:00.000000,Argentina,Uruguay,3,1,Copa Newton,Avellaneda,Argentina,0,1,1585,12,1130,-11,455,W,0,1,0
2016-08-15 00:00:00.000000,Uruguay,Argentina,1,2,Copa Lipton,Montevideo,Uruguay,0,12,1130,1,1585,11,-455,L,2,1,0
2016-08-20 00:00:00.000000,Sweden,USA,2,3,Friendly,Stockholm,Sweden,0,40,656,26,848,14,-192,L,2,1,0
2016-09-03 00:00:00.000000,Norway,USA,1,1,Friendly,Kristiania,Norway,0,50,588,26,848,24,-260,D,1,1,0
2016-10-01 00:00:00.000000,Argentina,Uruguay,7,2,Friendly,Avellaneda,Argentina,0,1,1646,9,1173,-8,473,W,0,1,0
2016-10-01 00:00:00.000000,Hungary,Austria,2,3,Friendly,Budapest,Hungary,0,20,913,26,839,-6,74,L,2,1,0
2016-10-01 00:00:00.000000,Norway,Sweden,0,0,Friendly,Kristiania,Norway,0,70,487,41,677,29,-190,D,1,1,0
2016-10-01 00:00:00.000000,Uruguay,Argentina,0,1,Copa Premio Honor Uruguayo,Montevideo,Uruguay,0,9,1173,1,1646,8,-473,L,2,1,0
2016-10-08 00:00:00.000000,Sweden,Denmark,4,0,Friendly,Stockholm,Sweden,0,41,677,46,637,-5,40,W,0,1,0
2016-10-15 00:00:00.000000,Denmark,Norway,8,0,Friendly,Copenhagen,Denmark,0,46,637,70,487,-24,150,W,0,1,0
2016-10-29 00:00:00.000000,Uruguay,Argentina,3,1,Friendly,Montevideo,Uruguay,0,9,1175,1,1621,8,-446,W,0,1,0
2016-11-05 00:00:00.000000,Austria,Hungary,3,3,Friendly,Vienna,Austria,0,30,792,22,891,8,-99,D,1,1,0
2017-05-06 00:00:00.000000,Austria,Hungary,1,1,Friendly,Vienna,Austria,0,30,792,22,891,8,-99,D,1,1,0
2017-05-07 00:00:00.000000,Japan,Philippines,2,15,Friendly,Tokyo,Japan,0,51,601,124,271,-73,330,L,2,1,0
2017-06-03 00:00:00.000000,Denmark,Sweden,1,1,Friendly,Copenhagen,Denmark,0,50,606,39,715,11,-109,D,1,1,0
2017-06-03 00:00:00.000000,Hungary,Austria,6,2,Friendly,Budapest,Hungary,0,22,891,30,792,-8,99,W,0,1,0
2017-06-17 00:00:00.000000,Norway,Denmark,1,2,Friendly,Kristiania,Norway,0,81,438,50,606,31,-168,L,2,1,0
2017-07-15 00:00:00.000000,Austria,Hungary,1,4,Friendly,Vienna,Austria,0,37,723,57,616,-20,107,L,2,1,0
2017-07-18 00:00:00.000000,Uruguay,Argentina,0,2,Copa Premio Honor Uruguayo,Montevideo,Uruguay,0,17,995,3,1413,14,-418,L,2,1,0
2017-08-15 00:00:00.000000,Argentina,Uruguay,1,0,Copa Lipton,Avellaneda,Argentina,0,3,1399,17,995,-14,404,W,0,1,0
2017-08-19 00:00:00.000000,Sweden,Norway,3,3,Friendly,Helsingborg,Sweden,0,19,933,85,391,-66,542,D,1,1,0
2017-09-02 00:00:00.000000,Uruguay,Argentina,1,0,Copa Newton,Montevideo,Uruguay,0,17,995,3,1399,14,-404,W,0,1,0
2017-09-16 00:00:00.000000,Norway,Sweden,0,2,Friendly,Kristiania,Norway,0,73,472,23,918,50,-446,L,2,1,0
2017-09-30 00:00:00.000000,Uruguay,Chile,4,0,Copa América,Montevideo,Uruguay,0,16,1043,9,1195,7,-152,W,0,1,0
2017-10-03 00:00:00.000000,Argentina,Brazil,4,2,Copa América,Montevideo,Uruguay,1,4,1325,2,1590,2,-265,W,0,0,0
2017-10-06 00:00:00.000000,Argentina,Chile,1,0,Copa América,Montevideo,Uruguay,1,4,1325,9,1195,-5,130,W,0,0,0
2017-10-07 00:00:00.000000,Denmark,Norway,12,0,Friendly,Copenhagen,Denmark,0,26,848,73,472,-47,376,W,0,1,0
2017-10-07 00:00:00.000000,Hungary,Austria,2,1,Friendly,Budapest,Hungary,0,59,629,57,632,2,-3,W,0,1,0
2017-10-07 00:00:00.000000,Uruguay,Brazil,4,0,Copa América,Montevideo,Uruguay,0,16,1043,2,1590,14,-547,W,0,1,0
2017-10-12 00:00:00.000000,Brazil,Chile,5,0,Copa América,Montevideo,Uruguay,1,2,1590,9,1195,-7,395,W,0,0,0
2017-10-14 00:00:00.000000,Sweden,Denmark,1,2,Friendly,Stockholm,Sweden,0,23,918,26,848,-3,70,L,2,1,0
2017-10-14 00:00:00.000000,Uruguay,Argentina,1,0,Copa América,Montevideo,Uruguay,0,16,1043,4,1325,12,-282,W,0,1,0
2017-10-16 00:00:00.000000,Uruguay,Brazil,3,1,Friendly,Montevideo,Uruguay,0,17,1034,2,1619,15,-585,W,0,1,0
2017-11-04 00:00:00.000000,Austria,Hungary,1,2,Friendly,Vienna,Austria,0,39,745,53,642,-14,103,L,2,1,0
2017-12-23 00:00:00.000000,Switzerland,Austria,0,1,Friendly,Basel,Switzerland,0,8,1190,29,815,-21,375,L,2,1,0
2017-12-26 00:00:00.000000,Switzerland,Austria,3,2,Friendly,Zürich,Switzerland,0,8,1190,29,815,-21,375,W,0,1,0
2018-04-14 00:00:00.000000,Hungary,Austria,2,0,Friendly,Budapest,Hungary,0,50,604,26,841,24,-237,W,0,1,0
2018-05-09 00:00:00.000000,Austria,Switzerland,5,1,Friendly,Vienna,Austria,0,26,841,6,1179,20,-338,W,0,1,0
2018-05-12 00:00:00.000000,Hungary,Switzerland,2,1,Friendly,Budapest,Hungary,0,50,604,6,1179,44,-575,W,0,1,0
2018-05-26 00:00:00.000000,Sweden,Norway,2,0,Friendly,Stockholm,Sweden,0,23,889,48,608,-25,281,W,0,1,0
2018-06-02 00:00:00.000000,Austria,Hungary,0,2,Friendly,Vienna,Austria,0,26,841,49,604,-23,237,L,2,1,0
2018-06-02 00:00:00.000000,Denmark,Sweden,3,0,Friendly,Copenhagen,Denmark,0,12,1054,23,889,-11,165,W,0,1,0
2010-05-26 00:00:00.000000,Azerbaijan,Moldova,1,1,Friendly,Seekirchen am Wallersee,Austria,1,109,259,89,378,20,-119,D,1,0,0
2010-05-26 00:00:00.000000,Chile,Zambia,3,0,Friendly,Calama,Chile,0,18,888,71,456,-53,432,W,0,1,0
2010-05-26 00:00:00.000000,Estonia,Croatia,0,0,Friendly,Tallinn,Estonia,0,99,320,10,1041,89,-721,D,1,1,0
2010-05-26 00:00:00.000000,France,Costa Rica,2,1,Friendly,Lens,France,0,9,1044,40,710,-31,334,W,0,1,0
2010-05-26 00:00:00.000000,Netherlands,Mexico,2,1,Friendly,Freiburg,Germany,1,4,1231,17,895,-13,336,W,0,0,0
2010-05-26 00:00:00.000000,Northern Ireland,Turkey,0,2,Friendly,New Britain,USA,1,56,566,29,830,27,-264,L,2,0,0
2010-05-26 00:00:00.000000,Uruguay,Israel,4,1,Friendly,Montevideo,Uruguay,0,16,899,26,857,-10,42,W,0,1,0
2010-05-27 00:00:00.000000,Belarus,Honduras,2,2,Friendly,Villach,Austria,1,82,397,38,734,44,-337,D,1,0,0
2010-05-27 00:00:00.000000,Denmark,Senegal,2,0,Friendly,Aalborg,Denmark,0,36,767,75,422,-39,345,W,0,1,0
2010-05-27 00:00:00.000000,South Africa,Colombia,2,1,Friendly,Johannesburg,South Africa,0,83,392,35,776,48,-384,W,0,1,0
2010-05-29 00:00:00.000000,Hungary,Germany,0,3,Friendly,Budapest,Hungary,0,57,565,6,1082,51,-517,L,2,1,0
2010-05-29 00:00:00.000000,Iceland,Andorra,4,0,Friendly,Reykjavík,Iceland,0,90,367,201,2,-111,365,W,0,1,0
2010-05-29 00:00:00.000000,Moldova,United Arab Emirates,2,3,Friendly,Anif,Austria,1,89,378,101,310,-12,68,L,2,0,0
2010-05-29 00:00:00.000000,New Zealand,Serbia,1,0,Friendly,Klagenfurt,Austria,1,78,410,15,947,63,-537,W,0,0,0
2010-05-29 00:00:00.000000,Norway,Montenegro,2,1,Friendly,Oslo,Norway,0,22,882,64,500,-42,382,W,0,1,0
2010-05-29 00:00:00.000000,Poland,Finland,0,0,Friendly,Kielce,Poland,0,58,561,52,584,6,-23,D,1,1,0
2010-05-29 00:00:00.000000,Slovakia,Cameroon,1,1,Friendly,Klagenfurt,Austria,1,34,777,19,887,15,-110,D,1,0,0
2010-05-29 00:00:00.000000,Spain,Saudi Arabia,3,2,Friendly,Innsbruck,Austria,1,2,1565,66,498,-64,1067,W,0,0,0
2010-05-29 00:00:00.000000,Ukraine,Romania,3,2,Friendly,L'viv,Ukraine,0,23,875,28,853,-5,22,W,0,1,0
2010-05-29 00:00:00.000000,USA,Turkey,2,1,Friendly,Philadelphia,USA,0,14,957,29,830,-15,127,W,0,1,0
2010-05-29 00:00:00.000000,Venezuela,Canada,1,1,Friendly,Mérida,Venezuela,0,49,608,63,516,-14,92,D,1,1,0
2010-05-30 00:00:00.000000,Belarus,Korea Republic,1,0,Friendly,Kufstein,Austria,1,82,397,47,632,35,-235,W,0,0,0
2010-05-30 00:00:00.000000,Chile,Northern Ireland,1,0,Friendly,Chillán,Chile,0,18,888,56,566,-38,322,W,0,1,0
2010-05-30 00:00:00.000000,Chile,Israel,3,0,Friendly,Concepción,Chile,0,18,888,26,857,-8,31,W,0,1,0
2010-05-30 00:00:00.000000,Japan,England,1,2,Friendly,Graz,Austria,1,45,682,8,1068,37,-386,L,2,0,0
2010-05-30 00:00:00.000000,Mexico,Gambia,5,1,Friendly,Bayreuth,Germany,1,17,895,93,361,-76,534,W,0,0,0
2010-05-30 00:00:00.000000,Nigeria,Colombia,1,1,Friendly,Milton Keynes,England,1,21,883,35,776,-14,107,D,1,0,0
2010-05-30 00:00:00.000000,Tunisia,France,1,1,Friendly,Radès,Tunisia,0,55,574,9,1044,46,-470,D,1,1,0
2010-05-31 00:00:00.000000,South Africa,Guatemala,5,0,Friendly,Polokwane,South Africa,0,83,392,114,241,-31,151,W,0,1,0
2010-06-01 00:00:00.000000,Australia,Denmark,1,0,Friendly,Roodepoort,South Africa,1,20,886,36,767,-16,119,W,0,0,0
2010-06-01 00:00:00.000000,Netherlands,Ghana,4,1,Friendly,Rotterdam,Netherlands,0,4,1231,32,800,-28,431,W,0,1,0
2010-06-01 00:00:00.000000,Portugal,Cameroon,3,1,Friendly,Covilhã,Portugal,0,3,1249,19,887,-16,362,W,0,1,0
2010-06-01 00:00:00.000000,Switzerland,Costa Rica,0,1,Friendly,Sion,Switzerland,0,24,866,40,710,-16,156,L,2,1,0
2010-06-02 00:00:00.000000,Albania,Andorra,1,0,Friendly,Tirana,Albania,0,79,406,201,2,-122,404,W,0,1,0
2010-06-02 00:00:00.000000,Azerbaijan,Honduras,0,0,Friendly,Zell am See,Austria,1,109,259,38,734,71,-475,D,1,0,0
2010-06-02 00:00:00.000000,Belarus,Sweden,0,1,Friendly,Minsk,Belarus,0,82,397,37,761,45,-364,L,2,1,0
2010-06-02 00:00:00.000000,Greece,Paraguay,0,2,Friendly,Winterthur,Switzerland,1,13,964,31,820,-18,144,L,2,0,0
2010-06-02 00:00:00.000000,Norway,Ukraine,0,1,Friendly,Oslo,Norway,0,22,882,23,875,-1,7,L,2,1,0
2010-06-02 00:00:00.000000,Serbia,Poland,0,0,Friendly,Kufstein,Austria,1,15,947,58,561,-43,386,D,1,0,0
2010-06-02 00:00:00.000000,Zimbabwe,Brazil,0,3,Friendly,Harare,Zimbabwe,0,110,258,1,1611,109,-1353,L,2,1,0
2010-06-03 00:00:00.000000,Italy,Mexico,1,2,Friendly,Brussels,Belgium,1,5,1184,17,895,-12,289,L,2,0,0
2010-06-03 00:00:00.000000,Spain,Korea Republic,1,0,Friendly,Innsbruck,Austria,1,2,1565,47,632,-45,933,W,0,0,0
2010-06-04 00:00:00.000000,Luxembourg,Faroe Islands,0,0,Friendly,Hesperange,Luxembourg,0,127,193,125,196,2,-3,D,1,1,0
2010-06-04 00:00:00.000000,Slovenia,New Zealand,3,1,Friendly,Maribor,Slovenia,0,25,860,78,410,-53,450,W,0,1,0
2010-06-04 00:00:00.000000,Sudan,Palestine,1,1,Friendly,Omdurman,Sudan,0,118,219,173,39,-55,180,D,1,1,0
2010-06-05 00:00:00.000000,Algeria,United Arab Emirates,1,0,Friendly,Fürth,Germany,1,30,821,101,310,-71,511,W,0,0,0
2010-06-05 00:00:00.000000,Australia,USA,1,3,Friendly,Roodepoort,South Africa,1,20,886,14,957,6,-71,L,2,0,0
2010-06-05 00:00:00.000000,Ghana,Latvia,1,0,Friendly,Milton Keynes,England,1,32,800,46,652,-14,148,W,0,0,0
2010-06-05 00:00:00.000000,Netherlands,Hungary,6,1,Friendly,Amsterdam,Netherlands,0,4,1231,57,565,-53,666,W,0,1,0
2010-06-05 00:00:00.000000,Romania,Honduras,3,0,Friendly,Sankt Veit an der Glan,Austria,1,28,853,38,734,-10,119,W,0,0,0
2010-06-05 00:00:00.000000,Serbia,Cameroon,4,3,Friendly,Belgrade,Serbia,0,15,947,19,887,-4,60,W,0,1,0
2010-06-05 00:00:00.000000,Slovakia,Costa Rica,3,0,Friendly,Bratislava,Slovakia,0,34,777,40,710,-6,67,W,0,1,0
2010-06-05 00:00:00.000000,South Africa,Denmark,1,0,Friendly,Atteridgeville,South Africa,0,83,392,36,767,47,-375,W,0,1,0
2010-06-05 00:00:00.000000,Switzerland,Italy,1,1,Friendly,Geneva,Switzerland,0,24,866,5,1184,19,-318,D,1,1,0
2010-06-06 00:00:00.000000,Nigeria,Korea DPR,3,1,Friendly,Johannesburg,South Africa,1,21,883,105,285,-84,598,W,0,0,0
2010-06-07 00:00:00.000000,Tanzania,Brazil,1,5,Friendly,Dar es Salaam,Tanzania,0,108,261,1,1611,107,-1350,L,2,1,0
2010-06-08 00:00:00.000000,Mozambique,Portugal,0,3,Friendly,Johannesburg,South Africa,1,85,383,3,1249,82,-866,L,2,0,0
2010-06-08 00:00:00.000000,Spain,Poland,6,0,Friendly,Murcia,Spain,0,2,1565,58,561,-56,1004,W,0,1,0
2010-06-11 00:00:00.000000,South Africa,Mexico,1,1,FIFA World Cup,Johannesburg,South Africa,0,83,392,17,895,66,-503,D,1,1,0
2010-06-11 00:00:00.000000,Uruguay,France,0,0,FIFA World Cup,Cape Town,South Africa,1,16,899,9,1044,7,-145,D,1,0,0
2010-06-12 00:00:00.000000,Argentina,Nigeria,1,0,FIFA World Cup,Johannesburg,South Africa,1,7,1076,21,883,-14,193,W,0,0,0
2010-06-12 00:00:00.000000,England,USA,1,1,FIFA World Cup,Rustenburg,South Africa,1,8,1068,14,957,-6,111,D,1,0,0
2010-06-12 00:00:00.000000,Korea Republic,Greece,2,0,FIFA World Cup,Port Elizabeth,South Africa,1,47,632,13,964,34,-332,W,0,0,0
2010-06-13 00:00:00.000000,Algeria,Slovenia,0,1,FIFA World Cup,Polokwane,South Africa,1,30,821,25,860,5,-39,L,2,0,0
2010-06-13 00:00:00.000000,Germany,Australia,4,0,FIFA World Cup,Durban,South Africa,1,6,1082,20,886,-14,196,W,0,0,0
2010-06-13 00:00:00.000000,Serbia,Ghana,0,1,FIFA World Cup,Pretoria,South Africa,1,15,947,32,800,-17,147,L,2,0,0
2010-06-14 00:00:00.000000,Italy,Paraguay,1,1,FIFA World Cup,Cape Town,South Africa,1,5,1184,31,820,-26,364,D,1,0,0
2010-06-14 00:00:00.000000,Japan,Cameroon,1,0,FIFA World Cup,Bloemfontein,South Africa,1,45,682,19,887,26,-205,W,0,0,0
2010-06-14 00:00:00.000000,Netherlands,Denmark,2,0,FIFA World Cup,Johannesburg,South Africa,1,4,1231,36,767,-32,464,W,0,0,0
2010-06-15 00:00:00.000000,Brazil,Korea DPR,2,1,FIFA World Cup,Johannesburg,South Africa,1,1,1611,105,285,-104,1326,W,0,0,0
2010-06-15 00:00:00.000000,New Zealand,Slovakia,1,1,FIFA World Cup,Rustenburg,South Africa,1,78,410,34,777,44,-367,D,1,0,0
2010-06-16 00:00:00.000000,Honduras,Chile,0,1,FIFA World Cup,Nelspruit,South Africa,1,38,734,18,888,20,-154,L,2,0,0
2010-06-16 00:00:00.000000,South Africa,Uruguay,0,3,FIFA World Cup,Pretoria,South Africa,0,83,392,16,899,67,-507,L,2,1,0
2010-06-16 00:00:00.000000,Spain,Switzerland,0,1,FIFA World Cup,Durban,South Africa,1,2,1565,24,866,-22,699,L,2,0,0
2010-06-17 00:00:00.000000,Argentina,Korea Republic,4,1,FIFA World Cup,Johannesburg,South Africa,1,7,1076,47,632,-40,444,W,0,0,0
2010-06-17 00:00:00.000000,France,Mexico,0,2,FIFA World Cup,Polokwane,South Africa,1,9,1044,17,895,-8,149,L,2,0,0
2010-06-17 00:00:00.000000,Greece,Nigeria,2,1,FIFA World Cup,Bloemfontein,South Africa,1,13,964,21,883,-8,81,W,0,0,0
2010-06-18 00:00:00.000000,England,Algeria,0,0,FIFA World Cup,Cape Town,South Africa,1,8,1068,30,821,-22,247,D,1,0,0
2010-06-18 00:00:00.000000,Germany,Serbia,0,1,FIFA World Cup,Port Elizabeth,South Africa,1,6,1082,15,947,-9,135,L,2,0,0
2010-06-18 00:00:00.000000,Lithuania,Latvia,0,0,Baltic Cup,Kaunas,Lithuania,0,49,608,46,652,3,-44,D,1,1,0
2010-06-18 00:00:00.000000,Slovenia,USA,2,2,FIFA World Cup,Johannesburg,South Africa,1,25,860,14,957,11,-97,D,1,0,0
2010-06-19 00:00:00.000000,Cameroon,Denmark,1,2,FIFA World Cup,Pretoria,South Africa,1,19,887,36,767,-17,120,L,2,0,0
2010-06-19 00:00:00.000000,Estonia,Latvia,0,0,Baltic Cup,Kaunas,Lithuania,1,99,320,46,652,53,-332,D,1,0,0
2010-06-19 00:00:00.000000,Ghana,Australia,1,1,FIFA World Cup,Rustenburg,South Africa,1,32,800,20,886,12,-86,D,1,0,0
2010-06-19 00:00:00.000000,Netherlands,Japan,1,0,FIFA World Cup,Durban,South Africa,1,4,1231,45,682,-41,549,W,0,0,0
2010-06-19 00:00:00.000000,Niger,Chad,1,1,Friendly,Niamey,Niger,0,162,92,143,128,19,-36,D,1,1,0
2010-06-20 00:00:00.000000,Italy,New Zealand,1,1,FIFA World Cup,Nelspruit,South Africa,1,5,1184,78,410,-73,774,D,1,0,0
2010-06-20 00:00:00.000000,Lithuania,Estonia,2,0,Baltic Cup,Kaunas,Lithuania,0,49,608,99,320,-50,288,W,0,1,0
2010-06-20 00:00:00.000000,Slovakia,Paraguay,0,2,FIFA World Cup,Bloemfontein,South Africa,1,34,777,31,820,3,-43,L,2,0,0
2010-06-20 00:00:00.000000,Sudan,Tunisia,2,6,Friendly,Omdurman,Sudan,0,118,219,55,574,63,-355,L,2,1,0
2010-06-21 00:00:00.000000,Chile,Switzerland,1,0,FIFA World Cup,Port Elizabeth,South Africa,1,18,888,24,866,-6,22,W,0,0,0
2010-06-21 00:00:00.000000,Portugal,Korea DPR,7,0,FIFA World Cup,Cape Town,South Africa,1,3,1249,105,285,-102,964,W,0,0,0
2010-06-21 00:00:00.000000,Spain,Honduras,2,0,FIFA World Cup,Johannesburg,South Africa,1,2,1565,38,734,-36,831,W,0,0,0
2010-06-22 00:00:00.000000,Greece,Argentina,0,2,FIFA World Cup,Polokwane,South Africa,1,13,964,7,1076,6,-112,L,2,0,0
2010-06-22 00:00:00.000000,Mexico,Uruguay,0,1,FIFA World Cup,Rustenburg,South Africa,1,17,895,16,899,1,-4,L,2,0,0
2010-06-22 00:00:00.000000,Nigeria,Korea Republic,2,2,FIFA World Cup,Durban,South Africa,1,21,883,47,632,-26,251,D,1,0,0
2010-06-22 00:00:00.000000,South Africa,France,2,1,FIFA World Cup,Bloemfontein,South Africa,0,83,392,9,1044,74,-652,W,0,1,0
2010-06-23 00:00:00.000000,Australia,Serbia,2,1,FIFA World Cup,Nelspruit,South Africa,1,20,886,15,947,5,-61,W,0,0,0
2010-06-23 00:00:00.000000,Ghana,Germany,0,1,FIFA World Cup,Johannesburg,South Africa,1,32,800,6,1082,26,-282,L,2,0,0
2010-06-23 00:00:00.000000,Slovenia,England,0,1,FIFA World Cup,Port Elizabeth,South Africa,1,25,860,8,1068,17,-208,L,2,0,0
2010-06-23 00:00:00.000000,USA,Algeria,1,0,FIFA World Cup,Pretoria,South Africa,1,14,957,30,821,-16,136,W,0,0,0
2010-06-24 00:00:00.000000,Cameroon,Netherlands,1,2,FIFA World Cup,Cape Town,South Africa,1,19,887,4,1231,15,-344,L,2,0,0
2010-06-24 00:00:00.000000,Denmark,Japan,1,3,FIFA World Cup,Rustenburg,South Africa,1,36,767,45,682,-9,85,L,2,0,0
2010-06-24 00:00:00.000000,Paraguay,New Zealand,0,0,FIFA World Cup,Polokwane,South Africa,1,31,820,78,410,-47,410,D,1,0,0
2010-06-24 00:00:00.000000,Slovakia,Italy,3,2,FIFA World Cup,Johannesburg,South Africa,1,34,777,5,1184,29,-407,W,0,0,0
2010-06-25 00:00:00.000000,Chile,Spain,1,2,FIFA World Cup,Pretoria,South Africa,1,18,888,2,1565,16,-677,L,2,0,0
2010-06-25 00:00:00.000000,Portugal,Brazil,0,0,FIFA World Cup,Durban,South Africa,1,3,1249,1,1611,2,-362,D,1,0,0
2010-06-25 00:00:00.000000,Switzerland,Honduras,0,0,FIFA World Cup,Bloemfontein,South Africa,1,24,866,38,734,-14,132,D,1,0,0
2010-06-26 00:00:00.000000,Uruguay,Korea Republic,2,1,FIFA World Cup,Port Elizabeth,South Africa,1,16,899,47,632,-31,267,W,0,0,0
2010-06-26 00:00:00.000000,USA,Ghana,1,2,FIFA World Cup,Rustenburg,South Africa,1,14,957,32,800,-18,157,L,2,0,0
2010-06-27 00:00:00.000000,Argentina,Mexico,3,1,FIFA World Cup,Johannesburg,South Africa,1,7,1076,17,895,-10,181,W,0,0,0
2010-06-27 00:00:00.000000,Germany,England,4,1,FIFA World Cup,Bloemfontein,South Africa,1,6,1082,8,1068,-2,14,W,0,0,0
2010-06-28 00:00:00.000000,Brazil,Chile,3,0,FIFA World Cup,Johannesburg,South Africa,1,1,1611,18,888,-17,723,W,0,0,0
2010-06-28 00:00:00.000000,Netherlands,Slovakia,2,1,FIFA World Cup,Durban,South Africa,1,4,1231,34,777,-30,454,W,0,0,0
2010-06-29 00:00:00.000000,Paraguay,Japan,0,0,FIFA World Cup,Pretoria,South Africa,1,31,820,45,682,-14,138,D,1,0,0
2010-06-29 00:00:00.000000,Spain,Portugal,1,0,FIFA World Cup,Cape Town,South Africa,1,2,1565,3,1249,-1,316,W,0,0,0
2010-07-01 00:00:00.000000,Chad,Togo,2,2,African Cup of Nations qualification,N'Djamena,Chad,0,143,128,76,418,67,-290,D,1,1,0
2010-07-01 00:00:00.000000,Tunisia,Botswana,0,1,African Cup of Nations qualification,Tunis,Tunisia,0,55,574,116,236,-61,338,L,2,1,0
2010-07-02 00:00:00.000000,Netherlands,Brazil,2,1,FIFA World Cup,Port Elizabeth,South Africa,1,4,1231,1,1611,3,-380,W,0,0,0
2010-07-02 00:00:00.000000,Uruguay,Ghana,1,1,FIFA World Cup,Johannesburg,South Africa,1,16,899,32,800,-16,99,D,1,0,0
2010-07-03 00:00:00.000000,Argentina,Germany,0,4,FIFA World Cup,Cape Town,South Africa,1,7,1076,6,1082,1,-6,L,2,0,0
2010-07-03 00:00:00.000000,Paraguay,Spain,0,1,FIFA World Cup,Johannesburg,South Africa,1,31,820,2,1565,29,-745,L,2,0,0
2010-07-06 00:00:00.000000,Uruguay,Netherlands,2,3,FIFA World Cup,Cape Town,South Africa,1,16,899,4,1231,12,-332,L,2,0,0
2010-07-07 00:00:00.000000,Germany,Spain,0,1,FIFA World Cup,Durban,South Africa,1,6,1082,2,1565,4,-483,L,2,0,0
2010-07-09 00:00:00.000000,Botswana,Chad,1,0,African Cup of Nations qualification,Gaborone,Botswana,0,116,236,143,128,-27,108,W,0,1,0
2010-07-09 00:00:00.000000,Togo,Malawi,1,1,African Cup of Nations qualification,Lomé,Togo,0,76,418,86,382,-10,36,D,1,1,0
2010-07-10 00:00:00.000000,Uruguay,Germany,2,3,FIFA World Cup,Port Elizabeth,South Africa,1,16,899,6,1082,10,-183,L,2,0,0
2010-07-11 00:00:00.000000,Netherlands,Spain,0,1,FIFA World Cup,Johannesburg,South Africa,1,4,1231,2,1565,2,-334,L,2,0,0
2010-08-04 00:00:00.000000,Botswana,Zimbabwe,2,0,Friendly,Selebi-Phikwe,Botswana,0,116,236,110,258,6,-22,W,0,1,0
2010-08-11 00:00:00.000000,Albania,Uzbekistan,1,0,Friendly,Durrës,Albania,0,70,455,88,351,-18,104,W,0,1,0
2010-08-11 00:00:00.000000,Algeria,Gabon,1,2,Friendly,Algiers,Algeria,0,33,759,34,755,-1,4,L,2,1,0
2010-08-11 00:00:00.000000,Angola,Uruguay,0,2,Friendly,Lisbon,Portugal,1,87,357,6,1152,81,-795,L,2,0,0
2010-08-11 00:00:00.000000,Armenia,Iran,1,3,Friendly,Yerevan,Armenia,0,96,318,65,517,31,-199,L,2,1,0
2010-08-11 00:00:00.000000,Austria,Switzerland,0,1,Friendly,Klagenfurt,Austria,0,60,536,17,940,43,-404,L,2,1,0
2010-08-11 00:00:00.000000,Azerbaijan,Kuwait,1,1,Friendly,Baku,Azerbaijan,0,105,266,85,365,20,-99,D,1,1,0
2010-08-11 00:00:00.000000,Benin,Niger,0,0,Friendly,Porto-Novo,Benin,0,61,535,145,110,-84,425,D,1,1,0
2010-08-11 00:00:00.000000,Bolivia,Colombia,1,1,Friendly,La Paz,Bolivia,0,50,577,36,734,14,-157,D,1,1,0
2010-08-11 00:00:00.000000,Burkina Faso,Congo,3,0,Friendly,Senlis,France,1,45,646,106,263,-61,383,W,0,0,0
2010-08-11 00:00:00.000000,Chad,Tunisia,1,3,African Cup of Nations qualification,N'Djamena,Chad,0,124,185,64,519,60,-334,L,2,1,0
2010-08-11 00:00:00.000000,Cyprus,Andorra,1,0,Friendly,Larnaca,Cyprus,0,63,523,201,2,-138,521,W,0,1,0
2010-08-11 00:00:00.000000,Czech Republic,Latvia,4,1,Friendly,Liberec,Czech Republic,0,31,769,49,579,-18,190,W,0,1,0
2010-08-11 00:00:00.000000,Denmark,Germany,2,2,Friendly,Copenhagen,Denmark,0,29,785,4,1464,25,-679,D,1,1,0
2010-08-11 00:00:00.000000,Egypt,Congo DR,6,3,Friendly,Cairo,Egypt,0,9,1053,123,187,-114,866,W,0,1,0
2010-08-11 00:00:00.000000,England,Hungary,2,1,Friendly,London,England,0,7,1125,62,534,-55,591,W,0,1,0
2010-08-11 00:00:00.000000,Estonia,Faroe Islands,2,1,UEFA Euro qualification,Tallinn,Estonia,0,94,321,118,206,-24,115,W,0,1,0
2010-08-11 00:00:00.000000,Finland,Belgium,1,0,Friendly,Turku,Finland,0,51,576,48,589,3,-13,W,0,1,0
2010-08-11 00:00:00.000000,Iceland,Liechtenstein,1,1,Friendly,Reykjavík,Iceland,0,79,385,141,126,-62,259,D,1,1,0
2010-08-11 00:00:00.000000,Kazakhstan,Oman,3,1,Friendly,Astana,Kazakhstan,0,125,184,81,377,44,-193,W,0,1,0
2010-08-11 00:00:00.000000,Korea Republic,Nigeria,2,1,Friendly,Suwon,Korea Republic,0,44,651,30,773,14,-122,W,0,1,0
2010-08-11 00:00:00.000000,Lithuania,Belarus,0,2,Friendly,Kaunas,Lithuania,0,52,571,78,403,-26,168,L,2,1,0
2010-08-11 00:00:00.000000,Malawi,Botswana,1,1,African Cup of Nations qualification,Blantyre,Malawi,0,74,424,93,329,-19,95,D,1,1,0
2010-08-11 00:00:00.000000,Mali,Guinea,0,2,Friendly,Marignane,France,1,55,548,102,286,-47,262,L,2,0,0
2010-08-11 00:00:00.000000,Mauritania,Palestine,0,0,Friendly,Nouakchott,Mauritania,0,168,62,171,50,-3,12,D,1,1,0
2010-08-11 00:00:00.000000,Mexico,Spain,1,1,Friendly,Mexico City,Mexico,0,25,853,1,1883,24,-1030,D,1,1,0
2010-08-11 00:00:00.000000,Moldova,Georgia,0,0,Friendly,Chișinău,Moldova,0,89,350,110,237,-21,113,D,1,1,0
2010-08-11 00:00:00.000000,Montenegro,Northern Ireland,2,0,Friendly,Podgorica,Montenegro,0,73,448,59,540,14,-92,W,0,1,0
2010-08-11 00:00:00.000000,Morocco,Equatorial Guinea,2,1,Friendly,Rabat,Morocco,0,83,371,145,110,-62,261,W,0,1,0
2010-08-11 00:00:00.000000,Mozambique,Swaziland,2,1,Friendly,Maputo,Mozambique,0,80,381,136,136,-56,245,W,0,1,0
2010-08-11 00:00:00.000000,Norway,France,2,1,Friendly,Oslo,Norway,0,22,878,21,890,1,-12,W,0,1,0
2010-08-11 00:00:00.000000,Panama,Venezuela,3,1,Friendly,Panama City,Panama,0,97,314,47,592,50,-278,W,0,1,0
2010-08-11 00:00:00.000000,Paraguay,Costa Rica,2,0,Friendly,Asunción,Paraguay,0,15,961,53,562,-38,399,W,0,1,0
2010-08-11 00:00:00.000000,Poland,Cameroon,0,3,Friendly,Szczecin,Poland,0,56,547,40,710,16,-163,L,2,1,0
2010-08-11 00:00:00.000000,Russia,Bulgaria,1,0,Friendly,St. Petersburg,Russia,0,16,956,43,672,-27,284,W,0,1,0
2010-08-11 00:00:00.000000,Saudi Arabia,Togo,1,0,Friendly,Riyadh,Saudi Arabia,0,70,455,75,421,-5,34,W,0,1,0
2010-08-11 00:00:00.000000,Serbia,Greece,0,1,Friendly,Belgrade,Serbia,0,13,969,12,975,1,-6,L,2,1,0
2010-08-11 00:00:00.000000,Slovakia,Croatia,1,1,Friendly,Bratislava,Slovakia,0,27,829,14,968,13,-139,D,1,1,0
2010-08-11 00:00:00.000000,Slovenia,Australia,2,0,Friendly,Ljubljana,Slovenia,0,19,917,20,911,-1,6,W,0,1,0
2010-08-11 00:00:00.000000,South Africa,Ghana,1,0,Friendly,Johannesburg,South Africa,0,66,504,23,874,43,-370,W,0,1,0
2010-08-11 00:00:00.000000,Sweden,Scotland,3,0,Friendly,Solna,Sweden,0,35,747,41,699,-6,48,W,0,1,0
2010-08-11 00:00:00.000000,Tanzania,Kenya,1,1,Friendly,Dar es Salaam,Tanzania,0,111,235,116,210,-5,25,D,1,1,0
2010-08-11 00:00:00.000000,Thailand,Singapore,1,0,Friendly,Bangkok,Thailand,0,104,276,120,198,-16,78,W,0,1,0
2010-08-11 00:00:00.000000,Trinidad and Tobago,Jamaica,1,3,Friendly,Macoya,Trinidad and Tobago,0,76,418,82,372,-6,46,L,2,1,0
2010-08-11 00:00:00.000000,Turkey,Romania,2,0,Friendly,Istanbul,Turkey,0,28,810,42,697,-14,113,W,0,1,0
2010-08-11 00:00:00.000000,Uganda,Zambia,1,1,Friendly,Kampala,Uganda,0,69,459,72,449,-3,10,D,1,1,0
2010-08-11 00:00:00.000000,Ukraine,Netherlands,1,1,Friendly,Donets'k,Ukraine,0,24,870,2,1659,22,-789,D,1,1,0
2010-08-11 00:00:00.000000,Wales,Luxembourg,5,1,Friendly,Llanelli,Wales,0,84,366,117,209,-33,157,W,0,1,0
2010-08-18 00:00:00.000000,Ethiopia,Kenya,0,3,Friendly,Addis Abeba,Ethiopia,0,144,116,116,210,28,-94,L,2,1,0
2010-08-28 00:00:00.000000,St. Kitts and Nevis,Antigua and Barbuda,1,1,Friendly,Basseterre,St. Kitts and Nevis,0,145,110,129,168,16,-58,D,1,1,0
2010-08-29 00:00:00.000000,Ethiopia,Chad,1,0,Friendly,Addis Abeba,Ethiopia,0,144,116,124,185,20,-69,W,0,1,0
2010-08-29 00:00:00.000000,Madagascar,Comoros,1,0,Friendly,Mahajanga,Madagascar,0,148,106,172,43,-24,63,W,0,1,0
2010-09-02 00:00:00.000000,Israel,Malta,3,1,UEFA Euro qualification,Ramat-Gan,Israel,0,38,733,151,105,-113,628,W,0,1,0
2010-09-03 00:00:00.000000,Algeria,Tanzania,1,1,African Cup of Nations qualification,Blida,Algeria,0,33,759,111,235,-78,524,D,1,1,0
2010-09-03 00:00:00.000000,Andorra,Russia,0,2,UEFA Euro qualification,Sant Julià de Lòria,Andorra,0,201,2,16,956,185,-954,L,2,1,0
2010-09-03 00:00:00.000000,Belgium,Germany,0,1,UEFA Euro qualification,Brussels,Belgium,0,48,589,4,1464,44,-875,L,2,1,0
2010-09-03 00:00:00.000000,England,Bulgaria,4,0,UEFA Euro qualification,London,England,0,7,1125,43,672,-36,453,W,0,1,0
2010-09-03 00:00:00.000000,Estonia,Italy,1,2,UEFA Euro qualification,Tallinn,Estonia,0,94,321,11,982,83,-661,L,2,1,0
2010-09-03 00:00:00.000000,Faroe Islands,Serbia,0,3,UEFA Euro qualification,Tórshavn,Faroe Islands,0,118,206,13,969,105,-763,L,2,1,0
2010-09-03 00:00:00.000000,France,Belarus,0,1,UEFA Euro qualification,Saint-Denis,France,0,21,890,78,403,-57,487,L,2,1,0
2010-09-03 00:00:00.000000,Greece,Georgia,1,1,UEFA Euro qualification,Piraeus,Greece,0,12,975,110,237,-98,738,D,1,1,0
2010-09-03 00:00:00.000000,Iceland,Norway,1,2,UEFA Euro qualification,Reykjavík,Iceland,0,79,385,22,878,57,-493,L,2,1,0
2010-09-03 00:00:00.000000,Kazakhstan,Turkey,0,3,UEFA Euro qualification,Astana,Kazakhstan,0,125,184,28,810,97,-626,L,2,1,0
2010-09-03 00:00:00.000000,Kuwait,Syria,3,0,Friendly,Kuwait City,Kuwait,0,85,365,92,336,-7,29,W,0,1,0
2010-09-03 00:00:00.000000,Latvia,Croatia,0,3,UEFA Euro qualification,Riga,Latvia,0,49,579,14,968,35,-389,L,2,1,0
2010-09-03 00:00:00.000000,Liechtenstein,Spain,0,4,UEFA Euro qualification,Vaduz,Liechtenstein,0,141,126,1,1883,140,-1757,L,2,1,0
2010-09-03 00:00:00.000000,Lithuania,Scotland,0,0,UEFA Euro qualification,Kaunas,Lithuania,0,52,571,41,699,11,-128,D,1,1,0
2010-09-03 00:00:00.000000,Moldova,Finland,2,0,UEFA Euro qualification,Chişinău,Moldova,0,89,350,51,576,38,-226,W,0,1,0
2010-09-03 00:00:00.000000,Montenegro,Wales,1,0,UEFA Euro qualification,Podgorica,Montenegro,0,73,448,84,366,-11,82,W,0,1,0
2010-09-03 00:00:00.000000,Oman,Malaysia,3,0,Friendly,Doha,Qatar,1,81,377,139,128,-58,249,W,0,0,0
2010-09-03 00:00:00.000000,Panama,Costa Rica,2,2,Friendly,Panama City,Panama,0,97,314,53,562,44,-248,D,1,1,0
2010-09-03 00:00:00.000000,Portugal,Cyprus,4,4,UEFA Euro qualification,Guimarães,Portugal,0,8,1062,63,523,-55,539,D,1,1,0
2010-09-03 00:00:00.000000,Qatar,Bahrain,1,1,Friendly,Doha,Qatar,0,98,300,68,466,30,-166,D,1,1,0
2010-09-03 00:00:00.000000,Romania,Albania,1,1,UEFA Euro qualification,Piatra Neamţ,Romania,0,42,697,70,455,-28,242,D,1,1,0
2010-09-03 00:00:00.000000,San Marino,Netherlands,0,5,UEFA Euro qualification,Serravalle,San Marino,0,202,0,2,1659,200,-1659,L,2,1,0
2010-09-03 00:00:00.000000,Slovenia,Northern Ireland,0,1,UEFA Euro qualification,Maribor,Slovenia,0,19,917,59,540,-40,377,L,2,1,0
2010-09-03 00:00:00.000000,Sweden,Hungary,2,0,UEFA Euro qualification,Solna,Sweden,0,35,747,62,534,-27,213,W,0,1,0
2010-09-03 00:00:00.000000,Switzerland,Australia,0,0,Friendly,St. Gallen,Switzerland,0,17,940,20,911,-3,29,D,1,1,0
2010-09-03 00:00:00.000000,Venezuela,Colombia,0,2,Friendly,Puerto la Cruz,Venezuela,0,47,592,36,734,11,-142,L,2,1,0
2010-09-04 00:00:00.000000,Botswana,Togo,2,1,African Cup of Nations qualification,Gaborone,Botswana,0,93,329,75,421,18,-92,W,0,1,0
2010-09-04 00:00:00.000000,Canada,Peru,0,2,Friendly,Toronto,Canada,0,101,287,39,726,62,-439,L,2,1,0
2010-09-04 00:00:00.000000,El Salvador,Honduras,2,2,Friendly,Los Angeles,USA,1,86,360,46,627,40,-267,D,1,0,0
2010-09-04 00:00:00.000000,Guatemala,Nicaragua,5,0,Friendly,Fort Lauderdale,USA,1,119,201,161,86,-42,115,W,0,0,0
2010-09-04 00:00:00.000000,Guinea-Bissau,Kenya,1,0,African Cup of Nations qualification,Bissau,Guinea-Bissau,0,188,19,116,210,72,-191,W,0,1,0
2010-09-04 00:00:00.000000,Japan,Paraguay,1,0,Friendly,Yokohama,Japan,0,32,768,15,961,17,-193,W,0,1,0
2010-09-04 00:00:00.000000,Mauritius,Cameroon,1,3,African Cup of Nations qualification,Mapou,Mauritius,0,183,27,40,710,143,-683,L,2,1,0
2010-09-04 00:00:00.000000,Mexico,Ecuador,1,2,Friendly,Zapopan,Mexico,0,25,853,58,545,-33,308,L,2,1,0
2010-09-04 00:00:00.000000,Morocco,Central African Republic,0,0,African Cup of Nations qualification,Rabat,Morocco,0,83,371,202,0,-119,371,D,1,1,0
2010-09-04 00:00:00.000000,Poland,Ukraine,1,1,Friendly,Łódź,Poland,0,56,547,24,870,32,-323,D,1,1,0
2010-09-04 00:00:00.000000,South Africa,Niger,2,0,African Cup of Nations qualification,Nelspruit,South Africa,0,66,504,145,110,-79,394,W,0,1,0
2010-09-04 00:00:00.000000,Sudan,Congo,2,0,African Cup of Nations qualification,Khartoum,Sudan,0,120,198,106,263,14,-65,W,0,1,0
2010-09-04 00:00:00.000000,Thailand,India,1,0,Friendly,Bangkok,Thailand,0,104,276,138,129,-34,147,W,0,1,0
2010-09-04 00:00:00.000000,Tunisia,Malawi,2,2,African Cup of Nations qualification,Radès,Tunisia,0,64,519,74,424,-10,95,D,1,1,0
2010-09-04 00:00:00.000000,Uganda,Angola,3,0,African Cup of Nations qualification,Kampala,Uganda,0,69,459,87,357,-18,102,W,0,1,0
2010-09-05 00:00:00.000000,Benin,Burundi,1,1,African Cup of Nations qualification,Cotonou,Benin,0,61,535,142,125,-81,410,D,1,1,0
2010-09-05 00:00:00.000000,Congo DR,Senegal,2,4,African Cup of Nations qualification,Lubumbashi,Congo DR,0,123,187,91,338,32,-151,L,2,1,0
2010-09-05 00:00:00.000000,Egypt,Sierra Leone,1,1,African Cup of Nations qualification,Cairo,Egypt,0,9,1053,137,130,-128,923,D,1,1,0
2010-09-05 00:00:00.000000,Ethiopia,Guinea,1,4,African Cup of Nations qualification,Addis Ababa,Ethiopia,0,144,116,102,286,42,-170,L,2,1,0
2010-09-05 00:00:00.000000,Jamaica,Costa Rica,1,0,Friendly,Kingston,Jamaica,0,82,372,53,562,29,-190,W,0,1,0
2010-09-05 00:00:00.000000,Liberia,Zimbabwe,1,1,African Cup of Nations qualification,Paynesville,Liberia,0,156,94,113,224,43,-130,D,1,1,0
2010-09-05 00:00:00.000000,Mozambique,Libya,0,0,African Cup of Nations qualification,Maputo,Mozambique,0,80,381,94,321,-14,60,D,1,1,0
2010-09-05 00:00:00.000000,Nigeria,Madagascar,2,0,African Cup of Nations qualification,Calabar,Nigeria,0,30,773,148,106,-118,667,W,0,1,0
2010-09-05 00:00:00.000000,Swaziland,Ghana,0,3,African Cup of Nations qualification,Lobamba,Swaziland,0,136,136,23,874,113,-738,L,2,1,0
2010-09-06 00:00:00.000000,Burkina Faso,Gabon,1,1,Friendly,Cannes,France,1,45,646,34,755,11,-109,D,1,0,0
2010-09-07 00:00:00.000000,Albania,Luxembourg,1,0,UEFA Euro qualification,Tirana,Albania,0,70,455,117,209,-47,246,W,0,1,0
2010-09-07 00:00:00.000000,Argentina,Spain,4,1,Friendly,Buenos Aires,Argentina,0,5,1288,1,1883,4,-595,W,0,1,0
2010-09-07 00:00:00.000000,Austria,Kazakhstan,2,0,UEFA Euro qualification,Salzburg,Austria,0,60,536,125,184,-65,352,W,0,1,0
2010-09-07 00:00:00.000000,Bahrain,Togo,3,0,Friendly,Riffa,Bahrain,0,68,466,75,421,-7,45,W,0,1,0
2010-09-07 00:00:00.000000,Belarus,Romania,0,0,UEFA Euro qualification,Minsk,Belarus,0,78,403,42,697,36,-294,D,1,1,0
2010-09-07 00:00:00.000000,Bulgaria,Montenegro,0,1,UEFA Euro qualification,Sofia,Bulgaria,0,43,672,73,448,-30,224,L,2,1,0
2010-09-07 00:00:00.000000,Canada,Honduras,2,1,Friendly,Montréal,Canada,0,101,287,46,627,55,-340,W,0,1,0
2010-09-07 00:00:00.000000,Croatia,Greece,0,0,UEFA Euro qualification,Zagreb,Croatia,0,14,968,12,975,2,-7,D,1,1,0
2010-09-07 00:00:00.000000,Czech Republic,Lithuania,0,1,UEFA Euro qualification,Olomouc,Czech Republic,0,31,769,52,571,-21,198,L,2,1,0
2010-09-07 00:00:00.000000,Denmark,Iceland,1,0,UEFA Euro qualification,Copenhagen,Denmark,0,29,785,79,385,-50,400,W,0,1,0
2010-09-07 00:00:00.000000,El Salvador,Guatemala,0,2,Friendly,Washington,USA,1,86,360,119,201,-33,159,L,2,0,0
2010-09-07 00:00:00.000000,Estonia,Uzbekistan,3,3,Friendly,Tallinn,Estonia,0,94,321,88,351,6,-30,D,1,1,0
2010-09-07 00:00:00.000000,Georgia,Israel,0,0,UEFA Euro qualification,Tbilisi,Georgia,0,110,237,38,733,72,-496,D,1,1,0
2010-09-07 00:00:00.000000,Germany,Azerbaijan,6,1,UEFA Euro qualification,Cologne,Germany,0,4,1464,105,266,-101,1198,W,0,1,0
2010-09-07 00:00:00.000000,Hungary,Moldova,2,1,UEFA Euro qualification,Budapest,Hungary,0,62,534,89,350,-27,184,W,0,1,0
2010-09-07 00:00:00.000000,Italy,Faroe Islands,5,0,UEFA Euro qualification,Florence,Italy,0,11,982,118,206,-107,776,W,0,1,0
2010-09-07 00:00:00.000000,Jamaica,Peru,1,2,Friendly,Fort Lauderdale,USA,1,82,372,39,726,43,-354,L,2,0,0
2010-09-07 00:00:00.000000,Japan,Guatemala,2,1,Friendly,Osaka,Japan,0,32,768,119,201,-87,567,W,0,1,0
2010-09-07 00:00:00.000000,Korea Republic,Iran,0,1,Friendly,Seoul,Korea Republic,0,44,651,65,517,-21,134,L,2,1,0
2010-09-07 00:00:00.000000,Malta,Latvia,0,2,UEFA Euro qualification,Attard,Malta,0,151,105,49,579,102,-474,L,2,1,0
2010-09-07 00:00:00.000000,Mexico,Colombia,1,0,Friendly,Monterrey,Mexico,0,25,853,36,734,-11,119,W,0,1,0
2010-09-07 00:00:00.000000,Netherlands,Finland,2,1,UEFA Euro qualification,Rotterdam,Netherlands,0,2,1659,51,576,-49,1083,W,0,1,0
2010-09-07 00:00:00.000000,Norway,Portugal,1,0,UEFA Euro qualification,Oslo,Norway,0,22,878,8,1062,14,-184,W,0,1,0
2010-09-07 00:00:00.000000,Panama,Trinidad and Tobago,3,0,Friendly,Panama City,Panama,0,97,314,76,418,21,-104,W,0,1,0
2010-09-07 00:00:00.000000,Poland,Australia,1,2,Friendly,Cracow,Poland,0,56,547,20,911,36,-364,L,2,1,0
2010-09-07 00:00:00.000000,Qatar,Oman,1,1,Friendly,Doha,Qatar,0,98,300,81,377,17,-77,D,1,1,0
2010-09-07 00:00:00.000000,Russia,Slovakia,0,1,UEFA Euro qualification,Moscow,Russia,0,16,956,27,829,-11,127,L,2,1,0
2010-09-07 00:00:00.000000,Scotland,Liechtenstein,2,1,UEFA Euro qualification,Glasgow,Scotland,0,41,699,141,126,-100,573,W,0,1,0
2010-09-07 00:00:00.000000,Serbia,Slovenia,1,1,UEFA Euro qualification,Belgrade,Serbia,0,13,969,19,917,-6,52,D,1,1,0
2010-09-07 00:00:00.000000,Sweden,San Marino,6,0,UEFA Euro qualification,Malmö,Sweden,0,35,747,202,0,-167,747,W,0,1,0
2010-09-07 00:00:00.000000,Switzerland,England,1,3,UEFA Euro qualification,Basel,Switzerland,0,17,940,7,1125,10,-185,L,2,1,0
2010-09-07 00:00:00.000000,Turkey,Belgium,3,2,UEFA Euro qualification,Istanbul,Turkey,0,28,810,48,589,-20,221,W,0,1,0
2010-09-07 00:00:00.000000,Ukraine,Chile,2,1,Friendly,Kyïv,Ukraine,0,24,870,10,988,14,-118,W,0,1,0
2010-09-07 00:00:00.000000,United Arab Emirates,Kuwait,3,0,Friendly,Abu Dhabi,United Arab Emirates,0,90,348,85,365,5,-17,W,0,1,0
2010-09-07 00:00:00.000000,Venezuela,Ecuador,1,0,Friendly,Barquisimeto,Venezuela,0,47,592,58,545,-11,47,W,0,1,0
2010-09-07 00:00:00.000000,Yemen,Syria,2,1,Friendly,Sana'a,Yemen,0,109,249,92,336,17,-87,W,0,1,0
2010-09-08 00:00:00.000000,India,Thailand,1,2,Friendly,New Delhi,India,0,138,129,104,276,34,-147,L,2,1,0
2010-09-10 00:00:00.000000,Belize,Trinidad and Tobago,0,0,Friendly,Belmopan,Belize,0,180,32,76,418,104,-386,D,1,1,0
2010-09-10 00:00:00.000000,St. Lucia,St. Vincent and the Grenadines,1,5,Friendly,Vieux Fort,St. Lucia,0,188,19,160,87,28,-68,L,2,1,0
2010-09-15 00:00:00.000000,India,Namibia,2,0,Friendly,New Delhi,India,0,138,129,115,213,23,-84,W,0,1,0
2010-09-16 00:00:00.000000,Jordan,Iraq,4,1,Friendly,Amman,Jordan,0,98,300,106,263,-8,37,W,0,1,0
2010-09-18 00:00:00.000000,Anguilla,British Virgin Islands,1,2,Friendly,Quartier d'Orléans,St. Martin,1,202,0,191,18,11,-18,L,2,0,0
2010-09-18 00:00:00.000000,Yemen,Zambia,0,1,Friendly,Sana'a,Yemen,0,109,249,72,449,37,-200,L,2,1,0
2010-09-19 00:00:00.000000,Antigua and Barbuda,Trinidad and Tobago,0,1,Friendly,St. John's,Antigua and Barbuda,0,129,168,76,418,53,-250,L,2,1,0
2010-09-19 00:00:00.000000,Jordan,Bahrain,2,0,Friendly,Zarqa,Jordan,0,98,300,68,466,30,-166,W,0,1,0
2010-09-21 00:00:00.000000,Iraq,Oman,3,2,Friendly,Amman,Jordan,1,106,263,81,377,25,-114,W,0,0,0
2010-09-21 00:00:00.000000,St. Lucia,Trinidad and Tobago,0,3,Friendly,St. John's,Antigua and Barbuda,1,188,19,76,418,112,-399,L,2,0,0
2010-09-23 00:00:00.000000,Antigua and Barbuda,St. Lucia,5,0,Friendly,St. John's,Antigua and Barbuda,0,129,168,188,19,-59,149,W,0,1,0
2010-09-24 00:00:00.000000,Iran,Bahrain,3,0,WAFF Championship,Amman,Jordan,1,65,517,68,466,-3,51,W,0,0,0
2010-09-24 00:00:00.000000,Jordan,Syria,1,1,WAFF Championship,Amman,Jordan,0,98,300,92,336,6,-36,D,1,1,0
2010-09-24 00:00:00.000000,Vietnam,Korea DPR,0,0,Friendly,Hanoi,Vietnam,0,127,174,100,288,27,-114,D,1,1,0
2010-09-25 00:00:00.000000,Iraq,Yemen,2,1,WAFF Championship,Amman,Jordan,1,106,263,109,249,-3,14,W,0,0,0
2010-09-26 00:00:00.000000,Bahrain,Oman,2,0,WAFF Championship,Amman,Jordan,1,68,466,81,377,-13,89,W,0,0,0
2010-09-26 00:00:00.000000,Barbados,Dominica,1,3,Friendly,Bridgetown,Barbados,0,127,174,178,33,-51,141,L,2,1,0
2010-09-26 00:00:00.000000,Guyana,Trinidad and Tobago,1,1,Friendly,Providence,Guyana,0,122,190,76,418,46,-228,D,1,1,0
2010-09-26 00:00:00.000000,Syria,Kuwait,1,2,WAFF Championship,Amman,Jordan,1,92,336,85,365,7,-29,L,2,0,0
2010-09-27 00:00:00.000000,Yemen,Palestine,3,1,WAFF Championship,Amman,Jordan,1,109,249,171,50,-62,199,W,0,0,0
2010-09-28 00:00:00.000000,Jordan,Kuwait,2,2,WAFF Championship,Amman,Jordan,0,98,300,85,365,13,-65,D,1,1,0
2010-09-28 00:00:00.000000,Oman,Iran,2,2,WAFF Championship,Amman,Jordan,1,81,377,65,517,16,-140,D,1,0,0
2010-09-29 00:00:00.000000,New Caledonia,Tahiti,1,1,African Nations Championship,Longjumeau,France,1,154,99,188,19,-34,80,D,1,0,0
2010-09-29 00:00:00.000000,Palestine,Iraq,0,3,WAFF Championship,Amman,Jordan,1,171,50,106,263,65,-213,L,2,0,0
2010-10-01 00:00:00.000000,Iran,Iraq,2,1,WAFF Championship,Amman,Jordan,1,65,517,106,263,-41,254,W,0,0,0
2010-10-01 00:00:00.000000,Kuwait,Yemen,1,1,WAFF Championship,Amman,Jordan,1,85,365,109,249,-24,116,D,1,0,0
2010-10-02 00:00:00.000000,Puerto Rico,Anguilla,3,1,CFU Caribbean Cup qualification,Bayamón,Puerto Rico,0,170,52,202,0,-32,52,W,0,1,0
2010-10-03 00:00:00.000000,Iran,Kuwait,1,2,WAFF Championship,Amman,Jordan,1,65,517,85,365,-20,152,L,2,0,0
2010-10-04 00:00:00.000000,Cayman Islands,Anguilla,4,1,CFU Caribbean Cup qualification,Bayamón,Puerto Rico,1,173,39,202,0,-29,39,W,0,0,0
2010-10-04 00:00:00.000000,India,Hong Kong,0,1,Friendly,Pune,India,0,138,129,133,152,5,-23,L,2,1,0
2010-10-06 00:00:00.000000,Barbados,St. Kitts and Nevis,1,1,CFU Caribbean Cup qualification,Kingstown,St. Vincent and the Grenadines,1,127,174,145,110,-18,64,D,1,0,0
2010-10-06 00:00:00.000000,Puerto Rico,Cayman Islands,2,0,CFU Caribbean Cup qualification,Bayamón,Puerto Rico,0,170,52,173,39,-3,13,W,0,1,0
2010-10-07 00:00:00.000000,Iran,Brazil,0,3,Friendly,Abu Dhabi,United Arab Emirates,1,65,517,3,1524,62,-1007,L,2,0,0
2010-10-08 00:00:00.000000,Armenia,Slovakia,3,1,UEFA Euro qualification,Yerevan,Armenia,0,96,318,27,829,69,-511,W,0,1,0
2010-10-08 00:00:00.000000,Austria,Azerbaijan,3,0,UEFA Euro qualification,Vienna,Austria,0,60,536,105,266,-45,270,W,0,1,0
2010-10-08 00:00:00.000000,Colombia,Ecuador,1,0,Friendly,Harrison,USA,1,36,734,58,545,-22,189,W,0,0,0
2010-10-08 00:00:00.000000,Cyprus,Norway,1,2,UEFA Euro qualification,Larnaca,Cyprus,0,63,523,22,878,41,-355,L,2,1,0
2010-10-08 00:00:00.000000,Czech Republic,Scotland,1,0,UEFA Euro qualification,Prague,Czech Republic,0,31,769,41,699,-10,70,W,0,1,0
2010-10-08 00:00:00.000000,Georgia,Malta,1,0,UEFA Euro qualification,Tbilisi,Georgia,0,110,237,151,105,-41,132,W,0,1,0
2010-10-08 00:00:00.000000,Germany,Turkey,3,0,UEFA Euro qualification,Berlin,Germany,0,4,1464,28,810,-24,654,W,0,1,0
2010-10-08 00:00:00.000000,Greece,Latvia,1,0,UEFA Euro qualification,Piraeus,Greece,0,12,975,49,579,-37,396,W,0,1,0
2010-10-08 00:00:00.000000,Hungary,San Marino,8,0,UEFA Euro qualification,Budapest,Hungary,0,62,534,202,0,-140,534,W,0,1,0
2010-10-08 00:00:00.000000,India,Vietnam,3,1,Friendly,Pune,India,0,138,129,127,174,11,-45,W,0,1,0
2010-10-08 00:00:00.000000,Indonesia,Uruguay,1,7,Friendly,Jakarta,Indonesia,0,135,143,6,1152,129,-1009,L,2,1,0
2010-10-08 00:00:00.000000,Japan,Argentina,1,0,Friendly,Saitama,Japan,0,32,768,5,1288,27,-520,W,0,1,0
2010-10-08 00:00:00.000000,Kazakhstan,Belgium,0,2,UEFA Euro qualification,Astana,Kazakhstan,0,125,184,48,589,77,-405,L,2,1,0
2010-10-08 00:00:00.000000,Kuwait,Bahrain,1,3,Friendly,Kuwait City,Kuwait,0,85,365,68,466,17,-101,L,2,1,0
2010-10-08 00:00:00.000000,Luxembourg,Belarus,0,0,UEFA Euro qualification,Luxembourg,Luxembourg,0,117,209,78,403,39,-194,D,1,1,0
2010-10-08 00:00:00.000000,Moldova,Netherlands,0,1,UEFA Euro qualification,Chişinău,Moldova,0,89,350,2,1659,87,-1309,L,2,1,0
2010-10-08 00:00:00.000000,Montenegro,Switzerland,1,0,UEFA Euro qualification,Podgorica,Montenegro,0,73,448,17,940,56,-492,W,0,1,0
2010-10-08 00:00:00.000000,Montserrat,Barbados,0,5,CFU Caribbean Cup qualification,Kingstown,St. Vincent and the Grenadines,1,202,0,127,174,75,-174,L,2,0,0
2010-10-08 00:00:00.000000,Northern Ireland,Italy,0,0,UEFA Euro qualification,Belfast,Northern Ireland,0,59,540,11,982,48,-442,D,1,1,0
2010-10-08 00:00:00.000000,Oman,Gabon,1,0,Friendly,Muscat,Oman,0,81,377,34,755,47,-378,W,0,1,0
2010-10-08 00:00:00.000000,Panama,El Salvador,1,0,Friendly,Panama City,Panama,0,97,314,86,360,11,-46,W,0,1,0
2010-10-08 00:00:00.000000,Peru,Costa Rica,2,0,Friendly,Lima,Peru,0,39,726,53,562,-14,164,W,0,1,0
2010-10-08 00:00:00.000000,Portugal,Denmark,3,1,UEFA Euro qualification,Porto,Portugal,0,8,1062,29,785,-21,277,W,0,1,0
2010-10-08 00:00:00.000000,Serbia,Estonia,1,3,UEFA Euro qualification,Belgrade,Serbia,0,13,969,94,321,-81,648,L,2,1,0
2010-10-08 00:00:00.000000,Slovenia,Faroe Islands,5,1,UEFA Euro qualification,Ljubljana,Slovenia,0,19,917,118,206,-99,711,W,0,1,0
2010-10-08 00:00:00.000000,Spain,Lithuania,3,1,UEFA Euro qualification,Salamanca,Spain,0,1,1883,52,571,-51,1312,W,0,1,0
2010-10-08 00:00:00.000000,St. Vincent and the Grenadines,St. Kitts and Nevis,1,1,CFU Caribbean Cup qualification,Kingstown,St. Vincent and the Grenadines,0,160,87,145,110,15,-23,D,1,1,0
2010-10-08 00:00:00.000000,Ukraine,Canada,2,2,Friendly,Kyïv,Ukraine,0,24,870,101,287,-77,583,D,1,1,0
2010-10-08 00:00:00.000000,Wales,Bulgaria,0,1,UEFA Euro qualification,Cardiff,Wales,0,84,366,43,672,41,-306,L,2,1,0
2010-10-09 00:00:00.000000,Angola,Guinea-Bissau,1,0,African Cup of Nations qualification,Luanda,Angola,0,87,357,188,19,-101,338,W,0,1,0
2010-10-09 00:00:00.000000,Australia,Paraguay,1,0,Friendly,Sydney,Australia,0,20,911,15,961,5,-50,W,0,1,0
2010-10-09 00:00:00.000000,Burkina Faso,Gambia,3,1,African Cup of Nations qualification,Ouagadougou,Burkina Faso,0,45,646,103,285,-58,361,W,0,1,0
2010-10-09 00:00:00.000000,Cameroon,Congo DR,1,1,African Cup of Nations qualification,Garoua,Cameroon,0,40,710,123,187,-83,523,D,1,1,0
2010-10-09 00:00:00.000000,Comoros,Mozambique,0,1,African Cup of Nations qualification,Mitsamiouli,Comoros,0,172,43,80,381,92,-338,L,2,1,0
2010-10-09 00:00:00.000000,France,Romania,2,0,UEFA Euro qualification,Saint-Denis,France,0,21,890,42,697,-21,193,W,0,1,0
2010-10-09 00:00:00.000000,Guatemala,Belize,4,2,Friendly,San José,Guatemala,0,119,201,180,32,-61,169,W,0,1,0
2010-10-09 00:00:00.000000,Israel,Croatia,1,2,UEFA Euro qualification,Ramat-Gan,Israel,0,38,733,14,968,24,-235,L,2,1,0
2010-10-09 00:00:00.000000,Kenya,Uganda,0,0,African Cup of Nations qualification,Nairobi,Kenya,0,116,210,69,459,47,-249,D,1,1,0
2010-10-09 00:00:00.000000,Malawi,Chad,6,2,African Cup of Nations qualification,Blantyre,Malawi,0,74,424,124,185,-50,239,W,0,1,0
2010-10-09 00:00:00.000000,Mali,Liberia,2,1,African Cup of Nations qualification,Bamako,Mali,0,55,548,156,94,-101,454,W,0,1,0
2010-10-09 00:00:00.000000,New Zealand,Honduras,1,1,Friendly,North Shore,New Zealand,0,54,557,46,627,8,-70,D,1,1,0
2010-10-09 00:00:00.000000,Rwanda,Benin,0,3,African Cup of Nations qualification,Kigali,Rwanda,0,111,235,61,535,50,-300,L,2,1,0
2010-10-09 00:00:00.000000,Saudi Arabia,Uzbekistan,4,0,Friendly,Jeddah,Saudi Arabia,0,70,455,88,351,-18,104,W,0,1,0
2010-10-09 00:00:00.000000,Senegal,Mauritius,7,0,African Cup of Nations qualification,Dakar,Senegal,0,91,338,183,27,-92,311,W,0,1,0
2010-10-09 00:00:00.000000,Tanzania,Morocco,0,1,African Cup of Nations qualification,Dar es Salaam,Tanzania,0,111,235,83,371,28,-136,L,2,1,0
2010-10-09 00:00:00.000000,United Arab Emirates,Chile,0,2,Friendly,Abu Dhabi,United Arab Emirates,0,90,348,10,988,80,-640,L,2,1,0
2010-10-09 00:00:00.000000,USA,Poland,2,2,Friendly,Chicago,USA,0,18,931,56,547,-38,384,D,1,1,0
2010-10-10 00:00:00.000000,Central African Republic,Algeria,2,0,African Cup of Nations qualification,Bangui,Central African Republic,0,202,0,33,759,169,-759,W,0,1,0
2010-10-10 00:00:00.000000,Congo,Swaziland,3,1,African Cup of Nations qualification,Brazzaville,Congo,0,106,263,136,136,-30,127,W,0,1,0
2010-10-10 00:00:00.000000,Ghana,Sudan,0,0,African Cup of Nations qualification,Kumasi,Ghana,0,23,874,120,198,-97,676,D,1,1,0
2010-10-10 00:00:00.000000,Guinea,Nigeria,1,0,African Cup of Nations qualification,Conakry,Guinea,0,102,286,30,773,72,-487,W,0,1,0
2010-10-10 00:00:00.000000,Jamaica,Trinidad and Tobago,1,0,Friendly,Kingston,Jamaica,0,82,372,76,418,6,-46,W,0,1,0
2010-10-10 00:00:00.000000,Libya,Zambia,1,0,African Cup of Nations qualification,Tripoli,Libya,0,94,321,72,449,22,-128,W,0,1,0
2010-10-10 00:00:00.000000,Madagascar,Ethiopia,0,1,African Cup of Nations qualification,Antananarivo,Madagascar,0,148,106,144,116,4,-10,L,2,1,0
2010-10-10 00:00:00.000000,Niger,Egypt,1,0,African Cup of Nations qualification,Niamey,Niger,0,145,110,9,1053,136,-943,W,0,1,0
2010-10-10 00:00:00.000000,Sierra Leone,South Africa,0,0,African Cup of Nations qualification,Freetown,Sierra Leone,0,137,130,66,504,71,-374,D,1,1,0
2010-10-10 00:00:00.000000,St. Kitts and Nevis,Montserrat,4,0,CFU Caribbean Cup qualification,Kingstown,St. Vincent and the Grenadines,1,145,110,202,0,-57,110,W,0,0,0
2010-10-10 00:00:00.000000,Togo,Tunisia,1,2,African Cup of Nations qualification,Lomé,Togo,0,75,421,64,519,11,-98,L,2,1,0
2010-10-11 00:00:00.000000,Brazil,Ukraine,2,0,Friendly,Derby,England,1,3,1524,24,870,-21,654,W,0,0,0
2010-10-12 00:00:00.000000,Armenia,Andorra,4,0,UEFA Euro qualification,Yerevan,Armenia,0,96,318,201,2,-105,316,W,0,1,0
2010-10-12 00:00:00.000000,Azerbaijan,Turkey,1,0,UEFA Euro qualification,Baku,Azerbaijan,0,105,266,28,810,77,-544,W,0,1,0
2010-10-12 00:00:00.000000,Bahrain,Uzbekistan,2,4,Friendly,Riffa,Bahrain,0,68,466,88,351,-20,115,L,2,1,0
2010-10-12 00:00:00.000000,Belarus,Albania,2,0,UEFA Euro qualification,Minsk,Belarus,0,78,403,70,455,8,-52,W,0,1,0
2010-10-12 00:00:00.000000,Belgium,Austria,4,4,UEFA Euro qualification,Brussels,Belgium,0,48,589,60,536,-12,53,D,1,1,0
2010-10-12 00:00:00.000000,Bulgaria,Saudi Arabia,2,0,Friendly,Istanbul,Turkey,1,43,672,70,455,-27,217,W,0,0,0
2010-10-12 00:00:00.000000,Costa Rica,El Salvador,2,1,Friendly,Ciudad Quesada,Costa Rica,0,53,562,86,360,-33,202,W,0,1,0
2010-10-12 00:00:00.000000,Croatia,Norway,2,1,Friendly,Zagreb,Croatia,0,14,968,22,878,-8,90,W,0,1,0
2010-10-12 00:00:00.000000,Denmark,Cyprus,2,0,UEFA Euro qualification,Copenhagen,Denmark,0,29,785,63,523,-34,262,W,0,1,0
2010-10-12 00:00:00.000000,Ecuador,Poland,2,2,Friendly,Montréal,Canada,1,58,545,56,547,2,-2,D,1,0,0
2010-10-12 00:00:00.000000,England,Montenegro,0,0,UEFA Euro qualification,London,England,0,7,1125,73,448,-66,677,D,1,1,0
2010-10-12 00:00:00.000000,Equatorial Guinea,Botswana,2,1,Friendly,Malabo,Equatorial Guinea,0,145,110,93,329,52,-219,W,0,1,0
2010-10-12 00:00:00.000000,Estonia,Slovenia,0,1,UEFA Euro qualification,Tallinn,Estonia,0,94,321,19,917,75,-596,L,2,1,0
2010-10-12 00:00:00.000000,Faroe Islands,Northern Ireland,1,1,UEFA Euro qualification,Toftir,Faroe Islands,0,118,206,59,540,59,-334,D,1,1,0
2010-10-12 00:00:00.000000,Finland,Hungary,1,2,UEFA Euro qualification,Helsinki,Finland,0,51,576,62,534,-11,42,L,2,1,0
2010-10-12 00:00:00.000000,France,Luxembourg,2,0,UEFA Euro qualification,Metz,France,0,21,890,117,209,-96,681,W,0,1,0
2010-10-12 00:00:00.000000,Greece,Israel,2,1,UEFA Euro qualification,Piraeus,Greece,0,12,975,38,733,-26,242,W,0,1,0
2010-10-12 00:00:00.000000,Guatemala,Honduras,0,2,Friendly,Los Angeles,USA,1,119,201,46,627,73,-426,L,2,0,0
2010-10-12 00:00:00.000000,Iceland,Portugal,1,3,UEFA Euro qualification,Reykjavík,Iceland,0,79,385,8,1062,71,-677,L,2,1,0
2010-10-12 00:00:00.000000,Indonesia,Maldives,3,0,Friendly,Jakarta,Indonesia,0,135,143,143,117,-8,26,W,0,1,0
2010-10-12 00:00:00.000000,Italy,Serbia,3,0,UEFA Euro qualification,Genoa,Italy,0,11,982,13,969,-2,13,W,0,1,0
2010-10-12 00:00:00.000000,Kazakhstan,Germany,0,3,UEFA Euro qualification,Astana,Kazakhstan,0,125,184,4,1464,121,-1280,L,2,1,0
2010-10-12 00:00:00.000000,Korea Republic,Japan,0,0,Friendly,Seoul,Korea Republic,0,44,651,32,768,12,-117,D,1,1,0
2010-10-12 00:00:00.000000,Kuwait,Vietnam,3,1,Friendly,Kuwait City,Kuwait,0,85,365,127,174,-42,191,W,0,1,0
2010-10-12 00:00:00.000000,Latvia,Georgia,1,1,UEFA Euro qualification,Riga,Latvia,0,49,579,110,237,-61,342,D,1,1,0
2010-10-12 00:00:00.000000,Liechtenstein,Czech Republic,0,2,UEFA Euro qualification,Vaduz,Liechtenstein,0,141,126,31,769,110,-643,L,2,1,0
2010-10-12 00:00:00.000000,Mexico,Venezuela,2,2,Friendly,Ciudad Juárez,Mexico,0,25,853,47,592,-22,261,D,1,1,0
2010-10-12 00:00:00.000000,Netherlands,Sweden,4,1,UEFA Euro qualification,Amsterdam,Netherlands,0,2,1659,35,747,-33,912,W,0,1,0
2010-10-12 00:00:00.000000,New Zealand,Paraguay,0,2,Friendly,Wellington,New Zealand,0,54,557,15,961,39,-404,L,2,1,0
2010-10-12 00:00:00.000000,Oman,Chile,0,1,Friendly,Muscat,Oman,0,81,377,10,988,71,-611,L,2,1,0
2010-10-12 00:00:00.000000,Panama,Peru,1,0,Friendly,Panama City,Panama,0,97,314,39,726,58,-412,W,0,1,0
2010-10-12 00:00:00.000000,Philippines,Macau,5,0,Dragon Cup,Kaohsiung,Taiwan,1,165,67,196,12,-31,55,W,0,0,0
2010-10-12 00:00:00.000000,Qatar,Iraq,1,2,Friendly,Doha,Qatar,0,98,300,106,263,-8,37,L,2,1,0
2010-10-12 00:00:00.000000,San Marino,Moldova,0,2,UEFA Euro qualification,Serravalle,San Marino,0,202,0,89,350,113,-350,L,2,1,0
2010-10-12 00:00:00.000000,Saudi Arabia,Gabon,1,0,Friendly,Istanbul,Turkey,1,70,455,34,755,36,-300,W,0,0,0
2010-10-12 00:00:00.000000,Scotland,Spain,2,3,UEFA Euro qualification,Glasgow,Scotland,0,41,699,1,1883,40,-1184,L,2,1,0
2010-10-12 00:00:00.000000,Switzerland,Wales,4,1,UEFA Euro qualification,Basel,Switzerland,0,17,940,84,366,-67,574,W,0,1,0
2010-10-12 00:00:00.000000,United Arab Emirates,Angola,0,2,Friendly,Abu Dhabi,United Arab Emirates,0,90,348,87,357,3,-9,L,2,1,0
2010-10-12 00:00:00.000000,USA,Colombia,0,0,Friendly,Chester,USA,0,18,931,36,734,-18,197,D,1,1,0
2010-10-13 00:00:00.000000,Guyana,St. Lucia,1,0,CFU Caribbean Cup qualification,Paramaribo,Suriname,1,122,190,188,19,-66,171,W,0,0,0
2010-10-13 00:00:00.000000,India,Yemen,3,6,Friendly,Pune,India,0,138,129,109,249,29,-120,L,2,1,0
2010-10-14 00:00:00.000000,Dominican Republic,British Virgin Islands,17,0,CFU Caribbean Cup qualification,San Cristóbal,Dominican Republic,0,184,26,191,18,-7,8,W,0,1,0
2010-10-15 00:00:00.000000,British Virgin Islands,Dominica,0,10,CFU Caribbean Cup qualification,San Cristóbal,Dominican Republic,1,191,18,178,33,13,-15,L,2,0,0
2010-10-15 00:00:00.000000,Suriname,St. Lucia,2,1,CFU Caribbean Cup qualification,Paramaribo,Suriname,0,126,181,188,19,-62,162,W,0,1,0
2010-10-17 00:00:00.000000,Dominican Republic,Dominica,0,1,CFU Caribbean Cup qualification,San Cristóbal,Dominican Republic,0,184,26,178,33,6,-7,L,2,1,0
2010-10-17 00:00:00.000000,Suriname,Guyana,0,2,CFU Caribbean Cup qualification,Paramaribo,Suriname,0,126,181,122,190,4,-9,L,2,1,0
2010-10-22 00:00:00.000000,Grenada,Puerto Rico,3,1,CFU Caribbean Cup qualification,St. George's,Grenada,0,132,163,170,52,-38,111,W,0,1,0
2010-10-22 00:00:00.000000,Laos,Cambodia,0,0,AFF Championship,Vientiane,Laos,0,173,39,178,33,-5,6,D,1,1,0
2010-10-24 00:00:00.000000,Grenada,St. Kitts and Nevis,2,0,CFU Caribbean Cup qualification,St. George's,Grenada,0,132,163,145,110,-13,53,W,0,1,0
2010-10-24 00:00:00.000000,Laos,Philippines,2,2,AFF Championship,Vientiane,Laos,0,173,39,165,67,8,-28,D,1,1,0
2010-10-26 00:00:00.000000,Panama,Cuba,0,3,Friendly,Panama City,Panama,0,97,314,114,215,-17,99,L,2,1,0
2010-10-26 00:00:00.000000,Philippines,Cambodia,0,0,AFF Championship,Vientiane,Laos,1,165,67,178,33,-13,34,D,1,0,0
2010-10-26 00:00:00.000000,Puerto Rico,St. Kitts and Nevis,0,1,CFU Caribbean Cup qualification,St. George's,Grenada,1,170,52,145,110,25,-58,L,2,0,0
2010-10-27 00:00:00.000000,Botswana,Swaziland,2,0,Friendly,Lobatse,Botswana,0,93,329,136,136,-43,193,W,0,1,0
2010-11-02 00:00:00.000000,Haiti,Guyana,0,0,CFU Caribbean Cup qualification,San Fernando,Trinidad and Tobago,1,131,166,122,190,9,-24,D,1,0,0
2010-11-02 00:00:00.000000,Singapore,Korea DPR,1,2,VFF Cup,Hanoi,Vietnam,1,120,198,100,288,20,-90,L,2,0,0
2010-11-04 00:00:00.000000,Trinidad and Tobago,Guyana,2,1,CFU Caribbean Cup qualification,San Fernando,Trinidad and Tobago,0,76,418,122,190,-46,228,W,0,1,0
2010-11-04 00:00:00.000000,Vietnam,Singapore,1,1,VFF Cup,Hanoi,Vietnam,0,127,174,120,198,7,-24,D,1,1,0
2010-11-06 00:00:00.000000,Trinidad and Tobago,Haiti,4,0,CFU Caribbean Cup qualification,San Fernando,Trinidad and Tobago,0,76,418,131,166,-55,252,W,0,1,0
2010-11-06 00:00:00.000000,Vietnam,Korea DPR,0,2,VFF Cup,Hanoi,Vietnam,0,127,174,100,288,27,-114,L,2,1,0
2010-11-07 00:00:00.000000,Yemen,Uganda,2,2,Friendly,Sana'a,Yemen,0,109,249,69,459,40,-210,D,1,1,0
2010-11-10 00:00:00.000000,Antigua and Barbuda,Suriname,2,1,CFU Caribbean Cup qualification,St. John's,Antigua and Barbuda,0,129,168,126,181,3,-13,W,0,1,0
2010-11-10 00:00:00.000000,Bahrain,Uganda,0,0,Friendly,Riffa,Bahrain,0,68,466,69,459,-1,7,D,1,1,0
2010-11-10 00:00:00.000000,Cuba,Dominica,4,2,CFU Caribbean Cup qualification,St. John's,Antigua and Barbuda,1,114,215,178,33,-64,182,W,0,0,0
2010-11-10 00:00:00.000000,Yemen,Korea DPR,1,1,Friendly,Sana'a,Yemen,0,109,249,100,288,9,-39,D,1,1,0
2010-11-11 00:00:00.000000,Iraq,India,2,0,Friendly,Sharjah,United Arab Emirates,1,106,263,138,129,-32,134,W,0,0,0
2010-11-12 00:00:00.000000,Antigua and Barbuda,Dominica,0,0,CFU Caribbean Cup qualification,St. John's,Antigua and Barbuda,0,129,168,178,33,-49,135,D,1,1,0
2010-11-12 00:00:00.000000,Suriname,Cuba,3,3,CFU Caribbean Cup qualification,St. John's,Antigua and Barbuda,1,126,181,114,215,12,-34,D,1,0,0
2010-11-14 00:00:00.000000,Antigua and Barbuda,Cuba,0,0,CFU Caribbean Cup qualification,St. John's,Antigua and Barbuda,0,129,168,114,215,15,-47,D,1,1,0
2010-11-14 00:00:00.000000,Bahrain,Syria,0,2,Friendly,Riffa,Bahrain,0,68,466,92,336,-24,130,L,2,1,0
2010-11-14 00:00:00.000000,Dominica,Suriname,0,5,CFU Caribbean Cup qualification,St. John's,Antigua and Barbuda,1,178,33,126,181,52,-148,L,2,0,0
2010-11-14 00:00:00.000000,India,Kuwait,1,9,Friendly,Abu Dhabi,United Arab Emirates,1,138,129,85,365,53,-236,L,2,0,0
2010-11-17 00:00:00.000000,Argentina,Brazil,1,0,Friendly,Doha,Qatar,1,5,1353,3,1493,2,-140,W,0,0,0
2010-11-17 00:00:00.000000,Austria,Greece,1,2,Friendly,Vienna,Austria,0,49,572,11,1043,38,-471,L,2,1,0
2010-11-17 00:00:00.000000,Botswana,Tunisia,1,0,African Cup of Nations qualification,Gaborone,Botswana,0,67,470,44,598,23,-128,W,0,1,0
2010-11-17 00:00:00.000000,Bulgaria,Serbia,0,1,Friendly,Sofia,Bulgaria,0,45,597,25,828,20,-231,L,2,1,0
2010-11-17 00:00:00.000000,Burkina Faso,Guinea,2,1,Friendly,Mantes-la-Ville,France,1,41,630,47,575,-6,55,W,0,0,0
2010-11-17 00:00:00.000000,Chile,Uruguay,2,0,Friendly,Santiago,Chile,0,16,929,7,1174,9,-245,W,0,1,0
2010-11-17 00:00:00.000000,Colombia,Peru,1,1,Friendly,Bogotá,Colombia,0,47,575,52,538,-5,37,D,1,1,0
2010-11-17 00:00:00.000000,Croatia,Malta,3,0,UEFA Euro qualification,Zagreb,Croatia,0,9,1098,169,77,-160,1021,W,0,1,0
2010-11-17 00:00:00.000000,Denmark,Czech Republic,0,0,Friendly,Århus,Denmark,0,27,812,31,756,-4,56,D,1,1,0
2010-11-17 00:00:00.000000,Ecuador,Venezuela,4,1,Friendly,Quito,Ecuador,0,61,498,56,527,5,-29,W,0,1,0
2010-11-17 00:00:00.000000,Egypt,Australia,3,0,Friendly,Cairo,Egypt,0,10,1047,20,853,-10,194,W,0,1,0
2010-11-17 00:00:00.000000,England,France,1,2,Friendly,London,England,0,6,1250,21,852,-15,398,L,2,1,0
2010-11-17 00:00:00.000000,Estonia,Liechtenstein,1,1,Friendly,Tallinn,Estonia,0,74,444,158,91,-84,353,D,1,1,0
2010-11-17 00:00:00.000000,Finland,San Marino,8,0,UEFA Euro qualification,Helsinki,Finland,0,87,389,203,0,-116,389,W,0,1,0
2010-11-17 00:00:00.000000,Gabon,Senegal,1,2,Friendly,Saint-Gratien,France,1,37,673,75,443,-38,230,L,2,0,0
2010-11-17 00:00:00.000000,Guatemala,Guyana,3,0,Friendly,Kennesaw,USA,1,126,217,86,392,40,-175,W,0,0,0
2010-11-17 00:00:00.000000,Hong Kong,Paraguay,0,7,Friendly,So Kon Po,Hong Kong,0,145,128,23,850,122,-722,L,2,1,0
2010-11-17 00:00:00.000000,Hungary,Lithuania,2,0,Friendly,Székesfehérvár,Hungary,0,43,615,46,576,-3,39,W,0,1,0
2010-11-17 00:00:00.000000,Iraq,Kuwait,1,1,Friendly,Abu Dhabi,United Arab Emirates,1,99,337,105,316,-6,21,D,1,0,0
2010-11-17 00:00:00.000000,Israel,Iceland,3,2,Friendly,Jaffa,Israel,0,55,535,110,275,-55,260,W,0,1,0
2010-11-17 00:00:00.000000,Italy,Romania,1,1,Friendly,Klagenfurt,Austria,1,14,995,52,538,-38,457,D,1,0,0
2010-11-17 00:00:00.000000,Jamaica,Costa Rica,0,0,Friendly,Fort Lauderdale,USA,1,82,413,63,490,19,-77,D,1,0,0
2010-11-17 00:00:00.000000,Libya,Niger,1,1,Friendly,Tripoli,Libya,0,81,414,102,324,-21,90,D,1,1,0
2010-11-17 00:00:00.000000,Luxembourg,Algeria,0,0,Friendly,Luxembourg,Luxembourg,0,133,175,34,706,99,-531,D,1,1,0
2010-11-17 00:00:00.000000,Malawi,Rwanda,2,1,Friendly,Blantyre,Malawi,0,77,423,127,215,-50,208,W,0,1,0
2010-11-17 00:00:00.000000,Mali,Congo DR,3,1,Friendly,Évreux,France,1,64,480,129,196,-65,284,W,0,0,0
2010-11-17 00:00:00.000000,Montenegro,Azerbaijan,2,0,Friendly,Podgorica,Montenegro,0,26,827,90,381,-64,446,W,0,1,0
2010-11-17 00:00:00.000000,Mozambique,Zimbabwe,1,3,Friendly,Maputo,Mozambique,0,98,339,118,246,-20,93,L,2,1,0
2010-11-17 00:00:00.000000,Netherlands,Turkey,1,0,Friendly,Amsterdam,Netherlands,0,2,1718,29,788,-27,930,W,0,1,0
2010-11-17 00:00:00.000000,Northern Ireland,Morocco,1,1,Friendly,Belfast,Northern Ireland,0,42,627,80,415,-38,212,D,1,1,0
2010-11-17 00:00:00.000000,Oman,Belarus,0,4,Friendly,Muscat,Oman,0,97,340,40,648,57,-308,L,2,1,0
2010-11-17 00:00:00.000000,Panama,Honduras,2,0,Friendly,Panama City,Panama,0,64,480,57,522,7,-42,W,0,1,0
2010-11-17 00:00:00.000000,Portugal,Spain,4,0,Friendly,Lisbon,Portugal,0,8,1102,1,1920,7,-818,W,0,1,0
2010-11-17 00:00:00.000000,Russia,Belgium,0,2,Friendly,Voronezh,Russia,0,13,1003,62,494,-49,509,L,2,1,0
2010-11-17 00:00:00.000000,Saudi Arabia,Ghana,0,0,Friendly,Dubai,United Arab Emirates,1,68,461,17,903,51,-442,D,1,0,0
2010-11-17 00:00:00.000000,Slovenia,Georgia,1,2,Friendly,Koper,Slovenia,0,15,958,78,422,-63,536,L,2,1,0
2010-11-17 00:00:00.000000,South Africa,USA,0,1,Friendly,Cape Town,South Africa,0,50,562,24,847,26,-285,L,2,1,0
2010-11-17 00:00:00.000000,Sweden,Germany,0,0,Friendly,Gothenburg,Sweden,0,35,703,4,1489,31,-786,D,1,1,0
2010-11-17 00:00:00.000000,Switzerland,Ukraine,2,2,Friendly,Geneva,Switzerland,0,21,852,36,698,-15,154,D,1,1,0
2010-11-17 00:00:00.000000,Tajikistan,Afghanistan,1,0,Friendly,Dushanbe,Tajikistan,0,149,121,195,10,-46,111,W,0,1,0
2010-11-17 00:00:00.000000,Togo,Chad,0,0,African Cup of Nations qualification,Lomé,Togo,0,107,299,147,126,-40,173,D,1,1,0
2010-11-18 00:00:00.000000,Qatar,Haiti,0,1,Friendly,Doha,Qatar,0,113,259,101,335,12,-76,L,2,1,0
2010-11-18 00:00:00.000000,United Arab Emirates,India,5,0,Friendly,Dubai,United Arab Emirates,0,104,318,142,145,-38,173,W,0,1,0
2010-11-22 00:00:00.000000,Kuwait,Qatar,1,0,Gulf Cup,Aden,Yemen,1,105,316,113,259,-8,57,W,0,0,0
2010-11-22 00:00:00.000000,Yemen,Saudi Arabia,0,4,Gulf Cup,Aden,Yemen,0,122,230,68,461,54,-231,L,2,1,0
2010-11-23 00:00:00.000000,Iraq,United Arab Emirates,0,0,Gulf Cup,Aden,Yemen,1,99,337,104,318,-5,19,D,1,0,0
2010-11-23 00:00:00.000000,Oman,Bahrain,1,1,Gulf Cup,Aden,Yemen,1,97,340,87,389,10,-49,D,1,0,0
2010-11-23 00:00:00.000000,Tanzania,Kenya,1,0,Friendly,Dar es Salaam,Tanzania,0,124,225,116,251,8,-26,W,0,1,0
2010-11-25 00:00:00.000000,Saudi Arabia,Kuwait,0,0,Gulf Cup,Zinjibar,Yemen,1,68,461,105,316,-37,145,D,1,0,0
2010-11-25 00:00:00.000000,Yemen,Qatar,1,2,Gulf Cup,Zinjibar,Yemen,0,122,230,113,259,9,-29,L,2,1,0
2010-11-26 00:00:00.000000,Bahrain,Iraq,2,3,Gulf Cup,Aden,Yemen,1,87,389,99,337,-12,52,L,2,0,0
2010-11-26 00:00:00.000000,Singapore,Laos,4,0,Friendly,Singapore,Singapore,0,138,168,171,70,-33,98,W,0,1,0
2010-11-26 00:00:00.000000,Trinidad and Tobago,Cuba,0,2,CFU Caribbean Cup,Fort-de-France,Martinique,1,78,422,94,353,-16,69,L,2,0,0
2010-11-26 00:00:00.000000,United Arab Emirates,Oman,0,0,Gulf Cup,Aden,Yemen,1,104,318,97,340,7,-22,D,1,0,0
2010-11-27 00:00:00.000000,Jamaica,Antigua and Barbuda,3,1,CFU Caribbean Cup,Rivière-Pilote,Martinique,1,82,413,115,253,-33,160,W,0,0,0
2010-11-27 00:00:00.000000,Tanzania,Zambia,0,1,CECAFA Cup,Dar es Salaam,Tanzania,0,124,225,69,457,55,-232,L,2,1,0
2010-11-28 00:00:00.000000,Burundi,Somalia,2,0,CECAFA Cup,Dar es Salaam,Tanzania,1,136,171,180,39,-44,132,W,0,0,0
2010-11-28 00:00:00.000000,Grenada,Trinidad and Tobago,1,0,CFU Caribbean Cup,Fort-de-France,Martinique,1,91,375,78,422,13,-47,W,0,0,0
2010-11-28 00:00:00.000000,Qatar,Saudi Arabia,1,1,Gulf Cup,Aden,Yemen,1,113,259,68,461,45,-202,D,1,0,0
2010-11-28 00:00:00.000000,Yemen,Kuwait,0,3,Gulf Cup,Zinjibar,Yemen,0,122,230,105,316,17,-86,L,2,1,0
2010-11-29 00:00:00.000000,Antigua and Barbuda,Guyana,1,0,CFU Caribbean Cup,Rivière-Pilote,Martinique,1,115,253,86,392,29,-139,W,0,0,0
2010-11-29 00:00:00.000000,Malawi,Kenya,3,2,CECAFA Cup,Dar es Salaam,Tanzania,1,77,423,116,251,-39,172,W,0,0,0
2010-11-29 00:00:00.000000,Oman,Iraq,0,0,Gulf Cup,Zinjibar,Yemen,1,97,340,99,337,-2,3,D,1,0,0
2010-11-29 00:00:00.000000,Uganda,Ethiopia,2,1,CECAFA Cup,Dar es Salaam,Tanzania,1,69,457,131,178,-62,279,W,0,0,0
2010-11-29 00:00:00.000000,United Arab Emirates,Bahrain,3,1,Gulf Cup,Zinjibar,Yemen,1,104,318,87,389,17,-71,W,0,0,0
2010-11-30 00:00:00.000000,Cuba,Grenada,0,0,CFU Caribbean Cup,Fort-de-France,Martinique,1,94,353,91,375,3,-22,D,1,0,0
2010-11-30 00:00:00.000000,Tanzania,Somalia,3,0,CECAFA Cup,Dar es Salaam,Tanzania,0,124,225,180,39,-56,186,W,0,1,0
2010-11-30 00:00:00.000000,Zambia,Burundi,0,0,CECAFA Cup,Dar es Salaam,Tanzania,1,69,457,136,171,-67,286,D,1,0,0
2010-12-01 00:00:00.000000,Guyana,Jamaica,0,4,CFU Caribbean Cup,Rivière-Pilote,Martinique,1,86,392,82,413,4,-21,L,2,0,0
2010-12-01 00:00:00.000000,Indonesia,Malaysia,5,1,AFF Championship,Jakarta,Indonesia,0,135,172,150,112,-15,60,W,0,1,0
2010-12-01 00:00:00.000000,Sudan,Rwanda,0,0,CECAFA Cup,Dar es Salaam,Tanzania,1,96,344,127,215,-31,129,D,1,0,0
2010-12-01 00:00:00.000000,Thailand,Laos,2,2,AFF Championship,Jakarta,Indonesia,1,114,254,171,70,-57,184,D,1,0,0
2010-12-02 00:00:00.000000,Ethiopia,Kenya,2,1,CECAFA Cup,Dar es Salaam,Tanzania,1,131,178,116,251,15,-73,W,0,0,0
2010-12-02 00:00:00.000000,Kuwait,Iraq,2,2,Gulf Cup,Aden,Yemen,1,105,316,99,337,6,-21,D,1,0,0
2010-12-02 00:00:00.000000,Malawi,Uganda,1,1,CECAFA Cup,Dar es Salaam,Tanzania,1,77,423,69,457,8,-34,D,1,0,0
2010-12-02 00:00:00.000000,Singapore,Philippines,1,1,AFF Championship,Hanoi,Vietnam,1,138,168,151,109,-13,59,D,1,0,0
2010-12-02 00:00:00.000000,United Arab Emirates,Saudi Arabia,0,1,Gulf Cup,Aden,Yemen,1,104,318,68,461,36,-143,L,2,0,0
2010-12-03 00:00:00.000000,Jamaica,Grenada,2,1,CFU Caribbean Cup,Fort-de-France,Martinique,1,82,413,91,375,-9,38,W,0,0,0
2010-12-03 00:00:00.000000,Zambia,Somalia,6,0,CECAFA Cup,Dar es Salaam,Tanzania,1,69,457,180,39,-111,418,W,0,0,0
2010-12-04 00:00:00.000000,Indonesia,Laos,6,0,AFF Championship,Jakarta,Indonesia,0,135,172,171,70,-36,102,W,0,1,0
2010-12-04 00:00:00.000000,Thailand,Malaysia,0,0,AFF Championship,Jakarta,Indonesia,1,114,254,150,112,-36,142,D,1,0,0
2010-12-05 00:00:00.000000,Grenada,Cuba,0,1,CFU Caribbean Cup,Fort-de-France,Martinique,1,91,375,94,353,-3,22,L,2,0,0
2010-12-05 00:00:00.000000,Kuwait,Saudi Arabia,1,0,Gulf Cup,Aden,Yemen,1,105,316,68,461,37,-145,W,0,0,0
2010-12-05 00:00:00.000000,Uganda,Kenya,2,0,CECAFA Cup,Dar es Salaam,Tanzania,1,69,457,116,251,-47,206,W,0,0,0
2010-12-05 00:00:00.000000,Vietnam,Philippines,0,2,AFF Championship,Hanoi,Vietnam,0,139,157,151,109,-12,48,L,2,1,0
2010-12-07 00:00:00.000000,Indonesia,Thailand,2,1,AFF Championship,Jakarta,Indonesia,0,135,172,114,254,21,-82,W,0,1,0
2010-12-07 00:00:00.000000,Malaysia,Laos,5,1,AFF Championship,Palembang,Indonesia,1,150,112,171,70,-21,42,W,0,0,0
2010-12-07 00:00:00.000000,Zambia,Ethiopia,1,2,CECAFA Cup,Dar es Salaam,Tanzania,1,69,457,131,178,-62,279,L,2,0,0
2010-12-08 00:00:00.000000,Tanzania,Rwanda,1,0,CECAFA Cup,Dar es Salaam,Tanzania,0,124,225,127,215,-3,10,W,0,1,0
2010-12-08 00:00:00.000000,Vietnam,Singapore,1,0,AFF Championship,Hanoi,Vietnam,0,139,157,138,168,1,-11,W,0,1,0
2010-12-10 00:00:00.000000,Tanzania,Uganda,0,0,CECAFA Cup,Dar es Salaam,Tanzania,0,124,225,69,457,55,-232,D,1,1,0
2010-12-12 00:00:00.000000,Ethiopia,Uganda,3,4,CECAFA Cup,Dar es Salaam,Tanzania,1,131,178,69,457,62,-279,L,2,0,0
2010-12-15 00:00:00.000000,Malaysia,Vietnam,2,0,AFF Championship,Kuala Lumpur,Malaysia,0,150,112,139,157,11,-45,W,0,1,0
2010-12-16 00:00:00.000000,Indonesia,Philippines,1,0,AFF Championship,Jakarta,Indonesia,0,135,172,151,109,-16,63,W,0,1,0
2010-12-16 00:00:00.000000,Qatar,Egypt,2,1,Friendly,Doha,Qatar,0,113,259,10,1047,103,-788,W,0,1,0
2010-12-18 00:00:00.000000,Honduras,Panama,2,1,Friendly,San Pedro Sula,Honduras,0,57,522,64,480,-7,42,W,0,1,0
2010-12-18 00:00:00.000000,Iraq,Syria,0,1,Friendly,Sulaymaniyah,Iraq,0,99,337,109,282,-10,55,L,2,1,0
2010-12-18 00:00:00.000000,Vietnam,Malaysia,0,0,AFF Championship,Hanoi,Vietnam,0,139,157,150,112,-11,45,D,1,1,0
2010-12-19 00:00:00.000000,Indonesia,Philippines,1,0,AFF Championship,Jakarta,Indonesia,0,135,172,151,109,-16,63,W,0,1,0
2010-12-22 00:00:00.000000,Qatar,Estonia,2,0,Friendly,Doha,Qatar,0,113,259,74,444,39,-185,W,0,1,0
2010-12-22 00:00:00.000000,Syria,Iraq,0,1,Friendly,Damascus,Syria,0,109,282,99,337,10,-55,L,2,1,0
2010-12-24 00:00:00.000000,Kuwait,Korea DPR,2,1,Friendly,6th of October City,Egypt,1,105,316,107,299,-2,17,W,0,0,0
2010-12-25 00:00:00.000000,Bahrain,Uzbekistan,1,1,Friendly,Dubai,United Arab Emirates,1,87,389,106,303,-19,86,D,1,0,0
2010-12-26 00:00:00.000000,Malaysia,Indonesia,3,0,AFF Championship,Kuala Lumpur,Malaysia,0,150,112,135,172,15,-60,W,0,1,0
2010-12-27 00:00:00.000000,Kuwait,Korea DPR,2,2,Friendly,6th of October City,Egypt,1,105,316,107,299,-2,17,D,1,0,0
2010-12-28 00:00:00.000000,Bahrain,Jordan,2,1,Friendly,Dubai,United Arab Emirates,1,87,389,95,352,-8,37,W,0,0,0
2010-12-28 00:00:00.000000,Saudi Arabia,Iraq,0,1,Friendly,Dammam,Saudi Arabia,0,68,461,99,337,-31,124,L,2,1,0
2010-12-29 00:00:00.000000,Indonesia,Malaysia,2,1,AFF Championship,Jakarta,Indonesia,0,135,172,150,112,-15,60,W,0,1,0
2010-12-30 00:00:00.000000,Syria,Korea Republic,0,1,Friendly,Abu Dhabi,United Arab Emirates,1,109,282,39,653,70,-371,L,2,0,0
2010-12-31 00:00:00.000000,Kuwait,Zambia,4,0,Friendly,6th of October City,Egypt,1,105,316,69,457,36,-141,W,0,0,0
2010-12-31 00:00:00.000000,Qatar,Korea DPR,0,1,Friendly,Doha,Qatar,0,113,259,107,299,6,-40,L,2,1,0
2011-01-02 00:00:00.000000,Iran,Angola,1,0,Friendly,Doha,Qatar,1,66,479,92,370,-26,109,W,0,0,0
2011-01-02 00:00:00.000000,Jordan,Uzbekistan,2,2,Friendly,Dubai,United Arab Emirates,1,95,352,106,303,-11,49,D,1,0,0
2011-01-02 00:00:00.000000,United Arab Emirates,Syria,2,0,Friendly,Al Ain,United Arab Emirates,0,104,318,109,282,-5,36,W,0,1,0
2011-01-04 00:00:00.000000,Bahrain,Korea DPR,0,1,Friendly,Riffa,Bahrain,0,87,389,107,299,-20,90,L,2,1,0
2011-01-04 00:00:00.000000,Saudi Arabia,Angola,0,0,Friendly,Dammam,Saudi Arabia,0,68,461,92,370,-24,91,D,1,1,0
2011-01-05 00:00:00.000000,Egypt,Tanzania,5,1,Nile Basin Tournament,Cairo,Egypt,0,10,1047,124,225,-114,822,W,0,1,0
2011-01-05 00:00:00.000000,Kenya,Sudan,1,0,Nile Basin Tournament,Cairo,Egypt,1,116,251,96,344,20,-93,W,0,0,0
2011-01-05 00:00:00.000000,Uganda,Burundi,3,1,Nile Basin Tournament,Cairo,Egypt,1,69,457,136,171,-67,286,W,0,0,0
2011-01-05 00:00:00.000000,United Arab Emirates,Australia,0,0,Friendly,al-Ain,United Arab Emirates,0,104,318,20,853,84,-535,D,1,1,0
2011-01-07 00:00:00.000000,Qatar,Uzbekistan,0,2,AFC Asian Cup,Doha,Qatar,0,113,259,106,303,7,-44,L,2,1,0
2011-01-08 00:00:00.000000,Congo DR,Kenya,1,0,Nile Basin Tournament,Cairo,Egypt,1,129,196,116,251,13,-55,W,0,0,0
2011-01-08 00:00:00.000000,Egypt,Uganda,1,0,Nile Basin Tournament,Cairo,Egypt,0,10,1047,69,457,-59,590,W,0,1,0
2011-01-08 00:00:00.000000,Tanzania,Burundi,1,1,Nile Basin Tournament,Cairo,Egypt,1,124,225,136,171,-12,54,D,1,0,0
2011-01-09 00:00:00.000000,Japan,Jordan,1,1,AFC Asian Cup,Doha,Qatar,1,30,781,95,352,-65,429,D,1,0,0
2011-01-09 00:00:00.000000,Saudi Arabia,Syria,1,2,AFC Asian Cup,Rayyan,Qatar,1,68,461,109,282,-41,179,L,2,0,0
2011-01-10 00:00:00.000000,India,Australia,0,4,AFC Asian Cup,Doha,Qatar,1,142,145,20,853,122,-708,L,2,0,0
2011-01-10 00:00:00.000000,Korea Republic,Bahrain,2,1,AFC Asian Cup,Doha,Qatar,1,39,653,87,389,-48,264,W,0,0,0
2011-01-12 00:00:00.000000,Uzbekistan,Kuwait,2,1,AFC Asian Cup,Doha,Qatar,1,108,285,99,328,9,-43,W,0,0,0
2011-01-13 00:00:00.000000,Jordan,Saudi Arabia,1,0,AFC Asian Cup,Rayyan,Qatar,1,107,286,78,423,29,-137,W,0,0,0
2011-01-13 00:00:00.000000,Syria,Japan,1,2,AFC Asian Cup,Doha,Qatar,1,110,277,29,776,81,-499,L,2,0,0
2011-01-14 00:00:00.000000,Australia,Korea Republic,1,1,AFC Asian Cup,Doha,Qatar,1,26,796,39,649,-13,147,D,1,0,0
2011-01-14 00:00:00.000000,Bahrain,India,5,2,AFC Asian Cup,Doha,Qatar,1,93,351,144,132,-51,219,W,0,0,0
2011-01-14 00:00:00.000000,Congo DR,Uganda,0,1,Nile Basin Tournament,Cairo,Egypt,1,128,211,83,416,45,-205,L,2,0,0
2011-01-14 00:00:00.000000,Costa Rica,Honduras,1,1,UNCAF Cup,Panama City,Panama,1,69,467,56,531,13,-64,D,1,0,0
2011-01-14 00:00:00.000000,Egypt,Kenya,5,1,Nile Basin Tournament,Cairo,Egypt,0,10,1036,125,225,-115,811,W,0,1,0
2011-01-14 00:00:00.000000,El Salvador,Nicaragua,2,0,UNCAF Cup,Panama City,Panama,1,116,251,157,86,-41,165,W,0,0,0
2011-01-14 00:00:00.000000,Panama,Belize,2,0,UNCAF Cup,Panama City,Panama,0,67,475,173,54,-106,421,W,0,1,0
2011-01-15 00:00:00.000000,Iran,Korea DPR,1,0,AFC Asian Cup,Doha,Qatar,1,65,491,109,283,-44,208,W,0,0,0
2011-01-15 00:00:00.000000,United Arab Emirates,Iraq,0,1,AFC Asian Cup,Rayyan,Qatar,1,102,304,98,334,4,-30,L,2,0,0
2011-01-16 00:00:00.000000,Belize,El Salvador,2,5,UNCAF Cup,Panama City,Panama,1,173,54,116,251,57,-197,L,2,0,0
2011-01-16 00:00:00.000000,Guatemala,Costa Rica,0,2,UNCAF Cup,Panama City,Panama,1,117,247,69,467,48,-220,L,2,0,0
2011-01-16 00:00:00.000000,Panama,Nicaragua,2,0,UNCAF Cup,Panama City,Panama,0,67,475,157,86,-90,389,W,0,1,0
2011-01-16 00:00:00.000000,Qatar,Kuwait,3,0,AFC Asian Cup,Doha,Qatar,0,105,290,99,328,6,-38,W,0,1,0
2011-01-16 00:00:00.000000,Tanzania,Sudan,0,2,Nile Basin Tournament,Cairo,Egypt,1,120,243,100,314,20,-71,L,2,0,0
2011-01-17 00:00:00.000000,Congo DR,Kenya,1,0,Nile Basin Tournament,Ismailia,Egypt,1,128,211,125,225,3,-14,W,0,0,0
2011-01-17 00:00:00.000000,Egypt,Uganda,3,1,Nile Basin Tournament,Ismailia,Egypt,0,10,1036,83,416,-73,620,W,0,1,0
2011-01-17 00:00:00.000000,Jordan,Syria,2,1,AFC Asian Cup,Doha,Qatar,1,107,286,110,277,-3,9,W,0,0,0
2011-01-17 00:00:00.000000,Saudi Arabia,Japan,0,5,AFC Asian Cup,Rayyan,Qatar,1,78,423,29,776,49,-353,L,2,0,0
2011-01-18 00:00:00.000000,Australia,Bahrain,1,0,AFC Asian Cup,Doha,Qatar,1,26,796,93,351,-67,445,W,0,0,0
2011-01-18 00:00:00.000000,Honduras,Guatemala,3,1,UNCAF Cup,Panama City,Panama,1,56,531,117,247,-61,284,W,0,0,0
2011-01-18 00:00:00.000000,Korea Republic,India,4,1,AFC Asian Cup,Doha,Qatar,1,39,649,144,132,-105,517,W,0,0,0
2011-01-18 00:00:00.000000,Nicaragua,Belize,1,1,UNCAF Cup,Panama City,Panama,1,157,86,173,54,-16,32,D,1,0,0
2011-01-18 00:00:00.000000,Panama,El Salvador,2,0,UNCAF Cup,Panama City,Panama,0,67,475,116,251,-49,224,W,0,1,0
2011-01-19 00:00:00.000000,Botswana,Sweden,1,2,Friendly,Cape Town,South Africa,1,54,535,33,712,21,-177,L,2,0,0
2011-01-19 00:00:00.000000,Iraq,Korea DPR,1,0,AFC Asian Cup,Rayyan,Qatar,1,98,334,109,283,-11,51,W,0,0,0
2011-01-19 00:00:00.000000,United Arab Emirates,Iran,0,3,AFC Asian Cup,Doha,Qatar,1,102,304,65,491,37,-187,L,2,0,0
2011-01-21 00:00:00.000000,Honduras,El Salvador,2,0,UNCAF Cup,Panama City,Panama,1,56,531,116,251,-60,280,W,0,0,0
2011-01-21 00:00:00.000000,Nicaragua,Guatemala,1,2,UNCAF Cup,Panama City,Panama,1,157,86,117,247,40,-161,L,2,0,0
2011-01-21 00:00:00.000000,Panama,Costa Rica,1,1,UNCAF Cup,Panama City,Panama,0,67,475,69,467,-2,8,D,1,1,0
2011-01-21 00:00:00.000000,Qatar,Japan,2,3,AFC Asian Cup,Doha,Qatar,0,105,290,29,776,76,-486,L,2,1,0
2011-01-21 00:00:00.000000,Uzbekistan,Jordan,2,1,AFC Asian Cup,Doha,Qatar,1,108,285,107,286,1,-1,W,0,0,0
2011-01-22 00:00:00.000000,Australia,Iraq,1,0,AFC Asian Cup,Doha,Qatar,1,26,796,98,334,-72,462,W,0,0,0
2011-01-22 00:00:00.000000,Iran,Korea Republic,0,1,AFC Asian Cup,Doha,Qatar,1,65,491,39,649,26,-158,L,2,0,0
2011-01-22 00:00:00.000000,USA,Chile,1,1,Friendly,Carson,USA,0,18,867,15,950,3,-83,D,1,1,0
2011-01-23 00:00:00.000000,Honduras,Costa Rica,2,1,UNCAF Cup,Panama City,Panama,1,56,531,69,467,-13,64,W,0,0,0
2011-01-23 00:00:00.000000,Panama,El Salvador,0,0,UNCAF Cup,Panama City,Panama,0,67,475,116,251,-49,224,D,1,1,0
2011-01-24 00:00:00.000000,Vanuatu,New Caledonia,0,0,Friendly,Port Vila,Vanuatu,0,166,67,155,89,11,-22,D,1,1,0
2011-01-25 00:00:00.000000,Japan,Korea Republic,2,2,AFC Asian Cup,Doha,Qatar,1,29,776,39,649,-10,127,D,1,0,0
2011-01-25 00:00:00.000000,Uzbekistan,Australia,0,6,AFC Asian Cup,Doha,Qatar,1,108,285,26,796,82,-511,L,2,0,0
2011-01-28 00:00:00.000000,Uzbekistan,Korea Republic,2,3,AFC Asian Cup,Doha,Qatar,1,108,285,39,649,69,-364,L,2,0,0
2011-01-29 00:00:00.000000,Australia,Japan,0,1,AFC Asian Cup,Doha,Qatar,1,26,796,29,776,-3,20,L,2,0,0
2011-02-06 00:00:00.000000,Moldova,Poland,0,1,Friendly,Vila Real de Santo António,Portugal,1,84,411,72,449,12,-38,L,2,0,0
2011-02-08 00:00:00.000000,Cyprus,Sweden,0,2,Cyprus International Tournament,Nicosia,Cyprus,0,89,367,33,712,56,-345,L,2,1,0
2011-02-08 00:00:00.000000,Ghana,Togo,4,1,Friendly,Antwerp,Belgium,1,16,924,101,313,-85,611,W,0,0,0
2011-02-08 00:00:00.000000,Peru,Panama,1,0,Friendly,Moquegua,Peru,0,66,486,67,475,-1,11,W,0,1,0
2011-02-08 00:00:00.000000,Romania,Ukraine,2,2,Cyprus International Tournament,Paralímni,Cyprus,1,56,531,34,702,22,-171,D,1,0,0
2011-02-09 00:00:00.000000,Albania,Slovenia,1,2,Friendly,Tirana,Albania,0,64,497,17,897,47,-400,L,2,1,0
2011-02-09 00:00:00.000000,Andorra,Moldova,1,2,Friendly,Lagos,Portugal,1,202,2,84,411,118,-409,L,2,0,0
2011-02-09 00:00:00.000000,Argentina,Portugal,2,1,Friendly,Geneva,Switzerland,1,5,1338,8,1090,-3,248,W,0,0,0
2011-02-09 00:00:00.000000,Armenia,Georgia,1,2,Friendly,Limassol,Cyprus,1,60,515,72,449,-12,66,L,2,0,0
2011-02-09 00:00:00.000000,Azerbaijan,Hungary,0,2,Friendly,Dubai,United Arab Emirates,1,97,343,41,632,56,-289,L,2,0,0
2011-02-09 00:00:00.000000,Belarus,Kazakhstan,1,1,Friendly,Antalya,Turkey,1,37,660,137,161,-100,499,D,1,0,0
2011-02-09 00:00:00.000000,Belgium,Finland,1,1,Friendly,Ghent,Belgium,0,58,526,79,419,-21,107,D,1,1,0
2011-02-09 00:00:00.000000,Cambodia,Macau,3,1,AFC Challenge Cup qualification,Phnom Penh,Cambodia,0,165,68,193,14,-28,54,W,0,1,0
2011-02-09 00:00:00.000000,Congo DR,Gabon,0,2,Friendly,Rouen,France,1,128,211,40,640,88,-429,L,2,0,0
2011-02-09 00:00:00.000000,Croatia,Czech Republic,4,2,Friendly,Pula,Croatia,0,9,1075,30,751,-21,324,W,0,1,0
2011-02-09 00:00:00.000000,Cyprus,Romania,1,1,Cyprus International Tournament,Paralímni,Cyprus,0,89,367,56,531,33,-164,D,1,1,0
2011-02-09 00:00:00.000000,Denmark,England,1,2,Friendly,Copenhagen,Denmark,0,28,790,6,1195,22,-405,L,2,1,0
2011-02-09 00:00:00.000000,El Salvador,Haiti,1,0,Friendly,San Salvador,El Salvador,0,116,251,90,358,26,-107,W,0,1,0
2011-02-09 00:00:00.000000,France,Brazil,1,0,Friendly,Saint-Denis,France,0,18,867,4,1446,14,-579,W,0,1,0
2011-02-09 00:00:00.000000,Germany,Italy,1,1,Friendly,Dortmund,Germany,0,3,1485,14,965,-11,520,D,1,1,0
2011-02-09 00:00:00.000000,Greece,Canada,1,0,Friendly,Lárisa,Greece,0,11,1016,84,411,-73,605,W,0,1,0
2011-02-09 00:00:00.000000,Guinea-Bissau,Gambia,3,1,Friendly,Amadora,Portugal,1,147,121,105,290,42,-169,W,0,0,0
2011-02-09 00:00:00.000000,Honduras,Ecuador,1,1,Friendly,La Ceiba,Honduras,0,56,531,52,542,4,-11,D,1,1,0
2011-02-09 00:00:00.000000,Iran,Russia,1,0,Friendly,Abu Dhabi,United Arab Emirates,1,65,491,13,982,52,-491,W,0,0,0
2011-02-09 00:00:00.000000,Israel,Serbia,0,2,Friendly,Jaffa,Israel,0,50,551,23,837,27,-286,L,2,1,0
2011-02-09 00:00:00.000000,Latvia,Bolivia,2,1,Friendly,Antalya,Turkey,1,76,440,96,344,-20,96,W,0,0,0
2011-02-09 00:00:00.000000,Libya,Benin,3,2,Friendly,Tripoli,Libya,0,71,451,72,449,-1,2,W,0,1,0
2011-02-09 00:00:00.000000,Luxembourg,Slovakia,2,1,Friendly,Luxembourg,Luxembourg,0,132,180,20,854,112,-674,W,0,1,0
2011-02-09 00:00:00.000000,Malaysia,Hong Kong,2,0,Friendly,Kuala Lumpur,Malaysia,0,142,145,146,128,-4,17,W,0,1,0
2011-02-09 00:00:00.000000,Malta,Switzerland,0,0,Friendly,Attard,Malta,0,163,76,22,841,141,-765,D,1,1,0
2011-02-09 00:00:00.000000,Morocco,Niger,3,0,Friendly,Marrakech,Morocco,0,77,437,94,349,-17,88,W,0,1,0
2011-02-09 00:00:00.000000,Mozambique,Botswana,1,1,Friendly,Maputo,Mozambique,0,92,353,54,535,38,-182,D,1,1,0
2011-02-09 00:00:00.000000,Namibia,Malawi,1,2,Friendly,Windhoek,Namibia,0,138,156,91,355,47,-199,L,2,1,0
2011-02-09 00:00:00.000000,Netherlands,Austria,3,1,Friendly,Eindhoven,Netherlands,0,2,1723,46,569,-44,1154,W,0,1,0
2011-02-09 00:00:00.000000,Nigeria,Sierra Leone,2,1,Friendly,Lagos,Nigeria,0,32,730,123,233,-91,497,W,0,1,0
2011-02-09 00:00:00.000000,Norway,Poland,0,1,Friendly,Faro,Portugal,1,12,995,72,449,-60,546,L,2,0,0
2011-02-09 00:00:00.000000,Philippines,Mongolia,2,0,AFC Challenge Cup qualification,Bacolod,Philippines,0,153,97,182,32,-29,65,W,0,1,0
2011-02-09 00:00:00.000000,San Marino,Liechtenstein,0,1,Friendly,Serravalle,San Marino,0,203,0,148,116,55,-116,L,2,1,0
2011-02-09 00:00:00.000000,Scotland,Northern Ireland,3,0,Nations Cup,Dublin,Ireland,1,52,542,43,615,9,-73,W,0,0,0
2011-02-09 00:00:00.000000,Senegal,Guinea,4,0,Friendly,Dakar,Senegal,0,70,465,46,569,24,-104,W,0,1,0
2011-02-09 00:00:00.000000,South Africa,Kenya,2,0,Friendly,Rustenburg,South Africa,0,51,550,125,225,-74,325,W,0,1,0
2011-02-09 00:00:00.000000,Spain,Colombia,1,0,Friendly,Madrid,Spain,0,1,1887,48,558,-47,1329,W,0,1,0
2011-02-09 00:00:00.000000,Swaziland,Zambia,0,4,Friendly,Manzini,Swaziland,0,159,82,81,418,78,-336,L,2,1,0
2011-02-09 00:00:00.000000,Sweden,Ukraine,1,1,Cyprus International Tournament,Nicosia,Cyprus,1,33,712,34,702,-1,10,D,1,0,0
2011-02-09 00:00:00.000000,Tanzania,Palestine,1,0,Friendly,Dar es Salaam,Tanzania,0,120,243,178,40,-58,203,W,0,1,0
2011-02-09 00:00:00.000000,Turkey,Korea Republic,0,0,Friendly,Trabzon,Turkey,0,31,741,39,649,-8,92,D,1,1,0
2011-02-09 00:00:00.000000,Venezuela,Costa Rica,2,2,Friendly,Puerto la Cruz,Venezuela,0,60,515,69,467,-9,48,D,1,1,0
2011-02-14 00:00:00.000000,Bahrain,Kuwait,0,0,Friendly,Riffa,Bahrain,0,93,351,99,328,-6,23,D,1,1,0
2011-02-16 00:00:00.000000,Macau,Cambodia,3,2,AFC Challenge Cup qualification,Macau,Macau,0,193,14,165,68,28,-54,W,0,1,0
2011-03-15 00:00:00.000000,Mongolia,Philippines,2,1,AFC Challenge Cup qualification,Ulaanbaatar,Mongolia,0,182,32,153,97,29,-65,W,0,1,0
2011-03-16 00:00:00.000000,Argentina,Venezuela,4,1,Friendly,San Juan,Argentina,0,5,1338,60,515,-55,823,W,0,1,0
2011-03-16 00:00:00.000000,Botswana,Namibia,1,1,Friendly,Maun,Botswana,0,54,535,138,156,-84,379,D,1,1,0
2011-03-17 00:00:00.000000,Nepal,Bhutan,1,0,Friendly,Pokhara,Nepal,0,173,54,197,9,-24,45,W,0,1,0
2011-03-19 00:00:00.000000,Nepal,Bhutan,2,1,Friendly,Pokhara,Nepal,0,173,54,197,9,-24,45,W,0,1,0
2011-03-21 00:00:00.000000,Maldives,Cambodia,4,0,AFC Challenge Cup qualification,Malé,Maldives,0,161,81,165,68,-4,13,W,0,1,0
2011-03-21 00:00:00.000000,Palestine,Bangladesh,2,0,AFC Challenge Cup qualification,Rangoon,Burma,1,178,40,158,84,20,-44,W,0,0,0
2011-03-21 00:00:00.000000,Turkmenistan,Pakistan,3,0,AFC Challenge Cup qualification,Petaling Jaya,Malaysia,1,133,173,171,56,-38,117,W,0,0,0
2011-03-23 00:00:00.000000,Bhutan,Afghanistan,0,3,AFC Challenge Cup qualification,Gurgaon,India,1,197,9,195,10,2,-1,L,2,0,0
2011-03-23 00:00:00.000000,Cambodia,Tajikistan,0,3,AFC Challenge Cup qualification,Malé,Maldives,1,165,68,143,141,22,-73,L,2,0,0
2011-03-23 00:00:00.000000,Pakistan,India,1,3,AFC Challenge Cup qualification,Petaling Jaya,Malaysia,1,171,56,144,132,27,-76,L,2,0,0
2011-03-23 00:00:00.000000,Philippines,Palestine,0,0,AFC Challenge Cup qualification,Rangoon,Burma,1,153,97,178,40,-25,57,D,1,0,0
2011-03-24 00:00:00.000000,Cuba,El Salvador,0,1,Friendly,Havana,Cuba,0,62,512,116,251,-54,261,L,2,1,0
2011-03-25 00:00:00.000000,Afghanistan,Bhutan,2,0,AFC Challenge Cup qualification,Gurgaon,India,1,195,10,197,9,-2,1,W,0,0,0
2011-03-25 00:00:00.000000,Austria,Belgium,0,2,UEFA Euro qualification,Vienna,Austria,0,46,569,58,526,-12,43,L,2,1,0
2011-03-25 00:00:00.000000,Bangladesh,Philippines,0,3,AFC Challenge Cup qualification,Rangoon,Burma,1,158,84,153,97,5,-13,L,2,0,0
2011-03-25 00:00:00.000000,Estonia,Uruguay,2,0,Friendly,Tallinn,Estonia,0,86,386,7,1152,79,-766,W,0,1,0
2011-03-25 00:00:00.000000,Hungary,Netherlands,0,4,UEFA Euro qualification,Budapest,Hungary,0,41,632,2,1723,39,-1091,L,2,1,0
2011-03-25 00:00:00.000000,Jamaica,Venezuela,0,2,Friendly,Montego Bay,Jamaica,0,59,522,60,515,-1,7,L,2,1,0
2011-03-25 00:00:00.000000,Korea Republic,Honduras,4,0,Friendly,Seoul,Korea Republic,0,39,649,56,531,-17,118,W,0,1,0
2011-03-25 00:00:00.000000,Lithuania,Poland,2,0,Friendly,Kaunas,Lithuania,0,55,532,72,449,-17,83,W,0,1,0
2011-03-25 00:00:00.000000,Luxembourg,France,0,2,UEFA Euro qualification,Luxembourg,Luxembourg,0,132,180,18,867,114,-687,L,2,1,0
2011-03-25 00:00:00.000000,Maldives,Tajikistan,0,0,AFC Challenge Cup qualification,Malé,Maldives,0,161,81,143,141,18,-60,D,1,1,0
2011-03-25 00:00:00.000000,Montenegro,Uzbekistan,1,0,Friendly,Podgorica,Montenegro,0,25,824,108,285,-83,539,W,0,1,0
2011-03-25 00:00:00.000000,Panama,Bolivia,2,0,Friendly,Panama City,Panama,0,67,475,96,344,-29,131,W,0,1,0
2011-03-25 00:00:00.000000,Serbia,Northern Ireland,2,1,UEFA Euro qualification,Belgrade,Serbia,0,23,837,43,615,-20,222,W,0,1,0
2011-03-25 00:00:00.000000,Slovenia,Italy,0,1,UEFA Euro qualification,Ljubljana,Slovenia,0,17,897,14,965,3,-68,L,2,1,0
2011-03-25 00:00:00.000000,Spain,Czech Republic,2,1,UEFA Euro qualification,Granada,Spain,0,1,1887,30,751,-29,1136,W,0,1,0
2011-03-25 00:00:00.000000,Turkmenistan,India,1,1,AFC Challenge Cup qualification,Petaling Jaya,Malaysia,1,133,173,144,132,-11,41,D,1,0,0
2011-03-26 00:00:00.000000,Albania,Belarus,1,0,UEFA Euro qualification,Tirana,Albania,0,64,497,37,660,27,-163,W,0,1,0
2011-03-26 00:00:00.000000,Andorra,Slovakia,0,1,UEFA Euro qualification,Sant Julià de Lòria,Andorra,0,202,2,20,854,182,-852,L,2,1,0
2011-03-26 00:00:00.000000,Armenia,Russia,0,0,UEFA Euro qualification,Yerevan,Armenia,0,60,515,13,982,47,-467,D,1,1,0
2011-03-26 00:00:00.000000,Bulgaria,Switzerland,0,0,UEFA Euro qualification,Sofia,Bulgaria,0,49,555,22,841,27,-286,D,1,1,0
2011-03-26 00:00:00.000000,Burkina Faso,Namibia,4,0,African Cup of Nations qualification,Ouagadougou,Burkina Faso,0,42,619,138,156,-96,463,W,0,1,0
2011-03-26 00:00:00.000000,Chad,Botswana,0,1,African Cup of Nations qualification,N'Djamena,Chad,0,140,147,54,535,86,-388,L,2,1,0
2011-03-26 00:00:00.000000,Colombia,Ecuador,2,0,Friendly,Madrid,Spain,1,48,558,52,542,-4,16,W,0,0,0
2011-03-26 00:00:00.000000,Cyprus,Iceland,0,0,UEFA Euro qualification,Nicosia,Cyprus,0,89,367,113,261,-24,106,D,1,1,0
2011-03-26 00:00:00.000000,Georgia,Croatia,1,0,UEFA Euro qualification,Tbilisi,Georgia,0,72,449,9,1075,63,-626,W,0,1,0
2011-03-26 00:00:00.000000,Germany,Kazakhstan,4,0,UEFA Euro qualification,Kaiserslautern,Germany,0,3,1485,137,161,-134,1324,W,0,1,0
2011-03-26 00:00:00.000000,Guinea-Bissau,Uganda,0,1,African Cup of Nations qualification,Bissau,Guinea-Bissau,0,147,121,83,416,64,-295,L,2,1,0
2011-03-26 00:00:00.000000,Israel,Latvia,2,1,UEFA Euro qualification,Jaffa,Israel,0,50,551,76,440,-26,111,W,0,1,0
2011-03-26 00:00:00.000000,Jordan,Kuwait,1,1,Friendly,Sharjah,United Arab Emirates,1,107,286,99,328,8,-42,D,1,0,0
2011-03-26 00:00:00.000000,Kenya,Angola,2,1,African Cup of Nations qualification,Nairobi,Kenya,0,125,225,88,368,37,-143,W,0,1,0
2011-03-26 00:00:00.000000,Korea DPR,Iraq,2,0,Friendly,Sharjah,United Arab Emirates,1,109,283,98,334,11,-51,W,0,0,0
2011-03-26 00:00:00.000000,Malawi,Togo,1,0,African Cup of Nations qualification,Blantyre,Malawi,0,91,355,101,313,-10,42,W,0,1,0
2011-03-26 00:00:00.000000,Mali,Zimbabwe,1,0,African Cup of Nations qualification,Bamako,Mali,0,68,474,118,246,-50,228,W,0,1,0
2011-03-26 00:00:00.000000,Malta,Greece,0,1,UEFA Euro qualification,Attard,Malta,0,163,76,11,1016,152,-940,L,2,1,0
2011-03-26 00:00:00.000000,Mexico,Paraguay,3,1,Friendly,Oakland,USA,1,27,795,24,832,3,-37,W,0,0,0
2011-03-26 00:00:00.000000,Norway,Denmark,1,1,UEFA Euro qualification,Oslo,Norway,0,12,995,28,790,-16,205,D,1,1,0
2011-03-26 00:00:00.000000,Portugal,Chile,1,1,Friendly,Leiria,Portugal,0,8,1090,15,950,-7,140,D,1,1,0
2011-03-26 00:00:00.000000,Rwanda,Burundi,3,1,African Cup of Nations qualification,Kigali,Rwanda,0,134,171,140,147,-6,24,W,0,1,0
2011-03-26 00:00:00.000000,Senegal,Cameroon,1,0,African Cup of Nations qualification,Dakar,Senegal,0,70,465,38,650,32,-185,W,0,1,0
2011-03-26 00:00:00.000000,South Africa,Egypt,1,0,African Cup of Nations qualification,Johannesburg,South Africa,0,51,550,10,1036,41,-486,W,0,1,0
2011-03-26 00:00:00.000000,USA,Argentina,1,1,Friendly,East Rutherford,USA,0,18,867,5,1338,13,-471,D,1,1,0
2011-03-26 00:00:00.000000,Wales,England,0,2,UEFA Euro qualification,Cardiff,Wales,0,113,261,6,1195,107,-934,L,2,1,0
2011-03-27 00:00:00.000000,Algeria,Morocco,1,0,African Cup of Nations qualification,Annaba,Algeria,0,36,678,77,437,-41,241,W,0,1,0
2011-03-27 00:00:00.000000,Brazil,Scotland,2,0,Friendly,London,England,1,4,1446,52,542,-48,904,W,0,0,0
2011-03-27 00:00:00.000000,Congo,Ghana,0,3,African Cup of Nations qualification,Brazzaville,Congo,0,122,239,16,924,106,-685,L,2,1,0
2011-03-27 00:00:00.000000,Congo DR,Mauritius,3,0,African Cup of Nations qualification,Kinshasa,Congo DR,0,128,211,191,16,-63,195,W,0,1,0
2011-03-27 00:00:00.000000,Madagascar,Guinea,1,1,African Cup of Nations qualification,Antananarivo,Madagascar,0,154,91,46,569,108,-478,D,1,1,0
2011-03-27 00:00:00.000000,Mozambique,Zambia,0,2,African Cup of Nations qualification,Maputo,Mozambique,0,92,353,81,418,11,-65,L,2,1,0
2011-03-27 00:00:00.000000,Niger,Sierra Leone,3,1,African Cup of Nations qualification,Niamey,Niger,0,94,349,123,233,-29,116,W,0,1,0
2011-03-27 00:00:00.000000,Nigeria,Ethiopia,4,0,African Cup of Nations qualification,Abuja,Nigeria,0,32,730,124,231,-92,499,W,0,1,0
2011-03-27 00:00:00.000000,Sri Lanka,Tajikistan,2,2,Friendly,Colombo,Sri Lanka,0,162,79,143,141,19,-62,D,1,1,0
2011-03-27 00:00:00.000000,St. Kitts and Nevis,Grenada,0,0,Friendly,Basseterre,St. Kitts and Nevis,0,121,242,94,349,27,-107,D,1,1,0
2011-03-27 00:00:00.000000,Sudan,Swaziland,3,0,African Cup of Nations qualification,Omdurman,Sudan,0,100,314,159,82,-59,232,W,0,1,0
2011-03-28 00:00:00.000000,Guatemala,Bolivia,1,1,Friendly,Mazatenango,Guatemala,0,117,247,96,344,21,-97,D,1,1,0
2011-03-29 00:00:00.000000,Belarus,Canada,0,1,Friendly,Antalya,Turkey,1,37,660,84,411,-47,249,L,2,0,0
2011-03-29 00:00:00.000000,Belgium,Azerbaijan,4,1,UEFA Euro qualification,Brussels,Belgium,0,58,526,97,343,-39,183,W,0,1,0
2011-03-29 00:00:00.000000,Colombia,Chile,0,2,Friendly,The Hague,Netherlands,1,48,558,15,950,33,-392,L,2,0,0
2011-03-29 00:00:00.000000,Costa Rica,Argentina,0,0,Friendly,San José,Costa Rica,0,69,467,5,1338,64,-871,D,1,1,0
2011-03-29 00:00:00.000000,Cuba,Panama,0,2,Friendly,Havana,Cuba,0,62,512,67,475,-5,37,L,2,1,0
2011-03-29 00:00:00.000000,Cyprus,Bulgaria,0,1,Friendly,Larnaca,Cyprus,0,89,367,49,555,40,-188,L,2,1,0
2011-03-29 00:00:00.000000,Czech Republic,Liechtenstein,2,0,UEFA Euro qualification,České Budějovice,Czech Republic,0,30,751,148,116,-118,635,W,0,1,0
2011-03-29 00:00:00.000000,Ecuador,Peru,0,0,Friendly,The Hague,Netherlands,1,52,542,66,486,-14,56,D,1,0,0
2011-03-29 00:00:00.000000,El Salvador,Jamaica,2,3,Friendly,San Salvador,El Salvador,0,116,251,59,522,57,-271,L,2,1,0
2011-03-29 00:00:00.000000,England,Ghana,1,1,Friendly,London,England,0,6,1195,16,924,-10,271,D,1,1,0
2011-03-29 00:00:00.000000,Equatorial Guinea,Gambia,1,0,Friendly,Malabo,Equatorial Guinea,0,164,72,105,290,59,-218,W,0,1,0
2011-03-29 00:00:00.000000,Estonia,Serbia,1,1,UEFA Euro qualification,Tallinn,Estonia,0,86,386,23,837,63,-451,D,1,1,0
2011-03-29 00:00:00.000000,France,Croatia,0,0,Friendly,Saint-Denis,France,0,18,867,9,1075,9,-208,D,1,1,0
2011-03-29 00:00:00.000000,Germany,Australia,1,2,Friendly,Mönchengladbach,Germany,0,3,1485,26,796,-23,689,L,2,1,0
2011-03-29 00:00:00.000000,Greece,Poland,0,0,Friendly,Piraeus,Greece,0,11,1016,72,449,-61,567,D,1,1,0
2011-03-29 00:00:00.000000,Israel,Georgia,1,0,UEFA Euro qualification,Jaffa,Israel,0,50,551,72,449,-22,102,W,0,1,0
2011-03-29 00:00:00.000000,Jordan,Korea DPR,1,1,Friendly,Sharjah,United Arab Emirates,1,107,286,109,283,-2,3,D,1,0,0
2011-03-29 00:00:00.000000,Kuwait,Iraq,1,0,Friendly,Sharjah,United Arab Emirates,1,99,328,98,334,1,-6,W,0,0,0
2011-03-29 00:00:00.000000,Lithuania,Spain,1,3,UEFA Euro qualification,Kaunas,Lithuania,0,55,532,1,1887,54,-1355,L,2,1,0
2011-03-29 00:00:00.000000,Mexico,Venezuela,1,1,Friendly,San Diego,USA,1,27,795,60,515,-33,280,D,1,0,0
2011-03-29 00:00:00.000000,Netherlands,Hungary,5,3,UEFA Euro qualification,Amsterdam,Netherlands,0,2,1723,41,632,-39,1091,W,0,1,0
2011-03-29 00:00:00.000000,Nigeria,Kenya,3,0,Friendly,Abuja,Nigeria,0,32,730,125,225,-93,505,W,0,1,0
2011-03-29 00:00:00.000000,Northern Ireland,Slovenia,0,0,UEFA Euro qualification,Belfast,Northern Ireland,0,43,615,17,897,26,-282,D,1,1,0
2011-03-29 00:00:00.000000,Oman,Tunisia,2,1,Friendly,Muscat,Oman,0,104,297,44,592,60,-295,W,0,1,0
2011-03-29 00:00:00.000000,Portugal,Finland,2,0,Friendly,Aveiro,Portugal,0,8,1090,79,419,-71,671,W,0,1,0
2011-03-29 00:00:00.000000,Qatar,Russia,1,1,Friendly,Doha,Qatar,0,105,290,13,982,92,-692,D,1,1,0
2011-03-29 00:00:00.000000,Romania,Luxembourg,3,1,UEFA Euro qualification,Piatra Neamţ,Romania,0,56,531,132,180,-76,351,W,0,1,0
2011-03-29 00:00:00.000000,Slovakia,Denmark,1,2,Friendly,Trnava,Slovakia,0,20,854,28,790,-8,64,L,2,1,0
2011-03-29 00:00:00.000000,Sri Lanka,Tajikistan,0,2,Friendly,Colombo,Sri Lanka,0,162,79,143,141,19,-62,L,2,1,0
2011-03-29 00:00:00.000000,Sweden,Moldova,2,1,UEFA Euro qualification,Solna,Sweden,0,33,712,84,411,-51,301,W,0,1,0
2011-03-29 00:00:00.000000,Turkey,Austria,2,0,UEFA Euro qualification,Istanbul,Turkey,0,31,741,46,569,-15,172,W,0,1,0
2011-03-29 00:00:00.000000,Ukraine,Italy,0,2,Friendly,Kyïv,Ukraine,0,34,702,14,965,20,-263,L,2,1,0
2011-03-29 00:00:00.000000,USA,Paraguay,0,1,Friendly,Nashville,USA,0,18,867,24,832,-6,35,L,2,1,0
2011-04-02 00:00:00.000000,Grenada,St. Kitts and Nevis,0,1,Friendly,St. George's,Grenada,0,94,349,121,242,-27,107,L,2,1,0
2011-04-03 00:00:00.000000,Tahiti,New Caledonia,1,3,Friendly,Papeete,French Polynesia,0,183,31,155,89,28,-58,L,2,0,0
2011-04-07 00:00:00.000000,Korea DPR,Sri Lanka,4,0,AFC Challenge Cup qualification,Kathmandu,Nepal,1,109,283,162,79,-53,204,W,0,0,0
2011-04-07 00:00:00.000000,Nepal,Afghanistan,1,0,AFC Challenge Cup qualification,Kathmandu,Nepal,0,173,54,195,10,-22,44,W,0,1,0
2011-04-07 00:00:00.000000,Tahiti,New Caledonia,1,0,Friendly,Papeete,French Polynesia,0,183,31,155,89,28,-58,W,0,0,0
2011-04-09 00:00:00.000000,Nepal,Korea DPR,0,1,AFC Challenge Cup qualification,Kathmandu,Nepal,0,173,54,109,283,64,-229,L,2,1,0
2011-04-09 00:00:00.000000,Sri Lanka,Afghanistan,0,1,AFC Challenge Cup qualification,Kathmandu,Nepal,1,162,79,195,10,-33,69,L,2,0,0
2011-04-11 00:00:00.000000,Korea DPR,Afghanistan,2,0,AFC Challenge Cup qualification,Kathmandu,Nepal,1,109,283,195,10,-86,273,W,0,0,0
2011-04-11 00:00:00.000000,Nepal,Sri Lanka,0,0,AFC Challenge Cup qualification,Kathmandu,Nepal,0,173,54,162,79,11,-25,D,1,1,0
2011-04-20 00:00:00.000000,Argentina,Ecuador,2,2,Friendly,Mar del Plata,Argentina,0,5,1338,52,542,-47,796,D,1,1,0
2011-04-23 00:00:00.000000,Mozambique,Tanzania,2,0,Friendly,Maputo,Mozambique,0,92,353,120,243,-28,110,W,0,1,0
2011-05-14 00:00:00.000000,Tanzania,South Africa,0,1,Friendly,Dar es Salaam,Tanzania,0,120,243,51,550,69,-307,L,2,1,0
2011-05-20 00:00:00.000000,Guyana,Barbados,0,1,Friendly,Linden,Guyana,0,110,284,132,180,-22,104,L,2,1,0
2011-05-22 00:00:00.000000,Guyana,Barbados,3,2,Friendly,Providence,Guyana,0,110,284,132,180,-22,104,W,0,1,0
2011-05-25 00:00:00.000000,Argentina,Paraguay,4,2,Friendly,Resistencia,Argentina,0,5,1267,23,847,-18,420,W,0,1,0
2011-05-25 00:00:00.000000,Swaziland,Botswana,0,0,Friendly,Manzini,Swaziland,0,159,89,69,479,90,-390,D,1,1,0
2011-05-25 00:00:00.000000,Wales,Scotland,1,3,Nations Cup,Dublin,Ireland,1,114,258,66,517,48,-259,L,2,0,0
2011-05-26 00:00:00.000000,Cuba,Nicaragua,1,1,Friendly,Havana,Cuba,0,81,416,166,75,-85,341,D,1,1,0
2011-05-27 00:00:00.000000,Grenada,Antigua and Barbuda,2,2,Friendly,St. George's,Grenada,0,98,337,100,322,-2,15,D,1,1,0
2011-05-27 00:00:00.000000,Wales,Northern Ireland,2,0,Nations Cup,Dublin,Ireland,1,114,258,65,520,49,-262,W,0,0,0
2011-05-28 00:00:00.000000,Cuba,Nicaragua,2,1,Friendly,Havana,Cuba,0,81,416,166,75,-85,341,W,0,1,0
2011-05-28 00:00:00.000000,Mexico,Ecuador,1,1,Friendly,Seattle,USA,1,28,802,64,523,-36,279,D,1,0,0
2011-05-29 00:00:00.000000,Barbados,Guyana,1,0,Friendly,Bridgetown,Barbados,0,132,180,110,284,22,-104,W,0,1,0
2011-05-29 00:00:00.000000,El Salvador,Honduras,2,2,Friendly,Houston,USA,1,87,391,43,603,44,-212,D,1,0,0
2011-05-29 00:00:00.000000,Ethiopia,Sudan,1,2,Friendly,Addis Ababa,Ethiopia,0,128,218,104,295,24,-77,L,2,1,0
2011-05-29 00:00:00.000000,Germany,Uruguay,2,1,Friendly,Sinsheim,Germany,0,4,1413,7,1094,-3,319,W,0,1,0
2011-05-29 00:00:00.000000,Panama,Grenada,2,0,Friendly,Panama City,Panama,0,67,493,98,337,-31,156,W,0,1,0
2011-05-29 00:00:00.000000,Swaziland,Malawi,1,1,Friendly,Mhlume,Swaziland,0,159,89,72,446,87,-357,D,1,1,0
2011-05-29 00:00:00.000000,Tunisia,Central African Republic,3,0,Friendly,Sousse,Tunisia,0,61,527,113,263,-52,264,W,0,1,0
2011-06-01 00:00:00.000000,Canada,Ecuador,2,2,Friendly,Toronto,Canada,0,76,439,64,523,12,-84,D,1,1,0
2011-06-01 00:00:00.000000,Guatemala,Venezuela,0,2,Friendly,Guatemala,Guatemala,0,124,222,68,489,56,-267,L,2,1,0
2011-06-01 00:00:00.000000,Japan,Peru,0,0,Kirin Cup,Niigata,Japan,0,14,961,54,548,-40,413,D,1,1,0
2011-06-01 00:00:00.000000,Mexico,New Zealand,3,0,Friendly,Denver,USA,1,28,802,60,528,-32,274,W,0,0,0
2011-06-01 00:00:00.000000,Nigeria,Argentina,4,1,Friendly,Abuja,Nigeria,0,39,637,5,1267,34,-630,W,0,1,0
2011-06-01 00:00:00.000000,Ukraine,Uzbekistan,2,0,Friendly,Kyïv,Ukraine,0,35,678,83,403,-48,275,W,0,1,0
2011-06-03 00:00:00.000000,Austria,Germany,1,2,UEFA Euro qualification,Vienna,Austria,0,74,443,4,1413,70,-970,L,2,1,0
2011-06-03 00:00:00.000000,Belarus,France,1,1,UEFA Euro qualification,Minsk,Belarus,0,53,557,19,883,34,-326,D,1,1,0
2011-06-03 00:00:00.000000,Belgium,Turkey,1,1,UEFA Euro qualification,Brussels,Belgium,0,37,654,30,795,7,-141,D,1,1,0
2011-06-03 00:00:00.000000,Croatia,Georgia,2,1,UEFA Euro qualification,Split,Croatia,0,10,991,57,536,-47,455,W,0,1,0
2011-06-03 00:00:00.000000,Faroe Islands,Slovenia,0,2,UEFA Euro qualification,Toftir,Faroe Islands,0,136,168,17,903,119,-735,L,2,1,0
2011-06-03 00:00:00.000000,Hong Kong,Malaysia,1,1,Friendly,Siu Sai Wan,Hong Kong,0,146,138,143,144,3,-6,D,1,1,0
2011-06-03 00:00:00.000000,Italy,Estonia,3,0,UEFA Euro qualification,Modena,Italy,0,9,1019,75,440,-66,579,W,0,1,0
2011-06-03 00:00:00.000000,Kazakhstan,Azerbaijan,2,1,UEFA Euro qualification,Astana,Kazakhstan,0,139,151,108,288,31,-137,W,0,1,0
2011-06-03 00:00:00.000000,Korea Republic,Serbia,2,1,Friendly,Seoul,Korea Republic,0,31,754,16,907,15,-153,W,0,1,0
2011-06-03 00:00:00.000000,Liechtenstein,Lithuania,2,0,UEFA Euro qualification,Vaduz,Liechtenstein,0,153,116,47,577,106,-461,W,0,1,0
2011-06-03 00:00:00.000000,Luxembourg,Hungary,0,1,Friendly,Luxembourg,Luxembourg,0,125,221,52,559,73,-338,L,2,1,0
2011-06-03 00:00:00.000000,Moldova,Sweden,1,4,UEFA Euro qualification,Chişinău,Moldova,0,86,394,28,802,58,-408,L,2,1,0
2011-06-03 00:00:00.000000,San Marino,Finland,0,1,UEFA Euro qualification,Serravalle,San Marino,0,202,0,81,416,121,-416,L,2,1,0
2011-06-04 00:00:00.000000,Bolivia,Paraguay,0,2,Copa Paz del Chaco,Santa Cruz,Bolivia,0,102,312,23,847,79,-535,L,2,1,0
2011-06-04 00:00:00.000000,Brazil,Netherlands,0,0,Friendly,Goiânia,Brazil,0,3,1425,2,1702,1,-277,D,1,1,0
2011-06-04 00:00:00.000000,Cameroon,Senegal,0,0,African Cup of Nations qualification,Yaoundé,Cameroon,0,49,572,40,613,9,-41,D,1,1,0
2011-06-04 00:00:00.000000,Central African Republic,Tanzania,2,1,African Cup of Nations qualification,Bangui,Central African Republic,0,113,263,117,252,-4,11,W,0,1,0
2011-06-04 00:00:00.000000,England,Switzerland,2,2,UEFA Euro qualification,London,England,0,6,1163,25,819,-19,344,D,1,1,0
2011-06-04 00:00:00.000000,Greece,Malta,3,1,UEFA Euro qualification,Piraeus,Greece,0,12,985,161,84,-149,901,W,0,1,0
2011-06-04 00:00:00.000000,Iceland,Denmark,0,2,UEFA Euro qualification,Reykjavík,Iceland,0,116,254,27,808,89,-554,L,2,1,0
2011-06-04 00:00:00.000000,Latvia,Israel,1,2,UEFA Euro qualification,Riga,Latvia,0,77,438,33,709,44,-271,L,2,1,0
2011-06-04 00:00:00.000000,Montenegro,Bulgaria,1,1,UEFA Euro qualification,Podgorica,Montenegro,0,24,820,46,592,-22,228,D,1,1,0
2011-06-04 00:00:00.000000,Morocco,Algeria,4,0,African Cup of Nations qualification,Marrakech,Morocco,0,73,445,41,609,32,-164,W,0,1,0
2011-06-04 00:00:00.000000,Peru,Czech Republic,0,0,Kirin Cup,Matsumoto,Japan,1,54,548,32,722,22,-174,D,1,0,0
2011-06-04 00:00:00.000000,Portugal,Norway,1,0,UEFA Euro qualification,Lisbon,Portugal,0,8,1052,11,987,-3,65,W,0,1,0
2011-06-04 00:00:00.000000,Russia,Armenia,3,1,UEFA Euro qualification,St. Petersburg,Russia,0,18,896,62,524,-44,372,W,0,1,0
2011-06-04 00:00:00.000000,Sierra Leone,Niger,1,0,African Cup of Nations qualification,Freetown,Sierra Leone,0,118,246,99,335,19,-89,W,0,1,0
2011-06-04 00:00:00.000000,Slovakia,Andorra,1,0,UEFA Euro qualification,Bratislava,Slovakia,0,26,809,202,0,-176,809,W,0,1,0
2011-06-04 00:00:00.000000,Uganda,Guinea-Bissau,2,0,African Cup of Nations qualification,Kampala,Uganda,0,84,402,136,168,-52,234,W,0,1,0
2011-06-04 00:00:00.000000,USA,Spain,0,4,Friendly,Foxborough,USA,0,22,855,1,1857,21,-1002,L,2,1,0
2011-06-04 00:00:00.000000,Zambia,Mozambique,3,0,African Cup of Nations qualification,Lusaka,Zambia,0,89,383,94,358,-5,25,W,0,1,0
2011-06-05 00:00:00.000000,Angola,Kenya,1,0,African Cup of Nations qualification,Luanda,Angola,0,104,295,123,227,-19,68,W,0,1,0
2011-06-05 00:00:00.000000,Australia,New Zealand,3,0,Friendly,Adelaide,Australia,0,20,876,60,528,-40,348,W,0,1,0
2011-06-05 00:00:00.000000,Botswana,Malawi,0,0,African Cup of Nations qualification,Gaborone,Botswana,0,69,479,72,446,-3,33,D,1,1,0
2011-06-05 00:00:00.000000,Burundi,Rwanda,3,1,African Cup of Nations qualification,Bujumbura,Burundi,0,149,127,122,228,27,-101,W,0,1,0
2011-06-05 00:00:00.000000,Comoros,Libya,1,1,African Cup of Nations qualification,Mitsamiouli,Comoros,0,188,19,58,534,130,-515,D,1,1,0
2011-06-05 00:00:00.000000,Costa Rica,Cuba,5,0,Gold Cup,Arlington,USA,1,56,541,81,416,-25,125,W,0,0,0
2011-06-05 00:00:00.000000,Egypt,South Africa,0,0,African Cup of Nations qualification,Cairo,Egypt,0,36,676,38,653,-2,23,D,1,1,0
2011-06-05 00:00:00.000000,Ethiopia,Nigeria,2,2,African Cup of Nations qualification,Addis Ababa,Ethiopia,0,128,218,39,637,89,-419,D,1,1,0
2011-06-05 00:00:00.000000,Guinea,Madagascar,4,1,African Cup of Nations qualification,Conakry,Guinea,0,62,524,138,164,-76,360,W,0,1,0
2011-06-05 00:00:00.000000,Mauritius,Congo DR,1,2,African Cup of Nations qualification,Mapou,Mauritius,0,189,18,126,219,63,-201,L,2,1,0
2011-06-05 00:00:00.000000,Mexico,El Salvador,5,0,Gold Cup,Arlington,USA,1,28,802,87,391,-59,411,W,0,0,0
2011-06-05 00:00:00.000000,Poland,Argentina,2,1,Friendly,Warsaw,Poland,0,71,449,5,1267,66,-818,W,0,1,0
2011-06-05 00:00:00.000000,Swaziland,Sudan,1,2,African Cup of Nations qualification,Lobamba,Swaziland,0,159,89,104,295,55,-206,L,2,1,0
2011-06-05 00:00:00.000000,Tunisia,Chad,5,0,African Cup of Nations qualification,Sousse,Tunisia,0,61,527,149,127,-88,400,W,0,1,0
2011-06-05 00:00:00.000000,Zimbabwe,Mali,2,1,African Cup of Nations qualification,Harare,Zimbabwe,0,126,219,70,451,56,-232,W,0,1,0
2011-06-06 00:00:00.000000,Honduras,Guatemala,0,0,Gold Cup,Carson,USA,1,43,603,124,222,-81,381,D,1,0,0
2011-06-06 00:00:00.000000,Jamaica,Grenada,4,0,Gold Cup,Carson,USA,1,55,546,98,337,-43,209,W,0,0,0
2011-06-06 00:00:00.000000,Ukraine,France,1,4,Friendly,Donets'k,Ukraine,0,35,678,19,883,16,-205,L,2,1,0
2011-06-07 00:00:00.000000,Australia,Serbia,0,0,Friendly,Melbourne,Australia,0,20,876,16,907,4,-31,D,1,1,0
2011-06-07 00:00:00.000000,Austria,Latvia,3,1,Friendly,Graz,Austria,0,74,443,77,438,-3,5,W,0,1,0
2011-06-07 00:00:00.000000,Azerbaijan,Germany,1,3,UEFA Euro qualification,Baku,Azerbaijan,0,108,288,4,1413,104,-1125,L,2,1,0
2011-06-07 00:00:00.000000,Belarus,Luxembourg,2,0,UEFA Euro qualification,Minsk,Belarus,0,53,557,125,221,-72,336,W,0,1,0
2011-06-07 00:00:00.000000,Brazil,Romania,1,0,Friendly,São Paulo,Brazil,0,3,1425,42,607,-39,818,W,0,1,0
2011-06-07 00:00:00.000000,Ecuador,Greece,1,1,Friendly,New York,USA,1,64,523,12,985,52,-462,D,1,0,0
2011-06-07 00:00:00.000000,Faroe Islands,Estonia,2,0,UEFA Euro qualification,Toftir,Faroe Islands,0,136,168,75,440,61,-272,W,0,1,0
2011-06-07 00:00:00.000000,Gabon,Gambia,0,1,Friendly,Franceville,Gabon,0,59,529,103,308,-44,221,L,2,1,0
2011-06-07 00:00:00.000000,Japan,Czech Republic,0,0,Kirin Cup,Yokohama,Japan,0,14,961,32,722,-18,239,D,1,1,0
2011-06-07 00:00:00.000000,Korea Republic,Ghana,2,1,Friendly,Jeonju,Korea Republic,0,31,754,15,918,16,-164,W,0,1,0
2011-06-07 00:00:00.000000,Norway,Lithuania,1,0,Friendly,Oslo,Norway,0,11,987,47,577,-36,410,W,0,1,0
2011-06-07 00:00:00.000000,Paraguay,Bolivia,0,0,Copa Paz del Chaco,Luque,Paraguay,0,23,847,102,312,-79,535,D,1,1,0
2011-06-07 00:00:00.000000,Russia,Cameroon,0,0,Friendly,Salzburg,Austria,1,18,896,49,572,-31,324,D,1,0,0
2011-06-07 00:00:00.000000,San Marino,Hungary,0,3,UEFA Euro qualification,Serravalle,San Marino,0,202,0,52,559,150,-559,L,2,1,0
2011-06-07 00:00:00.000000,Sweden,Finland,5,0,UEFA Euro qualification,Solna,Sweden,0,28,802,81,416,-53,386,W,0,1,0
2011-06-07 00:00:00.000000,USA,Canada,2,0,Gold Cup,Detroit,USA,0,22,855,76,439,-54,416,W,0,1,0
2011-06-07 00:00:00.000000,Venezuela,Spain,0,3,Friendly,Puerto la Cruz,Venezuela,0,68,489,1,1857,67,-1368,L,2,1,0
2011-06-08 00:00:00.000000,Uruguay,Netherlands,1,1,Friendly,Montevideo,Uruguay,0,7,1094,2,1702,5,-608,D,1,1,0
2011-06-09 00:00:00.000000,Costa Rica,El Salvador,1,1,Gold Cup,Charlotte,USA,1,56,541,87,391,-31,150,D,1,0,0
2011-06-09 00:00:00.000000,Cuba,Mexico,0,5,Gold Cup,Charlotte,USA,1,81,416,28,802,53,-386,L,2,0,0
2011-06-09 00:00:00.000000,Poland,France,0,1,Friendly,Warsaw,Poland,0,71,449,19,883,52,-434,L,2,1,0
2011-06-10 00:00:00.000000,Grenada,Honduras,1,7,Gold Cup,Miami,USA,1,98,337,43,603,55,-266,L,2,0,0
2011-06-10 00:00:00.000000,Jamaica,Guatemala,2,0,Gold Cup,Miami,USA,1,55,546,124,222,-69,324,W,0,0,0
2011-06-11 00:00:00.000000,Mexico,Venezuela,0,3,Friendly,Las Vegas,USA,1,28,802,68,489,-40,313,L,2,0,0
2011-06-11 00:00:00.000000,Paraguay,Romania,2,0,Friendly,Asunción,Paraguay,0,23,847,42,607,-19,240,W,0,1,0
2011-06-11 00:00:00.000000,USA,Panama,1,2,Gold Cup,Tampa,USA,0,22,855,67,493,-45,362,L,2,1,0
2011-06-12 00:00:00.000000,El Salvador,Cuba,6,1,Gold Cup,Chicago,USA,1,87,391,81,416,6,-25,W,0,0,0
2011-06-12 00:00:00.000000,Mexico,Costa Rica,4,1,Gold Cup,Chicago,USA,1,28,802,56,541,-28,261,W,0,0,0
2011-06-13 00:00:00.000000,Guatemala,Grenada,4,0,Gold Cup,Harrison,USA,1,124,222,98,337,26,-115,W,0,0,0
2011-06-13 00:00:00.000000,Honduras,Jamaica,0,1,Gold Cup,Harrison,USA,1,43,603,55,546,-12,57,L,2,0,0
2011-06-14 00:00:00.000000,Canada,Panama,1,1,Gold Cup,Kansas City,USA,1,76,439,67,493,9,-54,D,1,0,0
2011-06-15 00:00:00.000000,Montserrat,Belize,2,5,FIFA World Cup qualification,Couva,Trinidad and Tobago,1,202,0,172,66,30,-66,L,2,0,0
2011-06-18 00:00:00.000000,Costa Rica,Honduras,1,1,Gold Cup,East Rutherford,USA,1,56,541,43,603,13,-62,D,1,0,0
2011-06-18 00:00:00.000000,Mexico,Guatemala,2,1,Gold Cup,East Rutherford,USA,1,28,802,124,222,-96,580,W,0,0,0
2011-06-19 00:00:00.000000,Panama,El Salvador,1,1,Gold Cup,Washington,USA,1,67,493,87,391,-20,102,D,1,0,0
2011-06-19 00:00:00.000000,USA,Jamaica,2,0,Gold Cup,Washington,USA,0,22,855,55,546,-33,309,W,0,1,0
2011-06-20 00:00:00.000000,Argentina,Albania,4,0,Friendly,Buenos Aires,Argentina,0,5,1267,50,564,-45,703,W,0,1,0
2011-06-22 00:00:00.000000,Colombia,Mexico,0,0,Friendly,Pereira,Colombia,0,50,564,28,802,22,-238,D,1,1,0
2011-06-22 00:00:00.000000,Honduras,Mexico,0,2,Gold Cup,Houston,USA,1,43,603,28,802,15,-199,L,2,0,0
2011-06-22 00:00:00.000000,USA,Panama,1,0,Gold Cup,Houston,USA,0,22,855,67,493,-45,362,W,0,1,0
2011-06-23 00:00:00.000000,Paraguay,Chile,0,0,Friendly,Asunción,Paraguay,0,23,847,13,967,10,-120,D,1,1,0
2011-06-25 00:00:00.000000,Colombia,Senegal,2,0,Friendly,Medellín,Colombia,0,50,564,40,613,10,-49,W,0,1,0
2011-06-25 00:00:00.000000,Ecuador,Mexico,0,1,Friendly,Quito,Ecuador,0,64,523,28,802,36,-279,L,2,1,0
2011-06-25 00:00:00.000000,Kenya,Sudan,1,2,Friendly,Nairobi,Kenya,0,123,227,104,295,19,-68,L,2,1,0
2011-06-25 00:00:00.000000,USA,Mexico,2,4,Gold Cup,Pasadena,USA,0,22,855,28,802,-6,53,L,2,1,0
2011-06-27 00:00:00.000000,Bolivia,Mexico,0,1,Friendly,Buenos Aires,Argentina,1,102,312,28,802,74,-490,L,2,0,0
2011-06-28 00:00:00.000000,Peru,Senegal,1,0,Friendly,Lima,Peru,0,54,548,40,613,14,-65,W,0,1,0
2011-06-29 00:00:00.000000,Afghanistan,Palestine,0,2,FIFA World Cup qualification,Tursunzoda,Tajikistan,1,164,77,171,67,-7,10,L,2,0,0
2011-06-29 00:00:00.000000,Bangladesh,Pakistan,3,0,FIFA World Cup qualification,Dhaka,Bangladesh,0,163,79,168,72,-5,7,W,0,1,0
2011-06-29 00:00:00.000000,Cambodia,Laos,4,2,FIFA World Cup qualification,Phnom Penh,Cambodia,0,176,56,174,57,2,-1,W,0,1,0
2011-06-29 00:00:00.000000,Iraq,Syria,1,2,Friendly,Arbil,Iraq,0,89,383,104,295,-15,88,L,2,1,0
2011-06-29 00:00:00.000000,Sri Lanka,Philippines,1,1,FIFA World Cup qualification,Colombo,Sri Lanka,0,169,70,156,96,13,-26,D,1,1,0
2011-06-29 00:00:00.000000,Vietnam,Macau,6,0,FIFA World Cup qualification,Ho Chi Minh City,Vietnam,0,134,172,184,32,-50,140,W,0,1,0
2011-07-01 00:00:00.000000,Argentina,Bolivia,1,1,Copa América,La Plata,Argentina,0,5,1267,102,312,-97,955,D,1,1,0
2011-07-02 00:00:00.000000,Colombia,Costa Rica,1,0,Copa América,San Salvador de Jujuy,Argentina,1,50,564,56,541,-6,23,W,0,0,0
2011-07-02 00:00:00.000000,Lebanon,Kuwait,0,6,Friendly,Beirut,Lebanon,0,178,51,101,320,77,-269,L,2,1,0
2011-07-02 00:00:00.000000,Turks and Caicos Islands,Bahamas,0,4,FIFA World Cup qualification,Providenciales,Turks and Caicos Islands,0,193,13,196,9,-3,4,L,2,1,0
2011-07-03 00:00:00.000000,Brazil,Venezuela,0,0,Copa América,La Plata,Argentina,1,3,1425,68,489,-65,936,D,1,0,0
2011-07-03 00:00:00.000000,Laos,Cambodia,6,2,FIFA World Cup qualification,Vientiane,Laos,0,174,57,176,56,-2,1,W,0,1,0
2011-07-03 00:00:00.000000,Macau,Vietnam,1,7,FIFA World Cup qualification,Macau,Macau,0,184,32,134,172,50,-140,L,2,1,0
2011-07-03 00:00:00.000000,Pakistan,Bangladesh,0,0,FIFA World Cup qualification,Lahore,Pakistan,0,168,72,163,79,5,-7,D,1,1,0
2011-07-03 00:00:00.000000,Palestine,Afghanistan,1,1,FIFA World Cup qualification,al-Ramm,Palestine,0,171,67,164,77,7,-10,D,1,1,0
2011-07-03 00:00:00.000000,Paraguay,Ecuador,0,0,Copa América,Santa Fe,Argentina,1,23,847,64,523,-41,324,D,1,0,0
2011-07-03 00:00:00.000000,Philippines,Sri Lanka,4,0,FIFA World Cup qualification,Manila,Philippines,0,156,96,169,70,-13,26,W,0,1,0
2011-07-04 00:00:00.000000,Chile,Mexico,2,1,Copa América,San Juan,Argentina,1,13,967,28,802,-15,165,W,0,0,0
2011-07-04 00:00:00.000000,Uruguay,Peru,1,1,Copa América,San Juan,Argentina,1,7,1094,54,548,-47,546,D,1,0,0
2011-07-05 00:00:00.000000,Jordan,Syria,1,3,Friendly,Istanbul,Turkey,1,93,378,104,295,-11,83,L,2,0,0
2011-07-06 00:00:00.000000,Argentina,Colombia,0,0,Copa América,Santa Fe,Argentina,0,5,1267,50,564,-45,703,D,1,1,0
2011-07-06 00:00:00.000000,Kuwait,Oman,1,1,Friendly,Beirut,Lebanon,1,101,320,107,294,-6,26,D,1,0,0
2011-07-06 00:00:00.000000,Malawi,Namibia,0,1,Friendly,Mzuzu,Malawi,0,72,446,140,150,-68,296,L,2,1,0
2011-07-07 00:00:00.000000,Bolivia,Costa Rica,0,2,Copa América,San Salvador de Jujuy,Argentina,1,102,312,56,541,46,-229,L,2,0,0
2011-07-07 00:00:00.000000,Solomon Islands,Vanuatu,2,1,Friendly,Honiara,Solomon Islands,0,182,40,165,76,17,-36,W,0,1,0
2011-07-08 00:00:00.000000,Aruba,St. Lucia,4,2,FIFA World Cup qualification,Oranjestad,Aruba,0,199,7,185,31,14,-24,W,0,1,0
2011-07-08 00:00:00.000000,Dominican Republic,Anguilla,2,0,FIFA World Cup qualification,San Cristóbal,Dominican Republic,0,172,66,202,0,-30,66,W,0,1,0
2011-07-08 00:00:00.000000,Jordan,Yemen,4,0,Friendly,Istanbul,Turkey,1,93,378,129,203,-36,175,W,0,0,0
2011-07-08 00:00:00.000000,Peru,Mexico,1,0,Copa América,Mendoza,Argentina,1,54,548,28,802,26,-254,W,0,0,0
2011-07-08 00:00:00.000000,Uruguay,Chile,1,1,Copa América,Mendoza,Argentina,1,7,1094,13,967,-6,127,D,1,0,0
2011-07-09 00:00:00.000000,Bahamas,Turks and Caicos Islands,6,0,FIFA World Cup qualification,Nassau,Bahamas,0,196,9,193,13,3,-4,W,0,1,0
2011-07-09 00:00:00.000000,Brazil,Paraguay,2,2,Copa América,Córdoba,Argentina,1,3,1425,23,847,-20,578,D,1,0,0
2011-07-09 00:00:00.000000,Lebanon,Oman,0,1,Friendly,Beirut,Lebanon,0,178,51,107,294,71,-243,L,2,1,0
2011-07-09 00:00:00.000000,Solomon Islands,Vanuatu,0,0,Friendly,Honiara,Solomon Islands,0,182,40,165,76,17,-36,D,1,1,0
2011-07-09 00:00:00.000000,Venezuela,Ecuador,1,0,Copa América,Salta,Argentina,1,68,489,64,523,4,-34,W,0,0,0
2011-07-10 00:00:00.000000,Colombia,Bolivia,2,0,Copa América,Santa Fe,Argentina,1,50,564,102,312,-52,252,W,0,0,0
2011-07-10 00:00:00.000000,Dominican Republic,Anguilla,4,0,FIFA World Cup qualification,San Cristóbal,Dominican Republic,0,172,66,202,0,-30,66,W,0,1,0
2011-07-10 00:00:00.000000,Maldives,India,1,1,Friendly,Malé,Maldives,0,148,133,145,139,3,-6,D,1,1,0
2011-07-11 00:00:00.000000,Argentina,Costa Rica,3,0,Copa América,Córdoba,Argentina,0,5,1267,56,541,-51,726,W,0,1,0
2011-07-12 00:00:00.000000,Chile,Peru,1,0,Copa América,Mendoza,Argentina,1,13,967,54,548,-41,419,W,0,0,0
2011-07-12 00:00:00.000000,St. Lucia,Aruba,4,2,FIFA World Cup qualification,Castries,St. Lucia,0,185,31,199,7,-14,24,W,0,1,0
2011-07-12 00:00:00.000000,Uruguay,Mexico,1,0,Copa América,La Plata,Argentina,1,7,1094,28,802,-21,292,W,0,0,0
2011-07-13 00:00:00.000000,Brazil,Ecuador,4,2,Copa América,Córdoba,Argentina,1,3,1425,64,523,-61,902,W,0,0,0
2011-07-13 00:00:00.000000,Iraq,Kuwait,0,2,Friendly,Amman,Jordan,1,89,383,101,320,-12,63,L,2,0,0
2011-07-13 00:00:00.000000,Jordan,Saudi Arabia,1,1,Friendly,Amman,Jordan,0,93,378,88,386,5,-8,D,1,1,0
2011-07-13 00:00:00.000000,Paraguay,Venezuela,3,3,Copa América,Salta,Argentina,1,23,847,68,489,-45,358,D,1,0,0
2011-07-15 00:00:00.000000,Fiji,Vanuatu,1,2,Friendly,Lautoka,Fiji,0,155,103,165,76,-10,27,L,2,1,0
2011-07-15 00:00:00.000000,Oman,Syria,1,1,Friendly,Muscat,Oman,0,107,294,104,295,3,-1,D,1,1,0
2011-07-16 00:00:00.000000,Argentina,Uruguay,1,1,Copa América,Santa Fe,Argentina,0,5,1267,7,1094,-2,173,D,1,1,0
2011-07-16 00:00:00.000000,Colombia,Peru,0,2,Copa América,Córdoba,Argentina,1,50,564,54,548,-4,16,L,2,0,0
2011-07-16 00:00:00.000000,Jordan,Iraq,1,1,Friendly,Amman,Jordan,0,93,378,89,383,4,-5,D,1,1,0
2011-07-16 00:00:00.000000,Kuwait,Saudi Arabia,1,0,Friendly,Amman,Jordan,1,101,320,88,386,13,-66,W,0,0,0
2011-07-17 00:00:00.000000,Belize,Montserrat,3,1,FIFA World Cup qualification,San Pedro Sula,Honduras,1,172,66,202,0,-30,66,W,0,0,0
2011-07-17 00:00:00.000000,Brazil,Paraguay,0,0,Copa América,La Plata,Argentina,1,3,1425,23,847,-20,578,D,1,0,0
2011-07-17 00:00:00.000000,Chile,Venezuela,1,2,Copa América,San Juan,Argentina,1,13,967,68,489,-55,478,L,2,0,0
2011-07-17 00:00:00.000000,Iran,Madagascar,1,0,Friendly,Teheran,Iran,0,48,575,138,164,-90,411,W,0,1,0
2011-07-17 00:00:00.000000,Qatar,India,1,2,Friendly,Doha,Qatar,0,92,380,145,139,-53,241,L,2,1,0
2011-07-17 00:00:00.000000,United Arab Emirates,Lebanon,6,2,Friendly,al-Ain,United Arab Emirates,0,111,273,178,51,-67,222,W,0,1,0
2011-07-19 00:00:00.000000,Peru,Uruguay,0,2,Copa América,La Plata,Argentina,1,54,548,7,1094,47,-546,L,2,0,0
2011-07-20 00:00:00.000000,Paraguay,Venezuela,0,0,Copa América,Mendoza,Argentina,1,23,847,68,489,-45,358,D,1,0,0
2011-07-23 00:00:00.000000,Iran,Maldives,4,0,FIFA World Cup qualification,Teheran,Iran,0,48,575,148,133,-100,442,W,0,1,0
2011-07-23 00:00:00.000000,Iraq,Yemen,2,0,FIFA World Cup qualification,Arbil,Iraq,0,89,383,129,203,-40,180,W,0,1,0
2011-07-23 00:00:00.000000,Jordan,Nepal,9,0,FIFA World Cup qualification,Amman,Jordan,0,93,378,147,135,-54,243,W,0,1,0
2011-07-23 00:00:00.000000,Kuwait,Philippines,3,0,FIFA World Cup qualification,Hawalli,Kuwait,0,101,320,156,96,-55,224,W,0,1,0
2011-07-23 00:00:00.000000,Lebanon,Bangladesh,4,0,FIFA World Cup qualification,Beirut,Lebanon,0,178,51,163,79,15,-28,W,0,1,0
2011-07-23 00:00:00.000000,Peru,Venezuela,4,1,Copa América,La Plata,Argentina,1,54,548,68,489,-14,59,W,0,0,0
2011-07-23 00:00:00.000000,Qatar,Vietnam,3,0,FIFA World Cup qualification,Doha,Qatar,0,92,380,134,172,-42,208,W,0,1,0
2011-07-23 00:00:00.000000,Saudi Arabia,Hong Kong,3,0,FIFA World Cup qualification,Dammam,Saudi Arabia,0,88,386,146,138,-58,248,W,0,1,0
2011-07-23 00:00:00.000000,Singapore,Malaysia,5,3,FIFA World Cup qualification,Singapore,Singapore,0,144,140,143,144,1,-4,W,0,1,0
2011-07-23 00:00:00.000000,Syria,Tajikistan,0,3,FIFA World Cup qualification,Amman,Jordan,1,104,295,135,171,-31,124,L,2,0,0
2011-07-23 00:00:00.000000,Thailand,Palestine,1,0,FIFA World Cup qualification,Buriram,Thailand,0,120,242,171,67,-51,175,W,0,1,0
2011-07-23 00:00:00.000000,Turkmenistan,Indonesia,1,1,FIFA World Cup qualification,Ashgabat,Turkmenistan,0,141,149,130,200,11,-51,D,1,1,0
2011-07-23 00:00:00.000000,United Arab Emirates,India,3,0,FIFA World Cup qualification,al-Ain,United Arab Emirates,0,111,273,145,139,-34,134,W,0,1,0
2011-07-24 00:00:00.000000,Liberia,Gambia,3,2,Friendly,Paynesville,Liberia,0,157,93,103,308,54,-215,W,0,1,0
2011-07-24 00:00:00.000000,Uruguay,Paraguay,3,0,Copa América,Buenos Aires,Argentina,1,7,1094,23,847,-16,247,W,0,0,0
2011-07-27 00:00:00.000000,Vanuatu,Solomon Islands,0,0,Friendly,Port Vila,Vanuatu,0,165,76,182,40,-17,36,D,1,1,0
2011-07-28 00:00:00.000000,Bangladesh,Lebanon,2,0,FIFA World Cup qualification,Dhaka,Bangladesh,0,163,79,178,51,-15,28,W,0,1,0
2011-07-28 00:00:00.000000,Hong Kong,Saudi Arabia,0,5,FIFA World Cup qualification,Siu Sai Wan,Hong Kong,0,146,138,88,386,58,-248,L,2,1,0
2011-07-28 00:00:00.000000,India,United Arab Emirates,2,2,FIFA World Cup qualification,New Delhi,India,0,145,139,111,273,34,-134,D,1,1,0
2011-07-28 00:00:00.000000,Indonesia,Turkmenistan,4,3,FIFA World Cup qualification,Jakarta,Indonesia,0,130,200,141,149,-11,51,W,0,1,0
2011-07-28 00:00:00.000000,Malaysia,Singapore,1,1,FIFA World Cup qualification,Kuala Lumpur,Malaysia,0,143,144,144,140,-1,4,D,1,1,0
2011-07-28 00:00:00.000000,Maldives,Iran,0,1,FIFA World Cup qualification,Malé,Maldives,0,148,133,48,575,100,-442,L,2,1,0
2011-07-28 00:00:00.000000,Nepal,Jordan,1,1,FIFA World Cup qualification,Kathmandu,Nepal,0,147,135,93,378,54,-243,D,1,1,0
2011-07-28 00:00:00.000000,Palestine,Thailand,2,2,FIFA World Cup qualification,al-Ramm,Palestine,0,171,67,120,242,51,-175,D,1,1,0
2011-07-28 00:00:00.000000,Philippines,Kuwait,1,2,FIFA World Cup qualification,Manila,Philippines,0,156,96,101,320,55,-224,L,2,1,0
2011-07-28 00:00:00.000000,Tajikistan,Syria,3,0,FIFA World Cup qualification,Tursunzoda,Tajikistan,0,135,171,104,295,31,-124,W,0,1,0
2011-07-28 00:00:00.000000,Vietnam,Qatar,2,1,FIFA World Cup qualification,Hanoi,Vietnam,0,134,172,92,380,42,-208,W,0,1,0
2011-07-28 00:00:00.000000,Yemen,Iraq,0,0,FIFA World Cup qualification,al-Ain,United Arab Emirates,1,129,203,89,383,40,-180,D,1,0,0
2011-07-30 00:00:00.000000,Vanuatu,Solomon Islands,2,0,Friendly,Port Vila,Vanuatu,0,165,76,182,40,-17,36,W,0,1,0
2011-07-31 00:00:00.000000,Swaziland,Botswana,0,2,Friendly,Pretoria,South Africa,1,159,89,69,479,90,-390,L,2,0,0
2011-08-07 00:00:00.000000,El Salvador,Venezuela,2,1,Friendly,Washington,USA,1,87,391,68,489,19,-98,W,0,0,0
2011-08-10 00:00:00.000000,Albania,Montenegro,3,2,Friendly,Shkodër,Albania,0,50,564,24,820,26,-256,W,0,1,0
2011-08-10 00:00:00.000000,Austria,Slovakia,1,2,Friendly,Klagenfurt,Austria,0,74,443,26,809,48,-366,L,2,1,0
2011-08-10 00:00:00.000000,Belarus,Bulgaria,1,0,Friendly,Minsk,Belarus,0,53,557,46,592,7,-35,W,0,1,0
2011-08-10 00:00:00.000000,Bolivia,Panama,1,3,Friendly,Santa Cruz,Bolivia,0,102,312,67,493,35,-181,L,2,1,0
2011-08-10 00:00:00.000000,Botswana,Kenya,1,0,Friendly,Gaborone,Botswana,0,69,479,123,227,-54,252,W,0,1,0
2011-08-10 00:00:00.000000,Costa Rica,Ecuador,0,2,Friendly,San José,Costa Rica,0,56,541,64,523,-8,18,L,2,1,0
2011-08-10 00:00:00.000000,Cyprus,Moldova,3,2,Friendly,Nicosia,Cyprus,0,89,383,86,394,3,-11,W,0,1,0
2011-08-10 00:00:00.000000,Equatorial Guinea,Guinea-Bissau,1,4,Friendly,Lisbon,Portugal,1,142,146,136,168,6,-22,L,2,0,0
2011-08-10 00:00:00.000000,France,Chile,1,1,Friendly,Montpellier,France,0,19,883,13,967,6,-84,D,1,1,0
2011-08-10 00:00:00.000000,Gabon,Guinea,1,1,Friendly,Saint-Leu-la-Forêt,France,1,59,529,62,524,-3,5,D,1,0,0
2011-08-10 00:00:00.000000,Gambia,Congo DR,3,0,Friendly,Banjul,Gambia,0,103,308,126,219,-23,89,W,0,1,0
2011-08-10 00:00:00.000000,Germany,Brazil,3,2,Friendly,Stuttgart,Germany,0,4,1413,3,1425,1,-12,W,0,1,0
2011-08-10 00:00:00.000000,Honduras,Venezuela,2,0,Friendly,Fort Lauderdale,USA,1,43,603,68,489,-25,114,W,0,0,0
2011-08-10 00:00:00.000000,Hungary,Iceland,4,0,Friendly,Budapest,Hungary,0,52,559,116,254,-64,305,W,0,1,0
2011-08-10 00:00:00.000000,Italy,Spain,2,1,Friendly,Bari,Italy,0,9,1019,1,1857,8,-838,W,0,1,0
2011-08-10 00:00:00.000000,Japan,Korea Republic,3,0,Friendly,Sapporo,Japan,0,14,961,31,754,-17,207,W,0,1,0
2011-08-10 00:00:00.000000,Kazakhstan,Syria,1,1,Friendly,Astana,Kazakhstan,0,139,151,104,295,35,-144,D,1,1,0
2011-08-10 00:00:00.000000,Kuwait,Korea DPR,0,0,Friendly,Kuwait City,Kuwait,0,101,320,115,255,-14,65,D,1,1,0
2011-08-10 00:00:00.000000,Latvia,Finland,0,2,Friendly,Riga,Latvia,0,77,438,81,416,-4,22,L,2,1,0
2011-08-10 00:00:00.000000,Liberia,Angola,0,0,Friendly,Paynesville,Liberia,0,157,93,104,295,53,-202,D,1,1,0
2011-08-10 00:00:00.000000,Liechtenstein,Switzerland,1,2,Friendly,Vaduz,Liechtenstein,0,153,116,25,819,128,-703,L,2,1,0
2011-08-10 00:00:00.000000,Lithuania,Armenia,3,0,Friendly,Kaunas,Lithuania,0,47,577,62,524,-15,53,W,0,1,0
2011-08-10 00:00:00.000000,Malta,Central African Republic,2,1,Friendly,Attard,Malta,0,161,84,113,263,48,-179,W,0,1,0
2011-08-10 00:00:00.000000,Niger,Togo,3,3,Friendly,Niamey,Niger,0,99,335,109,285,-10,50,D,1,1,0
2011-08-10 00:00:00.000000,Northern Ireland,Faroe Islands,4,0,UEFA Euro qualification,Belfast,Northern Ireland,0,65,520,136,168,-71,352,W,0,1,0
2011-08-10 00:00:00.000000,Norway,Czech Republic,3,0,Friendly,Oslo,Norway,0,11,987,32,722,-21,265,W,0,1,0
2011-08-10 00:00:00.000000,Oman,Bahrain,1,1,Friendly,Dubai,United Arab Emirates,1,107,294,97,338,10,-44,D,1,0,0
2011-08-10 00:00:00.000000,Poland,Georgia,1,0,Friendly,Lubin,Poland,0,71,449,57,536,14,-87,W,0,1,0
2011-08-10 00:00:00.000000,Portugal,Luxembourg,5,0,Friendly,Faro,Portugal,0,8,1052,125,221,-117,831,W,0,1,0
2011-08-10 00:00:00.000000,Russia,Serbia,1,0,Friendly,Moscow,Russia,0,18,896,16,907,2,-11,W,0,1,0
2011-08-10 00:00:00.000000,San Marino,Romania,0,1,Friendly,Serravalle,San Marino,0,202,0,42,607,160,-607,L,2,1,0
2011-08-10 00:00:00.000000,Scotland,Denmark,2,1,Friendly,Glasgow,Scotland,0,66,517,27,808,39,-291,W,0,1,0
2011-08-10 00:00:00.000000,Senegal,Morocco,0,2,Friendly,Dakar,Senegal,0,40,613,73,445,-33,168,L,2,1,0
2011-08-10 00:00:00.000000,Slovenia,Belgium,0,0,Friendly,Ljubljana,Slovenia,0,17,903,37,654,-20,249,D,1,1,0
2011-08-10 00:00:00.000000,South Africa,Burkina Faso,3,0,Friendly,Johannesburg,South Africa,0,38,653,44,600,-6,53,W,0,1,0
2011-08-10 00:00:00.000000,Tunisia,Mali,4,2,Friendly,Monastir,Tunisia,0,61,527,70,451,-9,76,W,0,1,0
2011-08-10 00:00:00.000000,Turkey,Estonia,3,0,Friendly,Istanbul,Turkey,0,30,795,75,440,-45,355,W,0,1,0
2011-08-10 00:00:00.000000,Ukraine,Sweden,0,1,Friendly,Kharkiv,Ukraine,0,35,678,28,802,7,-124,L,2,1,0
2011-08-10 00:00:00.000000,USA,Mexico,1,1,Friendly,Philadelphia,USA,0,22,855,28,802,-6,53,D,1,1,0
2011-08-10 00:00:00.000000,Wales,Australia,1,2,Friendly,Cardiff,Wales,0,114,258,20,876,94,-618,L,2,1,0
2011-08-10 00:00:00.000000,Zimbabwe,Zambia,2,0,Friendly,Harare,Zimbabwe,0,126,219,89,383,37,-164,W,0,1,0
2011-08-14 00:00:00.000000,Liberia,Niger,0,0,Friendly,Paynesville,Liberia,0,157,93,99,335,58,-242,D,1,1,0
2011-08-17 00:00:00.000000,Fiji,Samoa,3,0,Friendly,Navua,Fiji,0,155,103,186,26,-31,77,W,0,1,0
2011-08-17 00:00:00.000000,Lebanon,Syria,2,3,Friendly,Sidon,Lebanon,0,178,51,104,295,74,-244,L,2,1,0
2011-08-18 00:00:00.000000,Fiji,Samoa,5,1,Friendly,Suva,Fiji,0,155,103,186,26,-31,77,W,0,1,0
2011-08-19 00:00:00.000000,Eritrea,Sudan,0,3,Friendly,Asmara,Eritrea,0,181,42,104,295,77,-253,L,2,1,0
2011-08-19 00:00:00.000000,Qatar,Iraq,0,1,Friendly,Doha,Qatar,0,92,380,89,383,3,-3,L,2,1,0
2011-08-20 00:00:00.000000,Dominican Republic,Curaçao,1,0,Friendly,San Cristóbal,Dominican Republic,0,172,66,152,121,20,-55,W,0,1,0
2011-08-20 00:00:00.000000,Lesotho,Swaziland,0,0,Friendly,Maseru,Lesotho,0,176,56,159,89,17,-33,D,1,1,0
2011-08-21 00:00:00.000000,Barbados,St. Lucia,4,0,Friendly,Bridgetown,Barbados,0,132,180,185,31,-53,149,W,0,1,0
2011-08-21 00:00:00.000000,Dominican Republic,Curaçao,1,0,Friendly,San Cristóbal,Dominican Republic,0,172,66,152,121,20,-55,W,0,1,0
2011-08-21 00:00:00.000000,Trinidad and Tobago,India,3,0,Friendly,Port of Spain,Trinidad and Tobago,0,95,353,145,139,-50,214,W,0,1,0
2011-08-22 00:00:00.000000,Indonesia,Palestine,4,1,Friendly,Surakarta,Indonesia,0,130,200,171,67,-41,133,W,0,1,0
2011-08-22 00:00:00.000000,Jordan,Tunisia,3,3,Friendly,Amman,Jordan,0,93,378,61,527,32,-149,D,1,1,0
2011-08-22 00:00:00.000000,Lesotho,Swaziland,0,1,Friendly,Maseru,Lesotho,0,176,56,159,89,17,-33,L,2,1,0
2011-08-24 00:00:00.000000,Guyana,India,2,1,Friendly,Providence,Guyana,0,114,260,158,112,-44,148,W,0,1,0
2011-08-24 00:00:00.000000,Thailand,Singapore,0,0,Friendly,Bangkok,Thailand,0,120,246,129,209,-9,37,D,1,1,0
2011-08-25 00:00:00.000000,United Arab Emirates,Qatar,3,1,Friendly,al-Ain,United Arab Emirates,0,108,299,88,364,20,-65,W,0,1,0
2011-08-26 00:00:00.000000,Bahrain,Sudan,1,0,Friendly,Riffa,Bahrain,0,101,325,98,329,3,-4,W,0,1,0
2011-08-27 00:00:00.000000,Angola,Congo DR,1,2,Friendly,Dundo,Angola,0,96,338,127,222,-31,116,L,2,1,0
2011-08-27 00:00:00.000000,Fiji,Tahiti,3,0,South Pacific Games,Boulari,New Caledonia,1,141,180,183,57,-42,123,W,0,0,0
2011-08-27 00:00:00.000000,Jordan,Indonesia,1,0,Friendly,Amman,Jordan,0,92,348,131,207,-39,141,W,0,1,0
2011-08-27 00:00:00.000000,New Caledonia,Vanuatu,5,0,South Pacific Games,Nouméa,New Caledonia,0,165,104,162,105,3,-1,W,0,1,0
2011-08-27 00:00:00.000000,Oman,Kuwait,1,0,Friendly,Muscat,Oman,0,103,312,95,341,8,-29,W,0,1,0
2011-08-27 00:00:00.000000,Papua New Guinea,Cook Islands,4,0,South Pacific Games,Boulari,New Caledonia,1,207,0,197,10,10,-10,W,0,0,0
2011-08-27 00:00:00.000000,Solomon Islands,Guam,7,0,South Pacific Games,Nouméa,New Caledonia,1,177,79,197,10,-20,69,W,0,0,0
2011-08-28 00:00:00.000000,Antigua and Barbuda,St. Vincent and the Grenadines,2,2,Friendly,Osbourn,Antigua and Barbuda,0,106,308,158,112,-52,196,D,1,1,0
2011-08-30 00:00:00.000000,American Samoa,Solomon Islands,0,4,South Pacific Games,Nouméa,New Caledonia,1,203,0,177,79,26,-79,L,2,0,0
2011-08-30 00:00:00.000000,New Caledonia,Guam,9,0,South Pacific Games,Nouméa,New Caledonia,0,165,104,197,10,-32,94,W,0,1,0
2011-08-30 00:00:00.000000,Tahiti,Cook Islands,7,0,South Pacific Games,Boulari,New Caledonia,1,183,57,197,10,-14,47,W,0,0,0
2011-09-01 00:00:00.000000,American Samoa,Guam,0,2,South Pacific Games,Nouméa,New Caledonia,1,203,0,197,10,6,-10,L,2,0,0
2011-09-01 00:00:00.000000,Tahiti,Papua New Guinea,1,1,South Pacific Games,Boulari,New Caledonia,1,183,57,207,0,-24,57,D,1,0,0
2011-09-01 00:00:00.000000,Vanuatu,Solomon Islands,1,0,South Pacific Games,Nouméa,New Caledonia,1,162,105,177,79,-15,26,W,0,0,0
2011-09-02 00:00:00.000000,Albania,France,1,2,UEFA Euro qualification,Tirana,Albania,0,57,546,15,918,42,-372,L,2,1,0
2011-09-02 00:00:00.000000,Andorra,Armenia,0,3,UEFA Euro qualification,Sant Julià de Lòria,Andorra,0,203,0,71,456,132,-456,L,2,1,0
2011-09-02 00:00:00.000000,Antigua and Barbuda,Curaçao,5,2,FIFA World Cup qualification,St. John's,Antigua and Barbuda,0,106,308,166,103,-60,205,W,0,1,0
2011-09-02 00:00:00.000000,Argentina,Venezuela,1,0,Friendly,Calcutta,India,1,9,1017,44,615,-35,402,W,0,0,0
2011-09-02 00:00:00.000000,Australia,Thailand,2,1,FIFA World Cup qualification,Brisbane,Australia,0,22,837,120,246,-98,591,W,0,1,0
2011-09-02 00:00:00.000000,Azerbaijan,Belgium,1,1,UEFA Euro qualification,Baku,Azerbaijan,0,112,272,37,675,75,-403,D,1,1,0
2011-09-02 00:00:00.000000,Bahrain,Qatar,0,0,FIFA World Cup qualification,Riffa,Bahrain,0,101,325,88,364,13,-39,D,1,1,0
2011-09-02 00:00:00.000000,Bulgaria,England,0,3,UEFA Euro qualification,Sofia,Bulgaria,0,51,586,4,1177,47,-591,L,2,1,0
2011-09-02 00:00:00.000000,Canada,St. Lucia,4,1,FIFA World Cup qualification,Toronto,Canada,0,102,319,184,54,-82,265,W,0,1,0
2011-09-02 00:00:00.000000,Cyprus,Portugal,0,4,UEFA Euro qualification,Nicosia,Cyprus,0,76,427,8,1060,68,-633,L,2,1,0
2011-09-02 00:00:00.000000,Dominica,Nicaragua,0,2,FIFA World Cup qualification,Roseau,Dominica,0,136,193,179,75,-43,118,L,2,1,0
2011-09-02 00:00:00.000000,Ecuador,Jamaica,5,2,Friendly,Quito,Ecuador,0,66,491,43,623,23,-132,W,0,1,0
2011-09-02 00:00:00.000000,El Salvador,Dominican Republic,3,2,FIFA World Cup qualification,San Salvador,El Salvador,0,75,431,133,198,-58,233,W,0,1,0
2011-09-02 00:00:00.000000,Faroe Islands,Italy,0,1,UEFA Euro qualification,Tórshavn,Faroe Islands,0,111,273,7,1110,104,-837,L,2,1,0
2011-09-02 00:00:00.000000,Finland,Moldova,4,1,UEFA Euro qualification,Helsinki,Finland,0,79,416,88,364,-9,52,W,0,1,0
2011-09-02 00:00:00.000000,Georgia,Latvia,0,1,UEFA Euro qualification,Tbilisi,Georgia,0,63,522,84,388,-21,134,L,2,1,0
2011-09-02 00:00:00.000000,Germany,Austria,6,2,UEFA Euro qualification,Gelsenkirchen,Germany,0,3,1330,68,472,-65,858,W,0,1,0
2011-09-02 00:00:00.000000,Ghana,Swaziland,2,0,African Cup of Nations qualification,Accra,Ghana,0,36,726,172,90,-136,636,W,0,1,0
2011-09-02 00:00:00.000000,Grenada,Belize,0,3,FIFA World Cup qualification,St. George's,Grenada,0,118,249,148,146,-30,103,L,2,1,0
2011-09-02 00:00:00.000000,Guyana,Barbados,2,0,FIFA World Cup qualification,Providence,Guyana,0,114,260,147,156,-33,104,W,0,1,0
2011-09-02 00:00:00.000000,Hungary,Sweden,2,1,UEFA Euro qualification,Budapest,Hungary,0,45,613,18,889,27,-276,W,0,1,0
2011-09-02 00:00:00.000000,Iran,Indonesia,3,0,FIFA World Cup qualification,Teheran,Iran,0,53,559,131,207,-78,352,W,0,1,0
2011-09-02 00:00:00.000000,Iraq,Jordan,0,2,FIFA World Cup qualification,Arbil,Iraq,0,109,293,92,348,17,-55,L,2,1,0
2011-09-02 00:00:00.000000,Israel,Greece,0,1,UEFA Euro qualification,Jaffa,Israel,0,32,746,14,937,18,-191,L,2,1,0
2011-09-02 00:00:00.000000,Japan,Korea DPR,1,0,FIFA World Cup qualification,Saitama,Japan,0,15,918,114,260,-99,658,W,0,1,0
2011-09-02 00:00:00.000000,Korea Republic,Lebanon,6,0,FIFA World Cup qualification,Goyang,Korea Republic,0,33,745,160,106,-127,639,W,0,1,0
2011-09-02 00:00:00.000000,Lithuania,Liechtenstein,0,0,UEFA Euro qualification,Kaunas,Lithuania,0,56,552,119,247,-63,305,D,1,1,0
2011-09-02 00:00:00.000000,Luxembourg,Romania,0,2,UEFA Euro qualification,Luxembourg,Luxembourg,0,128,211,54,558,74,-347,L,2,1,0
2011-09-02 00:00:00.000000,Malta,Croatia,1,3,UEFA Euro qualification,Attard,Malta,0,167,102,10,1009,157,-907,L,2,1,0
2011-09-02 00:00:00.000000,Netherlands,San Marino,11,0,UEFA Euro qualification,Eindhoven,Netherlands,0,1,1596,203,0,-202,1596,W,0,1,0
2011-09-02 00:00:00.000000,Northern Ireland,Serbia,0,1,UEFA Euro qualification,Belfast,Northern Ireland,0,59,545,29,784,30,-239,L,2,1,0
2011-09-02 00:00:00.000000,Norway,Iceland,1,0,UEFA Euro qualification,Oslo,Norway,0,12,943,124,232,-112,711,W,0,1,0
2011-09-02 00:00:00.000000,Oman,Saudi Arabia,0,0,FIFA World Cup qualification,Muscat,Oman,0,103,312,87,372,16,-60,D,1,1,0
2011-09-02 00:00:00.000000,Panama,Paraguay,0,2,Friendly,Panama,Panama,0,62,524,25,807,37,-283,L,2,1,0
2011-09-02 00:00:00.000000,Peru,Bolivia,2,2,Friendly,Lima,Peru,0,26,806,85,380,-59,426,D,1,1,0
2011-09-02 00:00:00.000000,Poland,Mexico,1,1,Friendly,Warsaw,Poland,0,65,498,20,864,45,-366,D,1,1,0
2011-09-02 00:00:00.000000,Slovenia,Estonia,1,2,UEFA Euro qualification,Ljubljana,Slovenia,0,23,816,86,374,-63,442,L,2,1,0
2011-09-02 00:00:00.000000,Spain,Chile,3,2,Friendly,St. Gallen,Switzerland,1,2,1563,11,960,-9,603,W,0,0,0
2011-09-02 00:00:00.000000,St. Kitts and Nevis,Puerto Rico,0,0,FIFA World Cup qualification,Basseterre,St. Kitts and Nevis,0,122,239,144,167,-22,72,D,1,1,0
2011-09-02 00:00:00.000000,Suriname,Cayman Islands,1,0,FIFA World Cup qualification,Paramaribo,Suriname,0,110,285,172,90,-62,195,W,0,1,0
2011-09-02 00:00:00.000000,Tajikistan,Uzbekistan,0,1,FIFA World Cup qualification,Tursunzoda,Tajikistan,0,153,132,82,401,71,-269,L,2,1,0
2011-09-02 00:00:00.000000,Trinidad and Tobago,Bermuda,1,0,FIFA World Cup qualification,Port of Spain,Trinidad and Tobago,0,91,355,185,40,-94,315,W,0,1,0
2011-09-02 00:00:00.000000,Turkey,Kazakhstan,2,1,UEFA Euro qualification,Istanbul,Turkey,0,24,811,126,227,-102,584,W,0,1,0
2011-09-02 00:00:00.000000,Ukraine,Uruguay,2,3,Friendly,Kharkiv,Ukraine,0,48,598,5,1174,43,-576,L,2,1,0
2011-09-02 00:00:00.000000,United Arab Emirates,Kuwait,2,3,FIFA World Cup qualification,al-Ain,United Arab Emirates,0,108,299,95,341,13,-42,L,2,1,0
2011-09-02 00:00:00.000000,USA,Costa Rica,0,1,Friendly,Carson,USA,0,28,791,60,530,-32,261,L,2,1,0
2011-09-02 00:00:00.000000,Wales,Montenegro,2,1,UEFA Euro qualification,Cardiff,Wales,0,117,251,19,875,98,-624,W,0,1,0
2011-09-03 00:00:00.000000,Burkina Faso,Equatorial Guinea,1,0,Friendly,Bobo Dioulasso,Burkina Faso,0,40,646,154,131,-114,515,W,0,1,0
2011-09-03 00:00:00.000000,Cameroon,Mauritius,6,0,African Cup of Nations qualification,Yaoundé,Cameroon,0,52,582,188,35,-136,547,W,0,1,0
2011-09-03 00:00:00.000000,Cook Islands,Fiji,1,4,South Pacific Games,Boulari,New Caledonia,1,197,10,141,180,56,-170,L,2,0,0
2011-09-03 00:00:00.000000,Guam,Vanuatu,1,4,South Pacific Games,Nouméa,New Caledonia,1,197,10,162,105,35,-95,L,2,0,0
2011-09-03 00:00:00.000000,Honduras,Colombia,0,2,Friendly,Harrison,USA,1,50,589,35,730,15,-141,L,2,0,0
2011-09-03 00:00:00.000000,Kenya,Guinea-Bissau,2,1,African Cup of Nations qualification,Nairobi,Kenya,0,133,198,150,142,-17,56,W,0,1,0
2011-09-03 00:00:00.000000,Malawi,Tunisia,0,0,African Cup of Nations qualification,Blantyre,Malawi,0,73,436,57,546,16,-110,D,1,1,0
2011-09-03 00:00:00.000000,Namibia,Gambia,1,0,African Cup of Nations qualification,Windhoek,Namibia,0,143,169,107,306,36,-137,W,0,1,0
2011-09-03 00:00:00.000000,New Caledonia,American Samoa,8,0,South Pacific Games,Nouméa,New Caledonia,0,165,104,203,0,-38,104,W,0,1,0
2011-09-03 00:00:00.000000,Scotland,Czech Republic,2,2,UEFA Euro qualification,Glasgow,Scotland,0,55,554,42,635,13,-81,D,1,1,0
2011-09-03 00:00:00.000000,Senegal,Congo DR,2,0,African Cup of Nations qualification,Dakar,Senegal,0,49,591,127,222,-78,369,W,0,1,0
2011-09-03 00:00:00.000000,Sierra Leone,Egypt,2,1,African Cup of Nations qualification,Freetowm,Sierra Leone,0,92,348,34,739,58,-391,W,0,1,0
2011-09-03 00:00:00.000000,Tanzania,Algeria,1,1,African Cup of Nations qualification,Dar es Salaam,Tanzania,0,125,229,46,612,79,-383,D,1,1,0
2011-09-04 00:00:00.000000,Angola,Uganda,2,0,African Cup of Nations qualification,Luanda,Angola,0,96,338,80,411,16,-73,W,0,1,0
2011-09-04 00:00:00.000000,Burundi,Benin,1,1,African Cup of Nations qualification,Bujumbura,Burundi,0,145,164,83,394,62,-230,D,1,1,0
2011-09-04 00:00:00.000000,Central African Republic,Morocco,0,0,African Cup of Nations qualification,Bangui,Central African Republic,0,104,309,61,529,43,-220,D,1,1,0
2011-09-04 00:00:00.000000,Comoros,Zambia,1,2,African Cup of Nations qualification,Mitsamiouli,Comoros,0,182,68,76,427,106,-359,L,2,1,0
2011-09-04 00:00:00.000000,Congo,Sudan,0,1,African Cup of Nations qualification,Brazzaville,Congo,0,132,201,98,329,34,-128,L,2,1,0
2011-09-04 00:00:00.000000,Guinea,Ethiopia,1,0,African Cup of Nations qualification,Conakry,Guinea,0,69,464,140,181,-71,283,W,0,1,0
2011-09-04 00:00:00.000000,Madagascar,Nigeria,0,2,African Cup of Nations qualification,Antananarivo,Madagascar,0,152,139,38,659,114,-520,L,2,1,0
2011-09-04 00:00:00.000000,Mexico,Chile,1,0,Friendly,Barcelona,Spain,1,20,864,11,960,9,-96,W,0,0,0
2011-09-04 00:00:00.000000,Niger,South Africa,2,1,African Cup of Nations qualification,Niamey,Niger,0,104,309,47,602,57,-293,W,0,1,0
2011-09-04 00:00:00.000000,Togo,Botswana,1,0,African Cup of Nations qualification,Lomé,Togo,0,121,242,78,424,43,-182,W,0,1,0
2011-09-04 00:00:00.000000,Zimbabwe,Liberia,3,0,African Cup of Nations qualification,Harare,Zimbabwe,0,74,434,123,238,-49,196,W,0,1,0
2011-09-05 00:00:00.000000,American Samoa,Vanuatu,0,8,South Pacific Games,Nouméa,New Caledonia,1,203,0,162,105,41,-105,L,2,0,0
2011-09-05 00:00:00.000000,Bolivia,Peru,0,0,Friendly,La Paz,Bolivia,0,85,380,26,806,59,-426,D,1,1,0
2011-09-05 00:00:00.000000,Brazil,Ghana,1,0,Friendly,London,England,1,6,1156,36,726,-30,430,W,0,0,0
2011-09-05 00:00:00.000000,New Caledonia,Solomon Islands,1,2,South Pacific Games,Nouméa,New Caledonia,0,165,104,177,79,-12,25,L,2,1,0
2011-09-05 00:00:00.000000,Papua New Guinea,Fiji,0,2,South Pacific Games,Boulari,New Caledonia,1,207,0,141,180,66,-180,L,2,0,0
2011-09-06 00:00:00.000000,Argentina,Nigeria,3,1,Friendly,Dhaka,Bangladesh,1,9,1017,38,659,-29,358,W,0,0,0
2011-09-06 00:00:00.000000,Austria,Turkey,0,0,UEFA Euro qualification,Vienna,Austria,0,68,472,24,811,44,-339,D,1,1,0
2011-09-06 00:00:00.000000,Azerbaijan,Kazakhstan,3,2,UEFA Euro qualification,Baku,Azerbaijan,0,112,272,126,227,-14,45,W,0,1,0
2011-09-06 00:00:00.000000,Barbados,Trinidad and Tobago,0,2,FIFA World Cup qualification,Bridgetown,Barbados,0,147,156,91,355,56,-199,L,2,1,0
2011-09-06 00:00:00.000000,Belgium,USA,1,0,Friendly,Brussels,Belgium,0,37,675,28,791,9,-116,W,0,1,0
2011-09-06 00:00:00.000000,Belize,Guatemala,1,2,FIFA World Cup qualification,Belmopan,Belize,0,148,146,113,261,35,-115,L,2,1,0
2011-09-06 00:00:00.000000,Cayman Islands,El Salvador,1,4,FIFA World Cup qualification,Georgetown,Cayman Islands,0,172,90,75,431,97,-341,L,2,1,0
2011-09-06 00:00:00.000000,Croatia,Israel,3,1,UEFA Euro qualification,Zagreb,Croatia,0,10,1009,32,746,-22,263,W,0,1,0
2011-09-06 00:00:00.000000,Curaçao,Haiti,2,4,FIFA World Cup qualification,Willemstad,Curaçao,0,166,103,116,259,50,-156,L,2,1,0
2011-09-06 00:00:00.000000,Czech Republic,Ukraine,4,0,Friendly,Prague,Czech Republic,0,42,635,48,598,-6,37,W,0,1,0
2011-09-06 00:00:00.000000,Denmark,Norway,2,0,UEFA Euro qualification,Copenhagen,Denmark,0,21,841,12,943,9,-102,W,0,1,0
2011-09-06 00:00:00.000000,Dominican Republic,Suriname,1,1,FIFA World Cup qualification,San Cristóbal,Dominican Republic,0,133,198,110,285,23,-87,D,1,1,0
2011-09-06 00:00:00.000000,Ecuador,Costa Rica,4,0,Friendly,Quito,Ecuador,0,66,491,60,530,6,-39,W,0,1,0
2011-09-06 00:00:00.000000,England,Wales,1,0,UEFA Euro qualification,London,England,0,4,1177,117,251,-113,926,W,0,1,0
2011-09-06 00:00:00.000000,Estonia,Northern Ireland,4,1,UEFA Euro qualification,Tallinn,Estonia,0,86,374,59,545,27,-171,W,0,1,0
2011-09-06 00:00:00.000000,Finland,Netherlands,0,2,UEFA Euro qualification,Helsinki,Finland,0,79,416,1,1596,78,-1180,L,2,1,0
2011-09-06 00:00:00.000000,Gabon,Niger,1,0,Friendly,Nice,France,1,67,482,104,309,-37,173,W,0,0,0
2011-09-06 00:00:00.000000,Guyana,Bermuda,2,1,FIFA World Cup qualification,Georgetown,Guyana,0,114,260,185,40,-71,220,W,0,1,0
2011-09-06 00:00:00.000000,Honduras,Paraguay,0,3,Friendly,San Pedro Sula,Honduras,0,50,589,25,807,25,-218,L,2,1,0
2011-09-06 00:00:00.000000,Iceland,Cyprus,1,0,UEFA Euro qualification,Reykjavík,Iceland,0,124,232,76,427,48,-195,W,0,1,0
2011-09-06 00:00:00.000000,Indonesia,Bahrain,0,2,FIFA World Cup qualification,Jakarta,Indonesia,0,131,207,101,325,30,-118,L,2,1,0
2011-09-06 00:00:00.000000,Italy,Slovenia,1,0,UEFA Euro qualification,Florence,Italy,0,7,1110,23,816,-16,294,W,0,1,0
2011-09-06 00:00:00.000000,Jamaica,Colombia,0,2,Friendly,Fort Lauderdale,USA,1,43,623,35,730,8,-107,L,2,0,0
2011-09-06 00:00:00.000000,Korea DPR,Tajikistan,1,0,FIFA World Cup qualification,P'yŏngyang,Korea DPR,0,114,260,153,132,-39,128,W,0,1,0
2011-09-06 00:00:00.000000,Kuwait,Korea Republic,1,1,FIFA World Cup qualification,Kuwait City,Kuwait,0,95,341,33,745,62,-404,D,1,1,0
2011-09-06 00:00:00.000000,Latvia,Greece,1,1,UEFA Euro qualification,Riga,Latvia,0,84,388,14,937,70,-549,D,1,1,0
2011-09-06 00:00:00.000000,Lebanon,United Arab Emirates,3,1,FIFA World Cup qualification,Beirut,Lebanon,0,160,106,108,299,52,-193,W,0,1,0
2011-09-06 00:00:00.000000,Luxembourg,Albania,2,1,UEFA Euro qualification,Luxembourg,Luxembourg,0,128,211,57,546,71,-335,W,0,1,0
2011-09-06 00:00:00.000000,Malta,Georgia,1,1,UEFA Euro qualification,Attard,Malta,0,167,102,63,522,104,-420,D,1,1,0
2011-09-06 00:00:00.000000,Moldova,Hungary,0,2,UEFA Euro qualification,Chişinău,Moldova,0,88,364,45,613,43,-249,L,2,1,0
2011-09-06 00:00:00.000000,Nicaragua,Panama,1,2,FIFA World Cup qualification,Managua,Nicaragua,0,179,75,62,524,117,-449,L,2,1,0
2011-09-06 00:00:00.000000,Poland,Germany,2,2,Friendly,Gdańsk,Poland,0,65,498,3,1330,62,-832,D,1,1,0
2011-09-06 00:00:00.000000,Puerto Rico,Canada,0,3,FIFA World Cup qualification,Bayamón,Puerto Rico,0,144,167,102,319,42,-152,L,2,1,0
2011-09-06 00:00:00.000000,Qatar,Iran,1,1,FIFA World Cup qualification,Doha,Qatar,0,88,364,53,559,35,-195,D,1,1,0
2011-09-06 00:00:00.000000,Romania,France,0,0,UEFA Euro qualification,Bucharest,Romania,0,54,558,15,918,39,-360,D,1,1,0
2011-09-06 00:00:00.000000,San Marino,Sweden,0,5,UEFA Euro qualification,Serravalle,San Marino,0,203,0,18,889,185,-889,L,2,1,0
2011-09-06 00:00:00.000000,Saudi Arabia,Australia,1,3,FIFA World Cup qualification,Riyadh,Saudi Arabia,0,87,372,22,837,65,-465,L,2,1,0
2011-09-06 00:00:00.000000,Scotland,Lithuania,1,0,UEFA Euro qualification,Glasgow,Scotland,0,55,554,56,552,-1,2,W,0,1,0
2011-09-06 00:00:00.000000,Serbia,Faroe Islands,3,1,UEFA Euro qualification,Belgrade,Serbia,0,29,784,111,273,-82,511,W,0,1,0
2011-09-06 00:00:00.000000,Singapore,Iraq,0,2,FIFA World Cup qualification,Singapore,Singapore,0,129,209,109,293,20,-84,L,2,1,0
2011-09-06 00:00:00.000000,Slovakia,Armenia,0,4,UEFA Euro qualification,Žilina,Slovakia,0,26,806,71,456,-45,350,L,2,1,0
2011-09-06 00:00:00.000000,Spain,Liechtenstein,6,0,UEFA Euro qualification,Logroño,Spain,0,2,1563,119,247,-117,1316,W,0,1,0
2011-09-06 00:00:00.000000,St. Lucia,St. Kitts and Nevis,2,4,FIFA World Cup qualification,Gros Islet,St. Lucia,0,184,54,122,239,62,-185,L,2,1,0
2011-09-06 00:00:00.000000,Switzerland,Bulgaria,3,1,UEFA Euro qualification,Basel,Switzerland,0,30,757,51,586,-21,171,W,0,1,0
2011-09-06 00:00:00.000000,Thailand,Oman,3,0,FIFA World Cup qualification,Bangkok,Thailand,0,120,246,103,312,17,-66,W,0,1,0
2011-09-06 00:00:00.000000,Uzbekistan,Japan,1,1,FIFA World Cup qualification,Tashkent,Uzbekistan,0,82,401,15,918,67,-517,D,1,1,0
2011-09-06 00:00:00.000000,Venezuela,Guinea,2,1,Friendly,Caracas,Venezuela,0,44,615,69,464,-25,151,W,0,1,0
2011-09-07 00:00:00.000000,Equatorial Guinea,Central African Republic,3,0,Friendly,Malabo,Equatorial Guinea,0,154,131,104,309,50,-178,W,0,1,0
2011-09-07 00:00:00.000000,New Caledonia,Tahiti,3,1,South Pacific Games,Koné,New Caledonia,0,165,104,183,57,-18,47,W,0,1,0
2011-09-07 00:00:00.000000,Solomon Islands,Fiji,2,1,South Pacific Games,Lifou,New Caledonia,1,177,79,141,180,36,-101,W,0,0,0
2011-09-09 00:00:00.000000,New Caledonia,Solomon Islands,2,0,South Pacific Games,Nouméa,New Caledonia,0,165,104,177,79,-12,25,W,0,1,0
2011-09-09 00:00:00.000000,Tahiti,Fiji,2,1,South Pacific Games,Boulari,New Caledonia,1,183,57,141,180,42,-123,W,0,0,0
2011-09-11 00:00:00.000000,St. Vincent and the Grenadines,Dominica,1,0,Friendly,Kingstown,St. Vincent and the Grenadines,0,158,112,136,193,22,-81,W,0,1,0
2011-09-14 00:00:00.000000,Argentina,Brazil,0,0,Friendly,Córdoba,Argentina,0,9,1017,6,1156,3,-139,D,1,1,0
2011-09-23 00:00:00.000000,Suriname,Curaçao,2,0,Friendly,Paramaribo,Suriname,0,113,286,178,75,-65,211,W,0,1,0
2011-09-25 00:00:00.000000,Suriname,Curaçao,2,2,Friendly,Paramaribo,Suriname,0,113,286,178,75,-65,211,D,1,1,0
2011-09-28 00:00:00.000000,Brazil,Argentina,2,0,Friendly,Belém,Brazil,0,7,1132,10,1024,-3,108,W,0,1,0
2011-09-30 00:00:00.000000,Hong Kong,Philippines,3,3,Dragon Cup,Kaohsiung,Taiwan,1,156,124,166,105,-10,19,D,1,0,0
2011-10-01 00:00:00.000000,Ethiopia,Sudan,1,2,Friendly,Addis Ababa,Ethiopia,0,133,196,103,332,30,-136,L,2,1,0
2011-10-02 00:00:00.000000,Hong Kong,Macau,5,1,Dragon Cup,Kaohsiung,Taiwan,1,156,124,191,25,-35,99,W,0,0,0
2011-10-04 00:00:00.000000,Ethiopia,Malawi,0,0,Friendly,Addis Ababa,Ethiopia,0,133,196,78,439,55,-243,D,1,1,0
2011-10-04 00:00:00.000000,Philippines,Macau,2,0,Dragon Cup,Kaohsiung,Taiwan,1,166,105,191,25,-25,80,W,0,0,0
2011-10-05 00:00:00.000000,Iran,Palestine,7,0,Friendly,Teheran,Iran,0,50,576,162,108,-112,468,W,0,1,0
2011-10-06 00:00:00.000000,Thailand,Jordan,0,0,Friendly,Bangkok,Thailand,0,117,274,85,406,32,-132,D,1,1,0
2011-10-07 00:00:00.000000,Argentina,Chile,4,1,FIFA World Cup qualification,Buenos Aires,Argentina,0,10,1024,14,932,-4,92,W,0,1,0
2011-10-07 00:00:00.000000,Australia,Malaysia,5,0,Friendly,Canberra,Australia,0,19,882,147,158,-128,724,W,0,1,0
2011-10-07 00:00:00.000000,Azerbaijan,Austria,1,4,UEFA Euro qualification,Baku,Azerbaijan,0,97,359,77,442,20,-83,L,2,1,0
2011-10-07 00:00:00.000000,Barbados,Guyana,0,2,FIFA World Cup qualification,Bridgetown,Barbados,0,150,148,116,278,34,-130,L,2,1,0
2011-10-07 00:00:00.000000,Belgium,Kazakhstan,4,1,UEFA Euro qualification,Brussels,Belgium,0,34,729,132,198,-98,531,W,0,1,0
2011-10-07 00:00:00.000000,Belize,Grenada,1,4,FIFA World Cup qualification,Belmopan,Belize,0,134,195,120,265,14,-70,L,2,1,0
2011-10-07 00:00:00.000000,Bermuda,Trinidad and Tobago,2,1,FIFA World Cup qualification,Hamilton,Bermuda,0,189,30,80,414,109,-384,W,0,1,0
2011-10-07 00:00:00.000000,Cayman Islands,Suriname,0,1,FIFA World Cup qualification,Georgetown,Cayman Islands,0,174,84,113,286,61,-202,L,2,1,0
2011-10-07 00:00:00.000000,Congo DR,Cameroon,2,3,African Cup of Nations qualification,Kinshasa,Congo DR,0,129,225,48,596,81,-371,L,2,1,0
2011-10-07 00:00:00.000000,Costa Rica,Brazil,0,1,Friendly,San José,Costa Rica,0,57,549,7,1132,50,-583,L,2,1,0
2011-10-07 00:00:00.000000,Curaçao,Antigua and Barbuda,0,1,FIFA World Cup qualification,Willemstad,Curaçao,0,178,75,101,345,77,-270,L,2,1,0
2011-10-07 00:00:00.000000,Cyprus,Denmark,1,4,UEFA Euro qualification,Nicosia,Cyprus,0,86,398,17,893,69,-495,L,2,1,0
2011-10-07 00:00:00.000000,Czech Republic,Spain,0,2,UEFA Euro qualification,Prague,Czech Republic,0,40,656,1,1605,39,-949,L,2,1,0
2011-10-07 00:00:00.000000,Dominica,Panama,0,5,FIFA World Cup qualification,Roseau,Dominica,0,149,154,53,564,96,-410,L,2,1,0
2011-10-07 00:00:00.000000,Dominican Republic,El Salvador,1,2,FIFA World Cup qualification,San Cristóbal,Dominican Republic,0,139,182,88,390,51,-208,L,2,1,0
2011-10-07 00:00:00.000000,Ecuador,Venezuela,2,0,FIFA World Cup qualification,Quito,Ecuador,0,69,481,47,598,22,-117,W,0,1,0
2011-10-07 00:00:00.000000,Finland,Sweden,1,2,UEFA Euro qualification,Helsinki,Finland,0,72,471,25,792,47,-321,L,2,1,0
2011-10-07 00:00:00.000000,France,Albania,3,0,UEFA Euro qualification,Saint-Denis,France,0,12,956,71,474,-59,482,W,0,1,0
2011-10-07 00:00:00.000000,Gabon,Equatorial Guinea,2,0,Friendly,Nice,France,1,67,489,152,141,-85,348,W,0,0,0
2011-10-07 00:00:00.000000,Greece,Croatia,2,0,UEFA Euro qualification,Piraeus,Greece,0,11,1000,9,1057,2,-57,W,0,1,0
2011-10-07 00:00:00.000000,Indonesia,Saudi Arabia,0,0,Friendly,Kuala Lumpur,Malaysia,1,139,182,97,359,42,-177,D,1,0,0
2011-10-07 00:00:00.000000,Japan,Vietnam,1,0,Friendly,Kobe,Japan,0,15,924,130,209,-115,715,W,0,1,0
2011-10-07 00:00:00.000000,Korea Republic,Poland,2,2,Friendly,Seoul,Korea Republic,0,29,749,65,496,-36,253,D,1,1,0
2011-10-07 00:00:00.000000,Latvia,Malta,2,0,UEFA Euro qualification,Riga,Latvia,0,74,460,154,138,-80,322,W,0,1,0
2011-10-07 00:00:00.000000,Montenegro,England,2,2,UEFA Euro qualification,Podgorica,Montenegro,0,26,777,8,1089,18,-312,D,1,1,0
2011-10-07 00:00:00.000000,Netherlands,Moldova,1,0,UEFA Euro qualification,Rotterdam,Netherlands,0,2,1571,122,255,-120,1316,W,0,1,0
2011-10-07 00:00:00.000000,Northern Ireland,Estonia,1,2,UEFA Euro qualification,Belfast,Northern Ireland,0,70,477,58,537,12,-60,L,2,1,0
2011-10-07 00:00:00.000000,Peru,Paraguay,2,0,FIFA World Cup qualification,Lima,Peru,0,35,724,24,825,11,-101,W,0,1,0
2011-10-07 00:00:00.000000,Portugal,Iceland,5,3,UEFA Euro qualification,Porto,Portugal,0,5,1158,106,316,-101,842,W,0,1,0
2011-10-07 00:00:00.000000,Puerto Rico,St. Kitts and Nevis,1,1,FIFA World Cup qualification,Bayamón,Puerto Rico,0,145,173,123,252,22,-79,D,1,1,0
2011-10-07 00:00:00.000000,Romania,Belarus,2,2,UEFA Euro qualification,Bucharest,Romania,0,49,584,56,554,-7,30,D,1,1,0
2011-10-07 00:00:00.000000,Serbia,Italy,1,1,UEFA Euro qualification,Belgrade,Serbia,0,21,855,6,1142,15,-287,D,1,1,0
2011-10-07 00:00:00.000000,Singapore,Philippines,2,0,Friendly,Singapore,Singapore,0,136,188,166,105,-30,83,W,0,1,0
2011-10-07 00:00:00.000000,Slovakia,Russia,0,1,UEFA Euro qualification,Žilina,Slovakia,0,39,662,13,954,26,-292,L,2,1,0
2011-10-07 00:00:00.000000,St. Lucia,Canada,0,7,FIFA World Cup qualification,Gros Islet,St. Lucia,0,185,46,87,395,98,-349,L,2,1,0
2011-10-07 00:00:00.000000,Turkey,Germany,1,3,UEFA Euro qualification,Istanbul,Turkey,0,27,754,3,1290,24,-536,L,2,1,0
2011-10-07 00:00:00.000000,Ukraine,Bulgaria,3,0,Friendly,Kyïv,Ukraine,0,60,531,55,558,5,-27,W,0,1,0
2011-10-07 00:00:00.000000,Uruguay,Bolivia,4,2,FIFA World Cup qualification,Montevideo,Uruguay,0,4,1184,81,412,-77,772,W,0,1,0
2011-10-07 00:00:00.000000,Wales,Switzerland,2,0,UEFA Euro qualification,Swansea,Wales,0,90,374,18,886,72,-512,W,0,1,0
2011-10-08 00:00:00.000000,Chad,Malawi,2,2,African Cup of Nations qualification,N'Djamena,Chad,0,161,110,78,439,83,-329,D,1,1,0
2011-10-08 00:00:00.000000,Egypt,Niger,3,0,African Cup of Nations qualification,Cairo,Egypt,0,36,713,93,369,-57,344,W,0,1,0
2011-10-08 00:00:00.000000,Ethiopia,Madagascar,4,2,African Cup of Nations qualification,Addis Ababa,Ethiopia,0,133,196,158,115,-25,81,W,0,1,0
2011-10-08 00:00:00.000000,Gambia,Burkina Faso,1,1,African Cup of Nations qualification,Bakau,Gambia,0,125,248,41,651,84,-403,D,1,1,0
2011-10-08 00:00:00.000000,Guinea-Bissau,Angola,0,2,African Cup of Nations qualification,Bissau,Guinea-Bissau,0,163,106,84,407,79,-301,L,2,1,0
2011-10-08 00:00:00.000000,Liberia,Mali,1,2,African Cup of Nations qualification,Paynesville,Liberia,0,128,230,62,519,66,-289,L,2,1,0
2011-10-08 00:00:00.000000,Liechtenstein,Scotland,0,1,UEFA Euro qualification,Vaduz,Liechtenstein,0,118,270,52,572,66,-302,L,2,1,0
2011-10-08 00:00:00.000000,Mozambique,Comoros,3,0,African Cup of Nations qualification,Maputo,Mozambique,0,115,280,178,75,-63,205,W,0,1,0
2011-10-08 00:00:00.000000,Nigeria,Guinea,2,2,African Cup of Nations qualification,Abuja,Nigeria,0,43,613,76,447,-33,166,D,1,1,0
2011-10-08 00:00:00.000000,South Africa,Sierra Leone,0,0,African Cup of Nations qualification,Nelspriut,South Africa,0,51,574,68,488,-17,86,D,1,1,0
2011-10-08 00:00:00.000000,Sudan,Ghana,0,2,African Cup of Nations qualification,Khartoum,Sudan,0,103,332,37,700,66,-368,L,2,1,0
2011-10-08 00:00:00.000000,Swaziland,Congo,0,1,African Cup of Nations qualification,Lobamba,Switzerland,1,169,96,144,177,25,-81,L,2,0,0
2011-10-08 00:00:00.000000,Tunisia,Togo,2,0,African Cup of Nations qualification,Radès,Tunisia,0,61,526,95,364,-34,162,W,0,1,0
2011-10-08 00:00:00.000000,Uganda,Kenya,0,0,African Cup of Nations qualification,Kampala,Uganda,0,82,411,131,200,-49,211,D,1,1,0
2011-10-08 00:00:00.000000,USA,Honduras,1,0,Friendly,Miami Gardens,USA,0,31,741,53,564,-22,177,W,0,1,0
2011-10-08 00:00:00.000000,Zambia,Libya,0,0,African Cup of Nations qualification,Chingola,Zambia,0,83,409,62,519,21,-110,D,1,1,0
2011-10-09 00:00:00.000000,Algeria,Central African Republic,2,0,African Cup of Nations qualification,Algiers,Algeria,0,46,605,111,296,-65,309,W,0,1,0
2011-10-09 00:00:00.000000,Benin,Rwanda,0,1,African Cup of Nations qualification,Cotonou,Benin,0,92,370,143,178,-51,192,L,2,1,0
2011-10-09 00:00:00.000000,Mauritius,Senegal,0,2,African Cup of Nations qualification,Mapou,Mauritius,0,188,33,42,614,146,-581,L,2,1,0
2011-10-09 00:00:00.000000,Morocco,Tanzania,3,1,African Cup of Nations qualification,Marrakech,Morocco,0,59,534,127,240,-68,294,W,0,1,0
2011-10-11 00:00:00.000000,Albania,Romania,1,1,UEFA Euro qualification,Tirana,Albania,0,71,474,49,584,22,-110,D,1,1,0
2011-10-11 00:00:00.000000,Australia,Oman,3,0,FIFA World Cup qualification,Sydney,Australia,0,19,882,105,319,-86,563,W,0,1,0
2011-10-11 00:00:00.000000,Belarus,Poland,0,2,Friendly,Wiesbaden,Germany,1,56,554,65,496,-9,58,L,2,0,0
2011-10-11 00:00:00.000000,Bermuda,Guyana,1,1,FIFA World Cup qualification,Hamilton,Bermuda,0,189,30,116,278,73,-248,D,1,1,0
2011-10-11 00:00:00.000000,Bolivia,Colombia,1,2,FIFA World Cup qualification,La Paz,Bolivia,0,81,412,32,738,49,-326,L,2,1,0
2011-10-11 00:00:00.000000,Bulgaria,Wales,0,1,UEFA Euro qualification,Sofia,Bulgaria,0,55,558,90,374,-35,184,L,2,1,0
2011-10-11 00:00:00.000000,Canada,Puerto Rico,0,0,FIFA World Cup qualification,Toronto,Canada,0,87,395,145,173,-58,222,D,1,1,0
2011-10-11 00:00:00.000000,Chile,Peru,4,2,FIFA World Cup qualification,Santiago,Chile,0,14,932,35,724,-21,208,W,0,1,0
2011-10-11 00:00:00.000000,Croatia,Latvia,2,0,UEFA Euro qualification,Rijeka,Croatia,0,9,1057,74,460,-65,597,W,0,1,0
2011-10-11 00:00:00.000000,Denmark,Portugal,2,1,UEFA Euro qualification,Copenhagen,Denmark,0,17,893,5,1158,12,-265,W,0,1,0
2011-10-11 00:00:00.000000,El Salvador,Cayman Islands,4,0,FIFA World Cup qualification,San Salvador,El Salvador,0,88,390,174,84,-86,306,W,0,1,0
2011-10-11 00:00:00.000000,Equatorial Guinea,Cameroon,1,1,Friendly,Malabo,Equatorial Guinea,0,152,141,48,596,104,-455,D,1,1,0
2011-10-11 00:00:00.000000,Estonia,Ukraine,0,2,Friendly,Tallinn,Estonia,0,58,537,60,531,-2,6,L,2,1,0
2011-10-11 00:00:00.000000,Georgia,Greece,1,2,UEFA Euro qualification,Tbilisi,Georgia,0,64,499,11,1000,53,-501,L,2,1,0
2011-10-11 00:00:00.000000,Germany,Belgium,3,1,UEFA Euro qualification,Düsseldorf,Germany,0,3,1290,34,729,-31,561,W,0,1,0
2011-10-11 00:00:00.000000,Ghana,Nigeria,0,0,Friendly,Watford,England,1,37,700,43,613,-6,87,D,1,0,0
2011-10-11 00:00:00.000000,Guatemala,Belize,3,1,FIFA World Cup qualification,Guatemala,Guatemala,0,109,302,134,195,-25,107,W,0,1,0
2011-10-11 00:00:00.000000,Haiti,Curaçao,2,2,FIFA World Cup qualification,Port-au-Prince,Haiti,0,108,305,178,75,-70,230,D,1,1,0
2011-10-11 00:00:00.000000,Honduras,Jamaica,2,1,Friendly,La Ceiba,Honduras,0,53,564,45,606,8,-42,W,0,1,0
2011-10-11 00:00:00.000000,Hungary,Finland,0,0,UEFA Euro qualification,Budapest,Hungary,0,27,754,72,471,-45,283,D,1,1,0
2011-10-11 00:00:00.000000,Indonesia,Qatar,2,3,FIFA World Cup qualification,Jakarta,Indonesia,0,139,182,100,350,39,-168,L,2,1,0
2011-10-11 00:00:00.000000,Iran,Bahrain,6,0,FIFA World Cup qualification,Teheran,Iran,0,50,576,102,335,-52,241,W,0,1,0
2011-10-11 00:00:00.000000,Italy,Northern Ireland,3,0,UEFA Euro qualification,Pescara,Italy,0,6,1142,70,477,-64,665,W,0,1,0
2011-10-11 00:00:00.000000,Japan,Tajikistan,8,0,FIFA World Cup qualification,Osaka,Japan,0,15,924,124,250,-109,674,W,0,1,0
2011-10-11 00:00:00.000000,Kazakhstan,Austria,0,0,UEFA Euro qualification,Astana,Kazakhstan,0,132,198,77,442,55,-244,D,1,1,0
2011-10-11 00:00:00.000000,Korea DPR,Uzbekistan,0,1,FIFA World Cup qualification,P'yŏngyang,Korea DPR,0,121,258,79,421,42,-163,L,2,1,0
2011-10-11 00:00:00.000000,Korea Republic,United Arab Emirates,2,1,FIFA World Cup qualification,Suwon,Korea Republic,0,29,749,112,287,-83,462,W,0,1,0
2011-10-11 00:00:00.000000,Lebanon,Kuwait,2,2,FIFA World Cup qualification,Beirut,Lebanon,0,146,163,99,352,47,-189,D,1,1,0
2011-10-11 00:00:00.000000,Lithuania,Czech Republic,1,4,UEFA Euro qualification,Kaunas,Lithuania,0,75,459,40,656,35,-197,L,2,1,0
2011-10-11 00:00:00.000000,Malta,Israel,0,2,UEFA Euro qualification,Attard,Malta,0,154,138,38,677,116,-539,L,2,1,0
2011-10-11 00:00:00.000000,Mexico,Brazil,1,2,Friendly,Torreón,Mexico,0,20,866,7,1132,13,-266,L,2,1,0
2011-10-11 00:00:00.000000,Moldova,San Marino,4,0,UEFA Euro qualification,Chişinău,Moldova,0,122,255,203,0,-81,255,W,0,1,0
2011-10-11 00:00:00.000000,Norway,Cyprus,3,1,UEFA Euro qualification,Oslo,Norway,0,23,835,86,398,-63,437,W,0,1,0
2011-10-11 00:00:00.000000,Panama,Nicaragua,5,1,FIFA World Cup qualification,Panama City,Panama,0,53,564,156,124,-103,440,W,0,1,0
2011-10-11 00:00:00.000000,Paraguay,Uruguay,1,1,FIFA World Cup qualification,Asunción,Paraguay,0,24,825,4,1184,20,-359,D,1,1,0
2011-10-11 00:00:00.000000,Philippines,Nepal,4,0,Friendly,Manila,Philippines,0,166,105,135,193,31,-88,W,0,1,0
2011-10-11 00:00:00.000000,Russia,Andorra,6,0,UEFA Euro qualification,Moscow,Russia,0,13,954,203,0,-190,954,W,0,1,0
2011-10-11 00:00:00.000000,Singapore,Jordan,0,3,FIFA World Cup qualification,Singapore,Singapore,0,136,188,85,406,51,-218,L,2,1,0
2011-10-11 00:00:00.000000,Slovenia,Serbia,1,0,UEFA Euro qualification,Maribor,Slovenia,0,33,732,21,855,12,-123,W,0,1,0
2011-10-11 00:00:00.000000,Spain,Scotland,3,1,UEFA Euro qualification,Alicante,Spain,0,1,1605,52,572,-51,1033,W,0,1,0
2011-10-11 00:00:00.000000,St. Kitts and Nevis,St. Lucia,1,1,FIFA World Cup qualification,Basseterre,St. Kitts and Nevis,0,123,252,185,46,-62,206,D,1,1,0
2011-10-11 00:00:00.000000,Suriname,Dominican Republic,1,3,FIFA World Cup qualification,Paramaribo,Suriname,0,113,286,139,182,-26,104,L,2,1,0
2011-10-11 00:00:00.000000,Sweden,Netherlands,3,2,UEFA Euro qualification,Solna,Sweden,0,25,792,2,1571,23,-779,W,0,1,0
2011-10-11 00:00:00.000000,Switzerland,Montenegro,2,0,UEFA Euro qualification,Basel,Switzerland,0,18,886,26,777,-8,109,W,0,1,0
2011-10-11 00:00:00.000000,Thailand,Saudi Arabia,0,0,FIFA World Cup qualification,Bangkok,Thailand,0,117,274,97,359,20,-85,D,1,1,0
2011-10-11 00:00:00.000000,Trinidad and Tobago,Barbados,4,0,FIFA World Cup qualification,Port of Spain,Trinidad and Tobago,0,80,414,150,148,-70,266,W,0,1,0
2011-10-11 00:00:00.000000,Turkey,Azerbaijan,1,0,UEFA Euro qualification,Istanbul,Turkey,0,27,754,97,359,-70,395,W,0,1,0
2011-10-11 00:00:00.000000,USA,Ecuador,0,1,Friendly,Harrison,USA,0,31,741,69,481,-38,260,L,2,1,0
2011-10-11 00:00:00.000000,Venezuela,Argentina,1,0,FIFA World Cup qualification,Puerto la Cruz,Venezuela,0,47,598,10,1024,37,-426,W,0,1,0
2011-10-31 00:00:00.000000,Namibia,Lesotho,0,0,Friendly,Windhoek,Namibia,0,127,248,162,114,-35,134,D,1,1,0
2011-11-04 00:00:00.000000,Kuwait,Bahrain,0,1,Friendly,Kuwait City,Kuwait,0,96,350,101,324,-5,26,L,2,1,0
2011-11-04 00:00:00.000000,Qatar,Oman,0,0,Friendly,Doha,Qatar,0,92,371,103,317,-11,54,D,1,1,0
2011-11-06 00:00:00.000000,Iraq,Lebanon,1,0,Friendly,Doha,Qatar,1,91,379,146,171,-55,208,W,0,0,0
2011-11-06 00:00:00.000000,Lesotho,Congo DR,0,3,Friendly,Pretoria,South Africa,1,162,114,133,223,29,-109,L,2,0,0
2011-11-10 00:00:00.000000,Gabon,Brazil,0,2,Friendly,Libreville,Gabon,0,68,473,5,1144,63,-671,L,2,1,0
2011-11-11 00:00:00.000000,Albania,Azerbaijan,0,1,Friendly,Tirana,Albania,0,71,462,117,265,-46,197,L,2,1,0
2011-11-11 00:00:00.000000,Antigua and Barbuda,Haiti,1,0,FIFA World Cup qualification,St. John's,Antigua and Barbuda,0,90,381,107,307,-17,74,W,0,1,0
2011-11-11 00:00:00.000000,Argentina,Bolivia,1,1,FIFA World Cup qualification,Buenos Aires,Argentina,0,10,1030,115,273,-105,757,D,1,1,0
2011-11-11 00:00:00.000000,Bahrain,Iran,1,1,FIFA World Cup qualification,Riffa,Bahrain,0,101,324,42,626,59,-302,D,1,1,0
2011-11-11 00:00:00.000000,Belgium,Romania,2,1,Friendly,Liège,Belgium,0,37,670,55,575,-18,95,W,0,1,0
2011-11-11 00:00:00.000000,Bermuda,Barbados,2,1,FIFA World Cup qualification,Hamilton,Bermuda,0,132,225,148,164,-16,61,W,0,1,0
2011-11-11 00:00:00.000000,Burkina Faso,Mali,1,1,Friendly,Saint-Leu-la-Forêt,France,1,54,578,68,473,-14,105,D,1,0,0
2011-11-11 00:00:00.000000,Cameroon,Sudan,3,1,Friendly,Marrakech,Morocco,1,47,600,102,323,-55,277,W,0,0,0
2011-11-11 00:00:00.000000,Chad,Tanzania,1,2,FIFA World Cup qualification,N'Djamena,Chad,0,152,151,131,231,21,-80,L,2,1,0
2011-11-11 00:00:00.000000,Colombia,Venezuela,1,1,FIFA World Cup qualification,Barranquilla,Colombia,0,30,757,40,632,-10,125,D,1,1,0
2011-11-11 00:00:00.000000,Comoros,Mozambique,0,1,FIFA World Cup qualification,Mitsamiouli,Comoros,0,183,72,110,281,73,-209,L,2,1,0
2011-11-11 00:00:00.000000,Cyprus,Scotland,1,2,Friendly,Larnaca,Cyprus,0,120,259,51,581,69,-322,L,2,1,0
2011-11-11 00:00:00.000000,Czech Republic,Montenegro,2,0,UEFA Euro qualification,Prague,Czech Republic,0,47,600,39,655,8,-55,W,0,1,0
2011-11-11 00:00:00.000000,Denmark,Sweden,2,0,Friendly,Copenhagen,Denmark,0,10,1030,14,955,-4,75,W,0,1,0
2011-11-11 00:00:00.000000,Djibouti,Namibia,0,4,FIFA World Cup qualification,Djibouti,Djibouti,0,195,12,127,248,68,-236,L,2,1,0
2011-11-11 00:00:00.000000,Dominican Republic,Cayman Islands,4,0,FIFA World Cup qualification,San Cristóbal,Dominican Republic,0,128,245,185,51,-57,194,W,0,1,0
2011-11-11 00:00:00.000000,Equatorial Guinea,Madagascar,2,0,FIFA World Cup qualification,Malabo,Equatorial Guinea,0,155,140,165,111,-10,29,W,0,1,0
2011-11-11 00:00:00.000000,Eritrea,Rwanda,1,1,FIFA World Cup qualification,Asmara,Eritrea,0,190,28,112,277,78,-249,D,1,1,0
2011-11-11 00:00:00.000000,France,USA,1,0,Friendly,Saint-Denis,France,0,15,953,34,720,-19,233,W,0,1,0
2011-11-11 00:00:00.000000,Georgia,Moldova,2,0,Friendly,Tbilisi,Georgia,0,67,475,123,255,-56,220,W,0,1,0
2011-11-11 00:00:00.000000,Greece,Russia,1,1,Friendly,Piraeus,Greece,0,8,1044,13,975,-5,69,D,1,1,0
2011-11-11 00:00:00.000000,Guatemala,Grenada,3,0,FIFA World Cup qualification,Guatemala,Guatemala,0,99,340,116,270,-17,70,W,0,1,0
2011-11-11 00:00:00.000000,Guinea-Bissau,Togo,1,1,FIFA World Cup qualification,Bissau,Guinea-Bissau,0,167,106,94,359,73,-253,D,1,1,0
2011-11-11 00:00:00.000000,Guyana,Trinidad and Tobago,2,1,FIFA World Cup qualification,Providence,Guyana,0,97,346,79,433,18,-87,W,0,1,0
2011-11-11 00:00:00.000000,Hungary,Liechtenstein,5,0,Friendly,Budapest,Hungary,0,36,701,126,249,-90,452,W,0,1,0
2011-11-11 00:00:00.000000,Jordan,Singapore,2,0,FIFA World Cup qualification,Amman,Jordan,0,81,428,139,185,-58,243,W,0,1,0
2011-11-11 00:00:00.000000,Kuwait,Lebanon,0,1,FIFA World Cup qualification,Kuwait City,Kuwait,0,96,350,146,171,-50,179,L,2,1,0
2011-11-11 00:00:00.000000,Lesotho,Burundi,1,0,FIFA World Cup qualification,Maseru,Lesotho,0,162,114,141,183,21,-69,W,0,1,0
2011-11-11 00:00:00.000000,Mexico,Serbia,2,0,Friendly,Querétaro,Mexico,0,22,860,23,854,-1,6,W,0,1,0
2011-11-11 00:00:00.000000,Morocco,Uganda,0,1,Friendly,Marrakech,Morocco,0,56,566,88,393,-32,173,L,2,1,0
2011-11-11 00:00:00.000000,Netherlands,Switzerland,0,0,Friendly,Amsterdam,Netherlands,0,2,1425,18,920,-16,505,D,1,1,0
2011-11-11 00:00:00.000000,Nicaragua,Dominica,1,0,FIFA World Cup qualification,Managua,Nicaragua,0,160,115,152,151,8,-36,W,0,1,0
2011-11-11 00:00:00.000000,Oman,Australia,1,0,FIFA World Cup qualification,Muscat,Oman,0,103,317,20,868,83,-551,W,0,1,0
2011-11-11 00:00:00.000000,Panama,Costa Rica,2,0,Friendly,Panama City,Panama,0,53,579,62,522,-9,57,W,0,1,0
2011-11-11 00:00:00.000000,Paraguay,Ecuador,2,1,FIFA World Cup qualification,Asunción,Paraguay,0,28,785,52,580,-24,205,W,0,1,0
2011-11-11 00:00:00.000000,Poland,Italy,0,2,Friendly,Wrocław,Poland,0,64,506,6,1135,58,-629,L,2,1,0
2011-11-11 00:00:00.000000,Puerto Rico,St. Lucia,4,0,FIFA World Cup qualification,Bayamón,Puerto Rico,0,137,199,179,78,-42,121,W,0,1,0
2011-11-11 00:00:00.000000,Qatar,Indonesia,4,0,FIFA World Cup qualification,Doha,Qatar,0,92,371,140,184,-48,187,W,0,1,0
2011-11-11 00:00:00.000000,Saudi Arabia,Thailand,3,0,FIFA World Cup qualification,Riyadh,Saudi Arabia,0,98,341,114,275,-16,66,W,0,1,0
2011-11-11 00:00:00.000000,Seychelles,Kenya,0,3,FIFA World Cup qualification,Victoria,Seychelles,0,178,82,135,205,43,-123,L,2,1,0
2011-11-11 00:00:00.000000,St. Kitts and Nevis,Canada,0,0,FIFA World Cup qualification,Basseterre,St. Kitts and Nevis,0,109,289,83,425,26,-136,D,1,1,0
2011-11-11 00:00:00.000000,Suriname,El Salvador,1,3,FIFA World Cup qualification,Paramaribo,Suriname,0,104,313,82,426,22,-113,L,2,1,0
2011-11-11 00:00:00.000000,Swaziland,Congo DR,1,3,FIFA World Cup qualification,Lobamba,Switzerland,1,175,87,133,223,42,-136,L,2,0,0
2011-11-11 00:00:00.000000,Tajikistan,Japan,0,4,FIFA World Cup qualification,Dushanbe,Tajikistan,0,130,232,17,924,113,-692,L,2,1,0
2011-11-11 00:00:00.000000,Turkey,Croatia,0,3,UEFA Euro qualification,Istanbul,Turkey,0,26,803,12,1015,14,-212,L,2,1,0
2011-11-11 00:00:00.000000,Ukraine,Germany,3,3,Friendly,Kyïv,Ukraine,0,58,551,3,1352,55,-801,D,1,1,0
2011-11-11 00:00:00.000000,United Arab Emirates,Korea Republic,0,2,FIFA World Cup qualification,Dubai,United Arab Emirates,0,113,276,31,754,82,-478,L,2,1,0
2011-11-11 00:00:00.000000,Uruguay,Chile,4,0,FIFA World Cup qualification,Montevideo,Uruguay,0,4,1230,16,941,-12,289,W,0,1,0
2011-11-11 00:00:00.000000,Uzbekistan,Korea DPR,1,0,FIFA World Cup qualification,Tashkent,Uzbekistan,0,73,452,124,254,-51,198,W,0,1,0
2011-11-12 00:00:00.000000,Algeria,Tunisia,1,0,Friendly,Algiers,Algeria,0,35,713,60,541,-25,172,W,0,1,0
2011-11-12 00:00:00.000000,England,Spain,1,0,Friendly,London,England,0,7,1101,1,1624,6,-523,W,0,1,0
2011-11-12 00:00:00.000000,Nigeria,Botswana,0,0,Friendly,Abuja,Nigeria,0,44,625,89,386,-45,239,D,1,1,0
2011-11-12 00:00:00.000000,Somalia,Ethiopia,0,0,FIFA World Cup qualification,Djibouti,Djibouti,1,192,23,136,201,56,-178,D,1,0,0
2011-11-12 00:00:00.000000,Wales,Norway,4,1,Friendly,Cardiff,Wales,0,45,619,24,838,21,-219,W,0,1,0
2011-11-13 00:00:00.000000,India,Malaysia,1,1,Friendly,Guwahati,India,0,160,115,151,155,9,-40,D,1,1,0
2011-11-13 00:00:00.000000,Morocco,Cameroon,1,1,Friendly,Marrakech,Morocco,0,56,566,47,600,9,-34,D,1,1,0
2011-11-13 00:00:00.000000,Sudan,Uganda,0,0,Friendly,Marrakech,Morocco,1,102,323,88,393,14,-70,D,1,0,0
2011-11-14 00:00:00.000000,Bermuda,Barbados,2,1,FIFA World Cup qualification,Hamilton,Bermuda,0,132,225,148,164,-16,61,W,0,1,0
2011-11-14 00:00:00.000000,Brazil,Egypt,2,0,Friendly,al-Rayyan,Qatar,1,5,1144,29,775,-24,369,W,0,0,0
2011-11-14 00:00:00.000000,Cayman Islands,Dominican Republic,1,1,FIFA World Cup qualification,Georgetown,Cayman Islands,0,185,51,128,245,57,-194,D,1,1,0
2011-11-14 00:00:00.000000,Honduras,Serbia,2,0,Friendly,San Pedro Sula,Honduras,0,57,555,23,854,34,-299,W,0,1,0
2011-11-14 00:00:00.000000,Puerto Rico,St. Lucia,3,0,FIFA World Cup qualification,Mayagüez,Puerto Rico,0,137,199,179,78,-42,121,W,0,1,0
2011-11-15 00:00:00.000000,Belarus,Libya,1,1,Friendly,Dubai,United Arab Emirates,1,61,529,65,504,-4,25,D,1,0,0
2011-11-15 00:00:00.000000,Burundi,Lesotho,2,2,FIFA World Cup qualification,Bujumbura,Burundi,0,141,183,162,114,-21,69,D,1,1,0
2011-11-15 00:00:00.000000,Canada,St. Kitts and Nevis,4,0,FIFA World Cup qualification,Toronto,Canada,0,83,425,109,289,-26,136,W,0,1,0
2011-11-15 00:00:00.000000,Chile,Paraguay,2,0,FIFA World Cup qualification,Santiago,Chile,0,16,941,28,785,-12,156,W,0,1,0
2011-11-15 00:00:00.000000,Colombia,Argentina,1,2,FIFA World Cup qualification,Barranquilla,Colombia,0,30,757,10,1030,20,-273,L,2,1,0
2011-11-15 00:00:00.000000,Congo DR,Swaziland,5,1,FIFA World Cup qualification,Kinshasa,Congo DR,0,133,223,175,87,-42,136,W,0,1,0
2011-11-15 00:00:00.000000,Costa Rica,Spain,2,2,Friendly,San José,Costa Rica,0,62,522,1,1624,61,-1102,D,1,1,0
2011-11-15 00:00:00.000000,Croatia,Turkey,0,0,UEFA Euro qualification,Zagreb,Croatia,0,12,1015,26,803,-14,212,D,1,1,0
2011-11-15 00:00:00.000000,Denmark,Finland,2,1,Friendly,Esbjerg,Denmark,0,10,1030,78,438,-68,592,W,0,1,0
2011-11-15 00:00:00.000000,Ecuador,Peru,2,0,FIFA World Cup qualification,Quito,Ecuador,0,52,580,32,746,20,-166,W,0,1,0
2011-11-15 00:00:00.000000,El Salvador,Suriname,4,0,FIFA World Cup qualification,San Salvador,El Salvador,0,82,426,104,313,-22,113,W,0,1,0
2011-11-15 00:00:00.000000,England,Sweden,1,0,Friendly,London,England,0,7,1101,14,955,-7,146,W,0,1,0
2011-11-15 00:00:00.000000,France,Belgium,0,0,Friendly,Saint-Denis,France,0,15,953,37,670,-22,283,D,1,1,0
2011-11-15 00:00:00.000000,Germany,Netherlands,3,0,Friendly,Hamburg,Germany,0,3,1352,2,1425,1,-73,W,0,1,0
2011-11-15 00:00:00.000000,Ghana,Gabon,2,1,Friendly,Saint-Leu-la-Forêt,France,1,33,734,68,473,-35,261,W,0,0,0
2011-11-15 00:00:00.000000,Greece,Romania,1,3,Friendly,Altach,Austria,1,8,1044,55,575,-47,469,L,2,0,0
2011-11-15 00:00:00.000000,Grenada,Guatemala,1,4,FIFA World Cup qualification,St. George's,Grenada,0,116,270,99,340,17,-70,L,2,1,0
2011-11-15 00:00:00.000000,Guinea,Burkina Faso,1,1,Friendly,Viry-Châtillon,France,1,75,447,54,578,21,-131,D,1,0,0
2011-11-15 00:00:00.000000,Haiti,Antigua and Barbuda,2,1,FIFA World Cup qualification,Port-au-Prince,Haiti,0,107,307,90,381,17,-74,W,0,1,0
2011-11-15 00:00:00.000000,Indonesia,Iran,1,4,FIFA World Cup qualification,Jakarta,Indonesia,0,140,184,42,626,98,-442,L,2,1,0
2011-11-15 00:00:00.000000,Italy,Uruguay,0,1,Friendly,Rome,Italy,0,6,1135,4,1230,2,-95,L,2,1,0
2011-11-15 00:00:00.000000,Jordan,Iraq,1,3,FIFA World Cup qualification,Amman,Jordan,0,81,428,91,379,-10,49,L,2,1,0
2011-11-15 00:00:00.000000,Kenya,Seychelles,4,0,FIFA World Cup qualification,Nairobi,Kenya,0,135,205,178,82,-43,123,W,0,1,0
2011-11-15 00:00:00.000000,Korea DPR,Japan,1,0,FIFA World Cup qualification,P'yŏngyang,Korea DPR,0,124,254,17,924,107,-670,W,0,1,0
2011-11-15 00:00:00.000000,Kuwait,United Arab Emirates,2,1,FIFA World Cup qualification,Kuwait City,Kuwait,0,96,350,113,276,-17,74,W,0,1,0
2011-11-15 00:00:00.000000,Lebanon,Korea Republic,2,1,FIFA World Cup qualification,Beirut,Lebanon,0,146,171,31,754,115,-583,W,0,1,0
2011-11-15 00:00:00.000000,Luxembourg,Switzerland,0,1,Friendly,Luxembourg,Luxembourg,0,118,263,18,920,100,-657,L,2,1,0
2011-11-15 00:00:00.000000,Madagascar,Equatorial Guinea,2,1,FIFA World Cup qualification,Antananarivo,Madagascar,0,165,111,155,140,10,-29,W,0,1,0
2011-11-15 00:00:00.000000,Montenegro,Czech Republic,0,1,UEFA Euro qualification,Podgorica,Montenegro,0,39,655,47,600,-8,55,L,2,1,0
2011-11-15 00:00:00.000000,Mozambique,Comoros,4,1,FIFA World Cup qualification,Maputo,Mozambique,0,110,281,183,72,-73,209,W,0,1,0
2011-11-15 00:00:00.000000,Namibia,Djibouti,4,0,FIFA World Cup qualification,Windhoek,Namibia,0,127,248,195,12,-68,236,W,0,1,0
2011-11-15 00:00:00.000000,Niger,Botswana,1,1,Friendly,Niamey,Niger,0,95,352,89,386,6,-34,D,1,1,0
2011-11-15 00:00:00.000000,Nigeria,Zambia,2,0,Friendly,Kaduna,Nigeria,0,44,625,80,432,-36,193,W,0,1,0
2011-11-15 00:00:00.000000,Panama,Dominica,3,0,FIFA World Cup qualification,Panama City,Panama,0,53,579,152,151,-99,428,W,0,1,0
2011-11-15 00:00:00.000000,Poland,Hungary,2,1,Friendly,Poznań,Poland,0,64,506,36,701,28,-195,W,0,1,0
2011-11-15 00:00:00.000000,Qatar,Bahrain,0,0,FIFA World Cup qualification,Doha,Qatar,0,92,371,101,324,-9,47,D,1,1,0
2011-11-15 00:00:00.000000,Rwanda,Eritrea,3,1,FIFA World Cup qualification,Kigali,Rwanda,0,112,277,190,28,-78,249,W,0,1,0
2011-11-15 00:00:00.000000,Saudi Arabia,Oman,0,0,FIFA World Cup qualification,Riyadh,Saudi Arabia,0,98,341,103,317,-5,24,D,1,1,0
2011-11-15 00:00:00.000000,Slovenia,USA,2,3,Friendly,Ljubljana,Slovenia,0,27,787,34,720,-7,67,L,2,1,0
2011-11-15 00:00:00.000000,Tanzania,Chad,0,1,FIFA World Cup qualification,Dar es Salaam,Tanzania,0,131,231,152,151,-21,80,L,2,1,0
2011-11-15 00:00:00.000000,Thailand,Australia,0,1,FIFA World Cup qualification,Bangkok,Thailand,0,114,275,20,868,94,-593,L,2,1,0
2011-11-15 00:00:00.000000,Togo,Guinea-Bissau,1,0,FIFA World Cup qualification,Lomé,Togo,0,94,359,167,106,-73,253,W,0,1,0
2011-11-15 00:00:00.000000,Trinidad and Tobago,Guyana,2,0,FIFA World Cup qualification,Port of Spain,Trinidad and Tobago,0,79,433,97,346,-18,87,W,0,1,0
2011-11-15 00:00:00.000000,Ukraine,Austria,2,1,Friendly,L'viv,Ukraine,0,58,551,72,458,-14,93,W,0,1,0
2011-11-15 00:00:00.000000,Uzbekistan,Tajikistan,3,0,FIFA World Cup qualification,Tashkent,Uzbekistan,0,73,452,130,232,-57,220,W,0,1,0
2011-11-15 00:00:00.000000,Venezuela,Bolivia,1,0,FIFA World Cup qualification,San Cristóbal,Venezuela,0,40,632,115,273,-75,359,W,0,1,0
2011-11-15 00:00:00.000000,Zimbabwe,South Africa,2,1,Friendly,Harare,Zimbabwe,0,74,448,49,595,25,-147,W,0,1,0
2011-11-16 00:00:00.000000,Ethiopia,Somalia,5,0,FIFA World Cup qualification,Addis Ababa,Ethiopia,0,136,201,192,23,-56,178,W,0,1,0
2011-11-16 00:00:00.000000,India,Malaysia,3,2,Friendly,Calcutta,India,0,160,115,151,155,9,-40,W,0,1,0
2011-11-24 00:00:00.000000,American Samoa,Cook Islands,1,1,Oceania Nations Cup qualification,Apia,Samoa,1,204,0,196,10,8,-10,D,1,0,0
2011-11-24 00:00:00.000000,Maldives,Seychelles,2,1,Friendly,Malé,Maldives,0,166,106,183,69,-17,37,W,0,1,0
2011-11-24 00:00:00.000000,Samoa,Tonga,1,1,Oceania Nations Cup qualification,Apia,Samoa,0,204,0,202,3,2,-3,D,1,1,0
2011-11-25 00:00:00.000000,Burundi,Somalia,4,1,CECAFA Cup,Dar es Salaam,Tanzania,1,145,174,187,51,-42,123,W,0,0,0
2011-11-26 00:00:00.000000,Samoa,American Samoa,1,0,Oceania Nations Cup qualification,Apia,Samoa,0,204,0,204,0,0,0,W,0,1,0
2011-11-26 00:00:00.000000,Tanzania,Rwanda,0,1,CECAFA Cup,Dar es Salaam,Tanzania,0,136,228,114,297,22,-69,L,2,1,0
2011-11-26 00:00:00.000000,Tonga,Cook Islands,2,1,Oceania Nations Cup qualification,Apia,Samoa,1,202,3,196,10,6,-7,W,0,0,0
2011-11-27 00:00:00.000000,Zimbabwe,Djibouti,2,0,CECAFA Cup,Dar es Salaam,Tanzania,1,70,462,200,5,-130,457,W,0,0,0
2011-11-28 00:00:00.000000,Kenya,Malawi,0,2,CECAFA Cup,Dar es Salaam,Tanzania,1,133,240,87,407,46,-167,L,2,0,0
2011-11-28 00:00:00.000000,Somalia,Uganda,0,4,CECAFA Cup,Chamazi,Tanzania,1,187,51,91,394,96,-343,L,2,0,0
2011-11-28 00:00:00.000000,Sudan,Ethiopia,1,1,CECAFA Cup,Dar es Salaam,Tanzania,1,112,304,137,225,-25,79,D,1,0,0
2011-11-29 00:00:00.000000,India,Zambia,0,5,Friendly,Margao,India,0,162,119,79,436,83,-317,L,2,1,0
2011-11-29 00:00:00.000000,Rwanda,Zimbabwe,2,0,CECAFA Cup,Dar es Salaam,Tanzania,1,114,297,70,462,44,-165,W,0,0,0
2011-11-29 00:00:00.000000,Tanzania,Djibouti,3,0,CECAFA Cup,Dar es Salaam,Tanzania,0,136,228,200,5,-64,223,W,0,1,0
2011-11-30 00:00:00.000000,Ethiopia,Kenya,0,2,CECAFA Cup,Dar es Salaam,Tanzania,1,137,225,133,240,4,-15,L,2,0,0
2011-11-30 00:00:00.000000,Malawi,Sudan,0,0,CECAFA Cup,Dar es Salaam,Tanzania,1,87,407,112,304,-25,103,D,1,0,0
2011-12-01 00:00:00.000000,Burundi,Uganda,1,0,CECAFA Cup,Dar es Salaam,Tanzania,1,145,174,91,394,54,-220,W,0,0,0
2011-12-02 00:00:00.000000,Bangladesh,Pakistan,0,0,SAFF Cup,New Delhi,India,1,142,181,174,87,-32,94,D,1,0,0
2011-12-02 00:00:00.000000,Ethiopia,Malawi,1,1,CECAFA Cup,Dar es Salaam,Tanzania,1,137,225,87,407,50,-182,D,1,0,0
2011-12-02 00:00:00.000000,Maldives,Nepal,1,1,SAFF Cup,New Delhi,India,1,166,106,143,177,23,-71,D,1,0,0
2011-12-02 00:00:00.000000,Rwanda,Djibouti,5,2,CECAFA Cup,Dar es Salaam,Tanzania,1,114,297,200,5,-86,292,W,0,0,0
2011-12-02 00:00:00.000000,Suriname,Aruba,0,0,ABCS Tournament,Paramaribo,Suriname,0,122,261,172,92,-50,169,D,1,1,0
2011-12-03 00:00:00.000000,India,Afghanistan,1,1,SAFF Cup,New Delhi,India,0,162,119,178,77,-16,42,D,1,1,0
2011-12-03 00:00:00.000000,Kenya,Sudan,0,1,CECAFA Cup,Dar es Salaam,Tanzania,1,133,240,112,304,21,-64,L,2,0,0
2011-12-03 00:00:00.000000,Sri Lanka,Bhutan,3,0,SAFF Cup,New Delhi,India,1,176,85,198,6,-22,79,W,0,0,0
2011-12-03 00:00:00.000000,Tanzania,Zimbabwe,1,2,CECAFA Cup,Dar es Salaam,Tanzania,0,136,228,70,462,66,-234,L,2,1,0
2011-12-04 00:00:00.000000,Bangladesh,Nepal,0,1,SAFF Cup,New Delhi,India,1,142,181,143,177,-1,4,L,2,0,0
2011-12-04 00:00:00.000000,Maldives,Pakistan,0,0,SAFF Cup,New Delhi,India,1,166,106,174,87,-8,19,D,1,0,0
2011-12-04 00:00:00.000000,Suriname,Curaçao,2,0,ABCS Tournament,Paramaribo,Suriname,0,122,261,149,154,-27,107,W,0,1,0
2011-12-05 00:00:00.000000,Burundi,Sudan,0,2,CECAFA Cup,Dar es Salaam,Tanzania,1,145,174,112,304,33,-130,L,2,0,0
2011-12-05 00:00:00.000000,India,Bhutan,5,0,SAFF Cup,New Delhi,India,0,162,119,198,6,-36,113,W,0,1,0
2011-12-05 00:00:00.000000,Sri Lanka,Afghanistan,1,3,SAFF Cup,New Delhi,India,1,176,85,178,77,-2,8,L,2,0,0
2011-12-06 00:00:00.000000,Bahrain,Palestine,0,1,Friendly,Arad,Bahrain,0,102,340,164,113,-62,227,L,2,1,0
2011-12-06 00:00:00.000000,Maldives,Bangladesh,3,1,SAFF Cup,New Delhi,India,1,166,106,142,181,24,-75,W,0,0,0
2011-12-06 00:00:00.000000,Pakistan,Nepal,1,1,SAFF Cup,New Delhi,India,1,174,87,143,177,31,-90,D,1,0,0
2011-12-06 00:00:00.000000,Tanzania,Malawi,1,0,CECAFA Cup,Dar es Salaam,Tanzania,0,136,228,87,407,49,-179,W,0,1,0
2011-12-06 00:00:00.000000,Uganda,Zimbabwe,1,0,CECAFA Cup,Dar es Salaam,Tanzania,1,91,394,70,462,21,-68,W,0,0,0
2011-12-07 00:00:00.000000,Bhutan,Afghanistan,1,8,SAFF Cup,New Delhi,India,1,198,6,178,77,20,-71,L,2,0,0
2011-12-07 00:00:00.000000,India,Sri Lanka,3,0,SAFF Cup,New Delhi,India,0,162,119,176,85,-14,34,W,0,1,0
2011-12-08 00:00:00.000000,Sudan,Rwanda,1,2,CECAFA Cup,Dar es Salaam,Tanzania,1,112,304,114,297,-2,7,L,2,0,0
2011-12-08 00:00:00.000000,Tanzania,Uganda,1,3,CECAFA Cup,Dar es Salaam,Tanzania,0,136,228,91,394,45,-166,L,2,1,0
2011-12-09 00:00:00.000000,Afghanistan,Nepal,1,0,SAFF Cup,New Delhi,India,1,178,77,143,177,35,-100,W,0,0,0
2011-12-09 00:00:00.000000,India,Maldives,3,1,SAFF Cup,New Delhi,India,0,162,119,166,106,-4,13,W,0,1,0
2011-12-10 00:00:00.000000,Rwanda,Uganda,2,2,CECAFA Cup,Dar es Salaam,Tanzania,1,114,297,91,394,23,-97,D,1,0,0
2011-12-10 00:00:00.000000,Tanzania,Sudan,0,1,CECAFA Cup,Dar es Salaam,Tanzania,0,136,228,112,304,24,-76,L,2,1,0
2011-12-11 00:00:00.000000,Cuba,Costa Rica,1,1,Friendly,Havana,Cuba,0,92,390,64,503,28,-113,D,1,1,0
2011-12-11 00:00:00.000000,India,Afghanistan,4,0,SAFF Cup,New Delhi,India,0,162,119,178,77,-16,42,W,0,1,0
2011-12-14 00:00:00.000000,Angola,Cameroon,1,1,Friendly,Cabinda,Angola,0,84,412,48,602,36,-190,D,1,1,0
2011-12-18 00:00:00.000000,Angola,Zambia,1,0,Friendly,Dundo,Angola,0,84,412,79,436,5,-24,W,0,1,0
2011-12-21 00:00:00.000000,Chile,Paraguay,3,2,Friendly,La Serena,Chile,0,13,970,24,795,-11,175,W,0,1,0
2011-12-22 00:00:00.000000,Angola,Namibia,0,0,Friendly,Lubango,Angola,0,83,412,121,264,-38,148,D,1,1,0
2011-12-22 00:00:00.000000,Venezuela,Costa Rica,0,2,Friendly,Barquisimeto,Venezuela,0,39,661,65,495,-26,166,L,2,1,0
2012-01-06 00:00:00.000000,Equatorial Guinea,South Africa,0,0,Friendly,Bata,Equatorial Guinea,0,150,148,52,577,98,-429,D,1,1,0
2012-01-07 00:00:00.000000,Botswana,Zimbabwe,0,0,Friendly,Gaborone,Botswana,0,95,371,98,354,-3,17,D,1,1,0
2012-01-09 00:00:00.000000,Gabon,Burkina Faso,0,0,Friendly,Bitam,Gabon,0,77,445,62,518,15,-73,D,1,1,0
2012-01-09 00:00:00.000000,Tunisia,Sudan,3,0,Friendly,Sharjah,United Arab Emirates,1,59,537,113,297,-54,240,W,0,0,0
2012-01-11 00:00:00.000000,Nigeria,Angola,0,0,Friendly,Abuja,Nigeria,0,43,627,83,412,-40,215,D,1,1,0
2012-01-12 00:00:00.000000,Senegal,Sudan,1,0,Friendly,Dakar,Senegal,0,44,625,113,297,-69,328,W,0,1,0
2012-01-14 00:00:00.000000,Angola,Sierra Leone,3,1,Friendly,Cabinda,Angola,0,83,412,60,526,23,-114,W,0,1,0
2012-01-14 00:00:00.000000,Zambia,Namibia,0,0,Friendly,Johannesburg,South Africa,1,79,439,121,264,-42,175,D,1,0,0
2012-01-15 00:00:00.000000,Oman,Congo DR,2,2,Friendly,Muscat,Oman,0,85,408,125,254,-40,154,D,1,1,0
2012-01-16 00:00:00.000000,Gabon,Sudan,0,0,Friendly,Franceville,Gabon,0,77,445,113,297,-36,148,D,1,1,0
2012-01-18 00:00:00.000000,Bahrain,Sweden,0,2,Friendly,Doha,Qatar,1,95,372,17,891,78,-519,L,2,0,0
2012-01-18 00:00:00.000000,Thailand,Norway,0,1,King's Cup,Bangkok,Thailand,0,124,257,24,788,100,-531,L,2,1,0
2012-01-21 00:00:00.000000,Equatorial Guinea,Libya,1,0,African Cup of Nations,Bata,Equatorial Guinea,0,151,147,63,514,88,-367,W,0,1,0
2012-01-21 00:00:00.000000,Senegal,Zambia,1,2,African Cup of Nations,Bata,Equatorial Guinea,1,43,625,71,459,-28,166,L,2,0,0
2012-01-21 00:00:00.000000,USA,Venezuela,1,0,Friendly,Glendale,USA,0,33,721,41,642,-8,79,W,0,1,0
2012-01-22 00:00:00.000000,Burkina Faso,Angola,1,2,African Cup of Nations,Malabo,Equatorial Guinea,1,66,499,85,405,-19,94,L,2,0,0
2012-01-22 00:00:00.000000,Lebanon,Iraq,1,0,Friendly,Beirut,Lebanon,0,112,293,73,457,39,-164,W,0,1,0
2012-01-22 00:00:00.000000,Trinidad and Tobago,Finland,2,3,Friendly,Port of Spain,Trinidad and Tobago,0,78,448,85,405,-7,43,L,2,1,0
2012-01-23 00:00:00.000000,Gabon,Niger,2,0,African Cup of Nations,Libreville,Gabon,0,91,387,98,361,-7,26,W,0,1,0
2012-01-23 00:00:00.000000,Morocco,Tunisia,1,2,African Cup of Nations,Libreville,Gabon,1,61,523,59,541,2,-18,L,2,0,0
2012-01-24 00:00:00.000000,Ghana,Botswana,1,0,African Cup of Nations,Franceville,Gabon,1,26,779,94,373,-68,406,W,0,0,0
2012-01-24 00:00:00.000000,Mali,Guinea,1,0,African Cup of Nations,Franceville,Gabon,1,69,476,79,436,-10,40,W,0,0,0
2012-01-25 00:00:00.000000,Equatorial Guinea,Senegal,2,1,African Cup of Nations,Bata,Equatorial Guinea,0,151,147,43,625,108,-478,W,0,1,0
2012-01-25 00:00:00.000000,Libya,Zambia,2,2,African Cup of Nations,Bata,Equatorial Guinea,1,63,514,71,459,-8,55,D,1,0,0
2012-01-25 00:00:00.000000,Mexico,Venezuela,3,1,Friendly,Houston,USA,1,21,866,41,642,-20,224,W,0,0,0
2012-01-25 00:00:00.000000,Panama,USA,0,1,Friendly,Panama City,Panama,0,47,600,33,721,14,-121,L,2,1,0
2012-01-26 00:00:00.000000,Sudan,Angola,2,2,African Cup of Nations,Malabo,Equatorial Guinea,1,120,265,85,405,35,-140,D,1,0,0
2012-01-27 00:00:00.000000,Gabon,Morocco,3,2,African Cup of Nations,Libreville,Gabon,0,91,387,61,523,30,-136,W,0,1,0
2012-01-27 00:00:00.000000,Niger,Tunisia,1,2,African Cup of Nations,Libreville,Gabon,1,98,361,59,541,39,-180,L,2,0,0
2012-01-27 00:00:00.000000,Romania,Turkmenistan,4,0,Friendly,Belek,Turkey,1,55,562,146,164,-91,398,W,0,0,0
2012-01-28 00:00:00.000000,Botswana,Guinea,1,6,African Cup of Nations,Franceville,Gabon,1,94,373,79,436,15,-63,L,2,0,0
2012-01-28 00:00:00.000000,Ghana,Mali,2,0,African Cup of Nations,Franceville,Gabon,1,26,779,69,476,-43,303,W,0,0,0
2012-01-29 00:00:00.000000,Equatorial Guinea,Zambia,0,1,African Cup of Nations,Malabo,Equatorial Guinea,0,151,147,71,459,80,-312,L,2,1,0
2012-01-29 00:00:00.000000,Libya,Senegal,2,1,African Cup of Nations,Bata,Equatorial Guinea,1,63,514,43,625,20,-111,W,0,0,0
2012-01-29 00:00:00.000000,United Arab Emirates,Uzbekistan,1,0,Friendly,Dubai,United Arab Emirates,0,138,223,67,495,71,-272,W,0,1,0
2012-01-30 00:00:00.000000,Sudan,Burkina Faso,2,1,African Cup of Nations,Bata,Equatorial Guinea,1,120,265,66,499,54,-234,W,0,0,0
2012-01-31 00:00:00.000000,Gabon,Tunisia,1,0,African Cup of Nations,Franceville,Gabon,0,91,387,59,541,32,-154,W,0,1,0
2012-01-31 00:00:00.000000,Niger,Morocco,0,1,African Cup of Nations,Libreville,Gabon,1,98,361,61,523,37,-162,L,2,0,0
2012-02-01 00:00:00.000000,Botswana,Mali,1,2,African Cup of Nations,Libreville,Gabon,1,94,373,69,476,25,-103,L,2,0,0
2012-02-01 00:00:00.000000,Ghana,Guinea,1,1,African Cup of Nations,Franceville,Gabon,1,26,779,79,436,-53,343,D,1,0,0
2012-02-04 00:00:00.000000,Zambia,Sudan,3,0,African Cup of Nations,Bata,Equatorial Guinea,1,71,459,120,265,-49,194,W,0,0,0
2012-02-05 00:00:00.000000,Gabon,Mali,1,1,African Cup of Nations,Libreville,Gabon,0,91,387,69,476,22,-89,D,1,1,0
2012-02-05 00:00:00.000000,Ghana,Tunisia,2,1,African Cup of Nations,Franceville,Gabon,1,26,779,59,541,-33,238,W,0,0,0
2012-02-08 00:00:00.000000,Zambia,Ghana,1,0,African Cup of Nations,Bata,Equatorial Guinea,1,71,459,26,779,45,-320,W,0,0,0
2012-02-11 00:00:00.000000,Ghana,Mali,0,2,African Cup of Nations,Malabo,Equatorial Guinea,1,26,779,69,476,-43,303,L,2,0,0
2012-02-15 00:00:00.000000,Liberia,Nigeria,0,2,Friendly,Monrovia,Liberia,0,125,258,56,573,69,-315,L,2,1,0
2012-02-15 00:00:00.000000,Paraguay,Chile,2,0,Friendly,Luque,Paraguay,0,27,781,12,996,15,-215,W,0,1,0
2012-02-17 00:00:00.000000,Korea DPR,Kuwait,1,1,Friendly,Changsha,China,1,106,314,91,399,15,-85,D,1,0,0
2012-02-22 00:00:00.000000,Grenada,Guyana,1,2,Friendly,St. George's,Grenada,0,133,240,92,388,41,-148,L,2,1,0
2012-02-22 00:00:00.000000,Jamaica,Cuba,1,0,Friendly,Kingston,Jamaica,0,50,589,116,290,-66,299,W,0,1,0
2012-02-22 00:00:00.000000,Paraguay,Guatemala,2,1,Friendly,Luque,Paraguay,0,27,781,84,422,-57,359,W,0,1,0
2012-02-23 00:00:00.000000,Iran,Jordan,2,2,Friendly,Dubai,United Arab Emirates,1,47,606,82,431,-35,175,D,1,0,0
2012-02-23 00:00:00.000000,Oman,India,5,1,Friendly,Seeb,Oman,0,95,377,154,141,-59,236,W,0,1,0
2012-02-23 00:00:00.000000,Tanzania,Congo DR,0,0,Friendly,Dar es Salaam,Tanzania,0,139,224,119,280,20,-56,D,1,1,0
2012-02-24 00:00:00.000000,Jamaica,Cuba,3,0,Friendly,Montego Bay,Jamaica,0,50,589,116,290,-66,299,W,0,1,0
2012-02-24 00:00:00.000000,Japan,Iceland,3,1,Friendly,Osaka,Japan,0,30,762,103,330,-73,432,W,0,1,0
2012-02-24 00:00:00.000000,Nicaragua,Puerto Rico,1,0,Friendly,Managua,Nicaragua,0,144,189,113,301,31,-112,W,0,1,0
2012-02-24 00:00:00.000000,Singapore,Azerbaijan,2,2,Friendly,Dubai,United Arab Emirates,1,148,155,109,306,39,-151,D,1,0,0
2012-02-24 00:00:00.000000,Thailand,Maldives,3,0,Friendly,Chiang Mai,Thailand,0,130,245,175,98,-45,147,W,0,1,0
2012-02-24 00:00:00.000000,United Arab Emirates,Palestine,3,0,Friendly,Abu Dhabi,United Arab Emirates,0,132,243,162,128,-30,115,W,0,1,0
2012-02-25 00:00:00.000000,Korea Republic,Uzbekistan,4,2,Friendly,Jeonju,Korea Republic,0,34,714,77,455,-43,259,W,0,1,0
2012-02-26 00:00:00.000000,Nicaragua,Puerto Rico,4,1,Friendly,Managua,Nicaragua,0,144,189,113,301,31,-112,W,0,1,0
2012-02-27 00:00:00.000000,Egypt,Kenya,5,0,Friendly,Doha,Qatar,1,61,545,123,267,-62,278,W,0,0,0
2012-02-27 00:00:00.000000,India,Azerbaijan,0,3,Friendly,Dubai,United Arab Emirates,1,154,141,109,306,45,-165,L,2,0,0
2012-02-28 00:00:00.000000,Armenia,Serbia,0,2,Friendly,Limassol,Cyprus,1,41,639,25,791,16,-152,L,2,0,0
2012-02-29 00:00:00.000000,Antigua and Barbuda,Trinidad and Tobago,0,4,Friendly,St. John's,Antigua and Barbuda,0,90,405,85,416,5,-11,L,2,1,0
2012-02-29 00:00:00.000000,Armenia,Canada,3,1,Friendly,Limassol,Cyprus,1,41,639,71,469,-30,170,W,0,0,0
2012-02-29 00:00:00.000000,Australia,Saudi Arabia,4,2,FIFA World Cup qualification,Melbourne,Australia,0,22,832,89,407,-67,425,W,0,1,0
2012-02-29 00:00:00.000000,Austria,Finland,3,1,Friendly,Klagenfurt,Austria,0,71,469,79,439,-8,30,W,0,1,0
2012-02-29 00:00:00.000000,Bahrain,Indonesia,10,0,FIFA World Cup qualification,Riffa,Bahrain,0,97,366,146,161,-49,205,W,0,1,0
2012-02-29 00:00:00.000000,Bolivia,Cuba,1,0,Friendly,Cochabamba,Bolivia,0,107,309,116,290,-9,19,W,0,1,0
2012-02-29 00:00:00.000000,Burundi,Zimbabwe,2,1,African Cup of Nations qualification,Bujumbura,Burundi,0,143,199,99,348,44,-149,W,0,1,0
2012-02-29 00:00:00.000000,Chad,Malawi,3,2,African Cup of Nations qualification,N'Djamena,Chad,0,141,207,98,362,43,-155,W,0,1,0
2012-02-29 00:00:00.000000,Chile,Ghana,1,1,Friendly,Chester,USA,1,12,996,23,819,-11,177,D,1,0,0
2012-02-29 00:00:00.000000,Congo,Uganda,3,1,African Cup of Nations qualification,Brazzaville,Congo,0,130,245,87,411,43,-166,W,0,1,0
2012-02-29 00:00:00.000000,Croatia,Sweden,1,3,Friendly,Zagreb,Croatia,0,9,1101,18,924,-9,177,L,2,1,0
2012-02-29 00:00:00.000000,Cyprus,Serbia,0,0,Friendly,Larnaca,Cyprus,0,127,252,25,791,102,-539,D,1,1,0
2012-02-29 00:00:00.000000,Denmark,Russia,0,2,Friendly,Copenhagen,Denmark,0,10,1090,13,989,-3,101,L,2,1,0
2012-02-29 00:00:00.000000,Ecuador,Honduras,2,0,Friendly,Guayaquil,Ecuador,0,40,644,59,549,-19,95,W,0,1,0
2012-02-29 00:00:00.000000,Egypt,Niger,1,0,Friendly,Doha,Qatar,1,61,545,111,302,-50,243,W,0,0,0
2012-02-29 00:00:00.000000,El Salvador,Estonia,0,2,Friendly,Los Angeles,USA,1,54,576,54,576,0,0,L,2,0,0
2012-02-29 00:00:00.000000,England,Netherlands,2,3,Friendly,London,England,0,5,1179,3,1359,2,-180,L,2,1,0
2012-02-29 00:00:00.000000,Ethiopia,Benin,0,0,African Cup of Nations qualification,Addis Ababa,Ethiopia,0,137,230,136,237,1,-7,D,1,1,0
2012-02-29 00:00:00.000000,Gambia,Algeria,1,2,African Cup of Nations qualification,Bakau,Gambia,0,115,292,36,684,79,-392,L,2,1,0
2012-02-29 00:00:00.000000,Georgia,Albania,2,1,Friendly,Tbilisi,Georgia,0,81,436,78,452,3,-16,W,0,1,0
2012-02-29 00:00:00.000000,Germany,France,1,2,Friendly,Bremen,Germany,0,2,1369,17,930,-15,439,L,2,1,0
2012-02-29 00:00:00.000000,Greece,Belgium,1,1,Friendly,Heraklion,Greece,0,14,979,39,663,-25,316,D,1,1,0
2012-02-29 00:00:00.000000,Guinea-Bissau,Cameroon,0,1,African Cup of Nations qualification,Bissau,Guinea-Bissau,0,166,116,66,502,100,-386,L,2,1,0
2012-02-29 00:00:00.000000,Guyana,Guatemala,0,2,Friendly,Providence,Guyana,0,92,388,84,422,8,-34,L,2,1,0
2012-02-29 00:00:00.000000,Hungary,Bulgaria,1,1,Friendly,Győr,Hungary,0,37,678,88,408,-51,270,D,1,1,0
2012-02-29 00:00:00.000000,Iran,Qatar,2,2,FIFA World Cup qualification,Teheran,Iran,0,47,606,96,372,-49,234,D,1,1,0
2012-02-29 00:00:00.000000,Iraq,Singapore,7,1,FIFA World Cup qualification,Doha,Qatar,1,79,439,148,155,-69,284,W,0,0,0
2012-02-29 00:00:00.000000,Israel,Ukraine,2,3,Friendly,Petah Tikva,Israel,0,35,708,59,549,-24,159,L,2,1,0
2012-02-29 00:00:00.000000,Italy,USA,0,1,Friendly,Genoa,Italy,0,8,1115,31,750,-23,365,L,2,1,0
2012-02-29 00:00:00.000000,Japan,Uzbekistan,0,1,FIFA World Cup qualification,Toyota,Japan,0,30,762,77,455,-47,307,L,2,1,0
2012-02-29 00:00:00.000000,Kenya,Togo,2,1,African Cup of Nations qualification,Nairobi,Kenya,0,123,267,94,380,29,-113,W,0,1,0
2012-02-29 00:00:00.000000,Korea Republic,Kuwait,2,0,FIFA World Cup qualification,Seoul,Korea Republic,0,34,714,91,399,-57,315,W,0,1,0
2012-02-29 00:00:00.000000,Latvia,Kazakhstan,0,0,Friendly,Antalya,Turkey,1,74,463,138,225,-64,238,D,1,0,0
2012-02-29 00:00:00.000000,Liberia,Namibia,1,0,African Cup of Nations qualification,Monrovia,Liberia,0,125,258,120,271,5,-13,W,0,1,0
2012-02-29 00:00:00.000000,Malta,Liechtenstein,2,1,Friendly,Attard,Malta,0,159,133,124,263,35,-130,W,0,1,0
2012-02-29 00:00:00.000000,Mexico,Colombia,0,2,Friendly,Miami Gardens,USA,1,21,882,32,746,-11,136,L,2,0,0
2012-02-29 00:00:00.000000,Moldova,Belarus,0,0,Friendly,Antalya,Turkey,1,142,205,67,494,75,-289,D,1,0,0
2012-02-29 00:00:00.000000,Montenegro,Iceland,2,1,Friendly,Podgorica,Montenegro,0,51,585,103,330,-52,255,W,0,1,0
2012-02-29 00:00:00.000000,Morocco,Burkina Faso,2,0,Friendly,Marrakech,Morocco,0,62,543,75,462,-13,81,W,0,1,0
2012-02-29 00:00:00.000000,New Zealand,Jamaica,2,3,Friendly,Auckland,New Zealand,0,120,271,50,589,70,-318,L,2,1,0
2012-02-29 00:00:00.000000,Northern Ireland,Norway,0,3,Friendly,Belfast,Northern Ireland,0,86,412,24,793,62,-381,L,2,1,0
2012-02-29 00:00:00.000000,Oman,Thailand,2,0,FIFA World Cup qualification,Muscat,Oman,0,95,377,130,245,-35,132,W,0,1,0
2012-02-29 00:00:00.000000,Palestine,Azerbaijan,2,0,Friendly,Dubai,United Arab Emirates,1,162,128,109,306,53,-178,W,0,0,0
2012-02-29 00:00:00.000000,Paraguay,Panama,1,0,Friendly,Asunción,Paraguay,0,27,781,49,594,-22,187,W,0,1,0
2012-02-29 00:00:00.000000,Philippines,Malaysia,1,1,Friendly,Manila,Philippines,0,156,139,150,153,6,-14,D,1,1,0
2012-02-29 00:00:00.000000,Poland,Portugal,0,0,Friendly,Warsaw,Poland,0,70,470,6,1155,64,-685,D,1,1,0
2012-02-29 00:00:00.000000,Romania,Uruguay,1,1,Friendly,Bucharest,Romania,0,52,583,4,1317,48,-734,D,1,1,0
2012-02-29 00:00:00.000000,Rwanda,Nigeria,0,0,African Cup of Nations qualification,Kigali,Rwanda,0,108,308,56,573,52,-265,D,1,1,0
2012-02-29 00:00:00.000000,Seychelles,Congo DR,0,4,African Cup of Nations qualification,Victoria,Seychelles,0,189,53,119,280,70,-227,L,2,1,0
2012-02-29 00:00:00.000000,Slovenia,Scotland,1,1,Friendly,Koper,Slovenia,0,27,781,48,602,-21,179,D,1,1,0
2012-02-29 00:00:00.000000,South Africa,Senegal,0,0,Friendly,Durban,South Africa,0,58,559,68,490,-10,69,D,1,1,0
2012-02-29 00:00:00.000000,Spain,Venezuela,5,0,Friendly,Málaga,Spain,0,1,1566,46,615,-45,951,W,0,1,0
2012-02-29 00:00:00.000000,Switzerland,Argentina,1,3,Friendly,Berne,Switzerland,0,16,950,11,1081,5,-131,L,2,1,0
2012-02-29 00:00:00.000000,Tajikistan,Korea DPR,1,1,FIFA World Cup qualification,Xuçand,Tajikistan,0,140,218,106,314,34,-96,D,1,1,0
2012-02-29 00:00:00.000000,Tanzania,Mozambique,1,1,African Cup of Nations qualification,Dar es Salaam,Tanzania,0,139,224,102,332,37,-108,D,1,1,0
2012-02-29 00:00:00.000000,Tunisia,Peru,1,1,Friendly,Tunis,Tunisia,0,56,573,33,743,23,-170,D,1,1,0
2012-02-29 00:00:00.000000,Turkey,Slovakia,1,2,Friendly,Bursa,Turkey,0,25,791,38,675,-13,116,L,2,1,0
2012-02-29 00:00:00.000000,United Arab Emirates,Lebanon,4,2,FIFA World Cup qualification,Abu Dhabi,United Arab Emirates,0,132,243,114,299,18,-56,W,0,1,0
2012-02-29 00:00:00.000000,Wales,Costa Rica,0,1,Friendly,Cardiff,Wales,0,42,635,63,539,-21,96,L,2,1,0
2012-03-02 00:00:00.000000,Egypt,Congo DR,0,0,Friendly,Doha,Qatar,1,61,545,119,280,-58,265,D,1,0,0
2012-03-03 00:00:00.000000,St. Kitts and Nevis,Antigua and Barbuda,1,0,Friendly,Basseterre,St. Kitts and Nevis,0,117,287,90,405,27,-118,W,0,1,0
2012-03-08 00:00:00.000000,Nepal,Palestine,0,2,AFC Challenge Cup,Kathmandu,Nepal,0,153,144,160,131,-7,13,L,2,1,0
2012-03-08 00:00:00.000000,Turkmenistan,Maldives,3,1,AFC Challenge Cup,Kathmandu,Nepal,1,166,114,174,95,-8,19,W,0,0,0
2012-03-09 00:00:00.000000,India,Tajikistan,0,2,AFC Challenge Cup,Kathmandu,Nepal,1,158,132,145,210,13,-78,L,2,0,0
2012-03-09 00:00:00.000000,Korea DPR,Philippines,2,0,AFC Challenge Cup,Kathmandu,Nepal,1,111,299,156,136,-45,163,W,0,0,0
2012-03-10 00:00:00.000000,Nepal,Maldives,0,1,AFC Challenge Cup,Kathmandu,Nepal,0,153,144,174,95,-21,49,L,2,1,0
2012-03-10 00:00:00.000000,Palestine,Turkmenistan,0,0,AFC Challenge Cup,Kathmandu,Nepal,1,160,131,166,114,-6,17,D,1,0,0
2012-03-11 00:00:00.000000,Philippines,India,2,0,AFC Challenge Cup,Kathmandu,Nepal,1,156,136,158,132,-2,4,W,0,0,0
2012-03-11 00:00:00.000000,Tajikistan,Korea DPR,0,2,AFC Challenge Cup,Kathmandu,Nepal,1,145,210,111,299,34,-89,L,2,0,0
2012-03-12 00:00:00.000000,Maldives,Palestine,0,2,AFC Challenge Cup,Kathmandu,Nepal,1,174,95,160,131,14,-36,L,2,0,0
2012-03-12 00:00:00.000000,Nepal,Turkmenistan,0,3,AFC Challenge Cup,Kathmandu,Nepal,0,153,144,166,114,-13,30,L,2,1,0
2012-03-13 00:00:00.000000,Korea DPR,India,4,0,AFC Challenge Cup,Kathmandu,Nepal,1,111,299,158,132,-47,167,W,0,0,0
2012-03-13 00:00:00.000000,Tajikistan,Philippines,1,2,AFC Challenge Cup,Kathmandu,Nepal,1,145,210,156,136,-11,74,L,2,0,0
2012-03-16 00:00:00.000000,Korea DPR,Palestine,2,0,AFC Challenge Cup,Kathmandu,Nepal,1,111,299,160,131,-49,168,W,0,0,0
2012-03-16 00:00:00.000000,Turkmenistan,Philippines,2,1,AFC Challenge Cup,Kathmandu,Nepal,1,166,114,156,136,10,-22,W,0,0,0
2012-03-19 00:00:00.000000,Philippines,Palestine,4,3,AFC Challenge Cup,Kathmandu,Nepal,1,156,136,160,131,-4,5,W,0,0,0
2012-03-19 00:00:00.000000,Turkmenistan,Korea DPR,1,2,AFC Challenge Cup,Kathmandu,Nepal,1,166,114,111,299,55,-185,L,2,0,0
2012-03-21 00:00:00.000000,Chile,Peru,3,1,Copa del Pacífico,Arica,Chile,0,14,950,34,720,-20,230,W,0,1,0
2012-03-21 00:00:00.000000,Jamaica,Costa Rica,0,0,Friendly,Kingston,Jamaica,0,54,571,59,550,-5,21,D,1,1,0
2012-03-29 00:00:00.000000,Egypt,Uganda,2,1,Friendly,Omdurman,Sudan,1,64,530,88,388,-24,142,W,0,0,0
2012-03-31 00:00:00.000000,Egypt,Chad,4,0,Friendly,Omdurman,Sudan,1,64,530,112,293,-48,237,W,0,0,0
2012-04-11 00:00:00.000000,Costa Rica,Honduras,1,1,Friendly,San José,Costa Rica,0,59,557,61,550,-2,7,D,1,1,0
2012-04-11 00:00:00.000000,Peru,Chile,0,3,Copa del Pacífico,Tacna,Peru,0,34,719,13,967,21,-248,L,2,1,0
2012-04-12 00:00:00.000000,Egypt,Nigeria,3,2,Friendly,Dubai,United Arab Emirates,1,55,566,60,554,-5,12,W,0,0,0
2012-04-15 00:00:00.000000,Egypt,Mauritania,3,0,Friendly,Dubai,United Arab Emirates,1,55,566,202,4,-147,562,W,0,0,0
2012-04-17 00:00:00.000000,Egypt,Iraq,0,0,Friendly,Dubai,United Arab Emirates,1,55,566,70,488,-15,78,D,1,0,0
2012-04-18 00:00:00.000000,Iran,Mauritania,2,0,Friendly,Teheran,Iran,0,51,578,202,4,-151,574,W,0,1,0
2012-04-25 00:00:00.000000,Guatemala,Paraguay,0,1,Friendly,Guatemala,Guatemala,0,82,419,25,803,57,-384,L,2,1,0
2012-04-28 00:00:00.000000,Malaysia,Sri Lanka,6,0,Friendly,Kuala Lumpur,Malaysia,0,156,148,181,82,-25,66,W,0,1,0
2012-05-02 00:00:00.000000,Iran,Mozambique,3,0,Friendly,Karaj,Iran,0,51,578,106,322,-55,256,W,0,1,0
2012-05-11 00:00:00.000000,Lebanon,Egypt,1,4,Friendly,Tripoli,Lebanon,0,129,260,57,559,72,-299,L,2,1,0
2012-05-16 00:00:00.000000,Angola,Zambia,0,0,Friendly,Luanda,Angola,0,78,440,40,640,38,-200,D,1,1,0
2012-05-18 00:00:00.000000,Jamaica,Guyana,1,0,Friendly,Montego Bay,Jamaica,0,51,576,99,341,-48,235,W,0,1,0
2012-05-18 00:00:00.000000,Lebanon,Jordan,1,2,Friendly,Sidon,Lebanon,0,129,260,81,420,48,-160,L,2,1,0
2012-05-20 00:00:00.000000,Egypt,Cameroon,2,1,Friendly,Omdurman,Sudan,1,57,559,64,526,-7,33,W,0,0,0
2012-05-20 00:00:00.000000,Panama,Guyana,2,0,Friendly,Panama City,Panama,0,52,575,99,341,-47,234,W,0,1,0
2012-05-22 00:00:00.000000,Albania,Qatar,2,1,Friendly,Madrid,Spain,1,84,384,84,384,0,0,W,0,0,0
2012-05-22 00:00:00.000000,Egypt,Togo,3,0,Friendly,Omdurman,Sudan,1,57,559,88,374,-31,185,W,0,0,0
2012-05-22 00:00:00.000000,Latvia,Poland,0,1,Friendly,Klagenfurt,Austria,1,74,465,65,514,9,-49,L,2,0,0
2012-05-23 00:00:00.000000,Botswana,Lesotho,3,0,Friendly,Gaborone,Botswana,0,106,321,163,131,-57,190,W,0,1,0
2012-05-23 00:00:00.000000,El Salvador,New Zealand,2,2,Friendly,Houston,USA,1,49,591,130,256,-81,335,D,1,0,0
2012-05-23 00:00:00.000000,Iraq,Sierra Leone,1,0,Friendly,Istanbul,Turkey,1,72,476,61,542,11,-66,W,0,0,0
2012-05-23 00:00:00.000000,Japan,Azerbaijan,2,0,Friendly,Shizuoka,Japan,0,30,753,109,305,-79,448,W,0,1,0
2012-05-23 00:00:00.000000,Libya,Rwanda,2,0,Friendly,Tunis,Tunisia,1,46,602,105,327,-59,275,W,0,0,0
2012-05-23 00:00:00.000000,Peru,Nigeria,1,0,Friendly,Lima,Peru,0,36,691,63,537,-27,154,W,0,1,0
2012-05-23 00:00:00.000000,Venezuela,Moldova,4,0,Friendly,Puerto Ordaz,Venezuela,0,43,613,142,222,-99,391,W,0,1,0
2012-05-24 00:00:00.000000,Georgia,Turkey,1,3,Friendly,Salzburg,Austria,1,95,360,33,720,62,-360,L,2,0,0
2012-05-25 00:00:00.000000,Belgium,Montenegro,2,2,Friendly,Brussels,Belgium,0,44,604,55,569,-11,35,D,1,1,0
2012-05-25 00:00:00.000000,Costa Rica,Guatemala,3,2,Friendly,San José,Costa Rica,0,59,549,83,396,-24,153,W,0,1,0
2012-05-25 00:00:00.000000,Croatia,Estonia,3,1,Friendly,Rijeka,Croatia,0,8,1114,54,574,-46,540,W,0,1,0
2012-05-25 00:00:00.000000,Morocco,Senegal,0,1,Friendly,Marrakech,Morocco,0,60,548,77,448,-17,100,L,2,1,0
2012-05-25 00:00:00.000000,Russia,Uruguay,1,1,Friendly,Moscow,Russia,0,11,1049,3,1309,8,-260,D,1,1,0
2012-05-26 00:00:00.000000,Algeria,Niger,3,0,Friendly,Blida,Algeria,0,38,667,122,274,-84,393,W,0,1,0
2012-05-26 00:00:00.000000,Burkina Faso,Benin,2,2,Friendly,Ouagadougou,Burkina Faso,0,80,426,124,269,-44,157,D,1,1,0
2012-05-26 00:00:00.000000,Czech Republic,Israel,2,1,Friendly,Graz,Austria,1,26,798,58,558,-32,240,W,0,0,0
2012-05-26 00:00:00.000000,Denmark,Brazil,1,3,Friendly,Hamburg,Germany,1,10,1069,6,1165,4,-96,L,2,0,0
2012-05-26 00:00:00.000000,El Salvador,Moldova,2,0,Friendly,Dallas,USA,1,49,591,142,222,-93,369,W,0,0,0
2012-05-26 00:00:00.000000,Finland,Turkey,3,2,Friendly,Salzburg,Austria,1,79,430,33,720,46,-290,W,0,0,0
2012-05-26 00:00:00.000000,Greece,Slovenia,1,1,Friendly,Kufstein,Austria,1,14,961,28,781,-14,180,D,1,0,0
2012-05-26 00:00:00.000000,Guinea,Cameroon,1,2,Friendly,Amanvillers,France,1,68,499,64,526,4,-27,L,2,0,0
2012-05-26 00:00:00.000000,Honduras,New Zealand,0,1,Friendly,Dallas,USA,1,62,540,130,256,-68,284,L,2,0,0
2012-05-26 00:00:00.000000,Jordan,Sierra Leone,4,0,Friendly,Amman,Jordan,0,81,420,61,542,20,-122,W,0,1,0
2012-05-26 00:00:00.000000,Mozambique,Namibia,0,0,Friendly,Würzburg,Germany,1,110,300,120,281,-10,19,D,1,0,0
2012-05-26 00:00:00.000000,Netherlands,Bulgaria,1,2,Friendly,Amsterdam,Netherlands,0,4,1207,96,354,-92,853,L,2,1,0
2012-05-26 00:00:00.000000,Norway,England,0,1,Friendly,Oslo,Norway,0,24,805,7,1132,17,-327,L,2,1,0
2012-05-26 00:00:00.000000,Poland,Slovakia,1,0,Friendly,Klagenfurt,Austria,1,65,514,34,716,31,-202,W,0,0,0
2012-05-26 00:00:00.000000,Spain,Serbia,2,0,Friendly,St. Gallen,Switzerland,1,1,1442,32,725,-31,717,W,0,0,0
2012-05-26 00:00:00.000000,Switzerland,Germany,5,3,Friendly,Basel,Switzerland,0,18,891,2,1345,16,-454,W,0,1,0
2012-05-26 00:00:00.000000,Tanzania,Malawi,0,0,Friendly,Dar es Salaam,Tanzania,0,145,217,102,332,43,-115,D,1,1,0
2012-05-26 00:00:00.000000,USA,Scotland,5,1,Friendly,Jacksonville,USA,0,29,779,48,596,-19,183,W,0,1,0
2012-05-27 00:00:00.000000,Albania,Iran,1,0,Friendly,Istanbul,Turkey,1,84,384,52,575,32,-191,W,0,0,0
2012-05-27 00:00:00.000000,Chad,Libya,0,1,Friendly,Tunis,Tunisia,1,115,289,46,602,69,-313,L,2,0,0
2012-05-27 00:00:00.000000,France,Iceland,3,2,Friendly,Valenciennes,France,0,16,938,131,255,-115,683,W,0,1,0
2012-05-27 00:00:00.000000,Jamaica,Panama,0,1,Friendly,Kingston,Jamaica,0,51,576,52,575,-1,1,L,2,1,0
2012-05-27 00:00:00.000000,Mexico,Wales,2,0,Friendly,East Rutherford,USA,1,20,867,41,635,-21,232,W,0,0,0
2012-05-27 00:00:00.000000,Oman,Lebanon,1,1,Friendly,Muscat,Oman,0,92,363,129,260,-37,103,D,1,1,0
2012-05-27 00:00:00.000000,Tunisia,Rwanda,5,1,Friendly,Monastir,Tunisia,0,56,563,105,327,-49,236,W,0,1,0
2012-05-28 00:00:00.000000,Iraq,Botswana,1,1,Friendly,Istanbul,Turkey,1,72,476,106,321,-34,155,D,1,0,0
2012-05-28 00:00:00.000000,Qatar,Palestine,0,0,Friendly,Doha,Qatar,0,84,384,154,151,-70,233,D,1,1,0
2012-05-28 00:00:00.000000,Ukraine,Estonia,4,0,Friendly,Kufstein,Austria,1,50,589,54,574,-4,15,W,0,0,0
2012-05-29 00:00:00.000000,Bulgaria,Turkey,0,2,Friendly,Salzburg,Austria,1,96,354,33,720,63,-366,L,2,0,0
2012-05-29 00:00:00.000000,Lithuania,Russia,0,0,Friendly,Nyon,Switzerland,1,89,373,11,1049,78,-676,D,1,0,0
2012-05-30 00:00:00.000000,Azerbaijan,Andorra,0,0,Friendly,Kelsterbach,Germany,1,109,305,205,0,-96,305,D,1,0,0
2012-05-30 00:00:00.000000,Chad,Rwanda,1,1,Friendly,Port el-Kantaoui,Tunisia,1,115,289,105,327,10,-38,D,1,0,0
2012-05-30 00:00:00.000000,Netherlands,Slovakia,2,0,Friendly,Rotterdam,Netherlands,0,4,1207,34,716,-30,491,W,0,1,0
2012-05-30 00:00:00.000000,Spain,Korea Republic,4,1,Friendly,Berne,Switzerland,1,1,1442,31,746,-30,696,W,0,0,0
2012-05-30 00:00:00.000000,Sweden,Iceland,3,2,Friendly,Gothenburg,Sweden,0,17,931,131,255,-114,676,W,0,1,0
2012-05-30 00:00:00.000000,Switzerland,Romania,0,1,Friendly,Lucerne,Switzerland,0,18,891,45,603,-27,288,L,2,1,0
2012-05-30 00:00:00.000000,USA,Brazil,1,4,Friendly,Washington,USA,0,29,779,6,1165,23,-386,L,2,1,0
2012-05-31 00:00:00.000000,Armenia,Greece,0,1,Friendly,Kufstein,Austria,1,47,598,14,961,33,-363,L,2,0,0
2012-05-31 00:00:00.000000,France,Serbia,2,0,Friendly,Reims,France,0,16,938,32,725,-16,213,W,0,1,0
2012-05-31 00:00:00.000000,Germany,Israel,2,0,Friendly,Leipzig,Germany,0,2,1345,58,558,-56,787,W,0,1,0
2012-06-01 00:00:00.000000,Austria,Ukraine,3,2,Friendly,Innsbruck,Austria,0,73,475,50,589,23,-114,W,0,1,0
2012-06-01 00:00:00.000000,Czech Republic,Hungary,1,2,Friendly,Prague,Czech Republic,0,26,798,35,692,-9,106,L,2,1,0
2012-06-01 00:00:00.000000,Egypt,Mozambique,2,0,FIFA World Cup qualification,Alexandria,Egypt,0,57,559,110,300,-53,259,W,0,1,0
2012-06-01 00:00:00.000000,Estonia,Finland,1,2,Baltic Cup,Tartu,Estonia,0,54,574,79,430,-25,144,L,2,1,0
2012-06-01 00:00:00.000000,Ghana,Lesotho,7,0,FIFA World Cup qualification,Kumasi,Ghana,0,22,816,163,131,-141,685,W,0,1,0
2012-06-01 00:00:00.000000,Guatemala,Costa Rica,1,0,Friendly,Guatemala,Guatemala,0,83,396,59,549,24,-153,W,0,1,0
2012-06-01 00:00:00.000000,Hong Kong,Singapore,1,0,Friendly,So Kon Po,Hong Kong,0,161,132,158,145,3,-13,W,0,1,0
2012-06-01 00:00:00.000000,Italy,Russia,0,3,Friendly,Zürich,Switzerland,1,12,1041,11,1049,1,-8,L,2,0,0
2012-06-01 00:00:00.000000,Latvia,Lithuania,5,0,Baltic Cup,Võru,Estonia,1,74,465,89,373,-15,92,W,0,0,0
2012-06-01 00:00:00.000000,Malaysia,Philippines,0,0,Friendly,Shah Alam,Malaysia,0,153,153,148,172,5,-19,D,1,1,0
2012-06-01 00:00:00.000000,Panama,Jamaica,2,1,Friendly,Panama City,Panama,0,52,575,51,576,1,-1,W,0,1,0
2012-06-01 00:00:00.000000,Puerto Rico,Nicaragua,3,1,Friendly,Bayamón,Puerto Rico,0,138,236,146,211,-8,25,W,0,1,0
2012-06-01 00:00:00.000000,Samoa,Tahiti,1,10,Oceania Nations Cup,Honiara,Solomon Islands,1,156,149,179,86,-23,63,L,2,0,0
2012-06-01 00:00:00.000000,Vanuatu,New Caledonia,2,5,Oceania Nations Cup,Honiara,Solomon Islands,1,172,103,155,150,17,-47,L,2,0,0
2012-06-02 00:00:00.000000,Algeria,Rwanda,4,0,FIFA World Cup qualification,Blida,Algeria,0,38,667,105,327,-67,340,W,0,1,0
2012-06-02 00:00:00.000000,Argentina,Ecuador,4,0,FIFA World Cup qualification,Buenos Aires,Argentina,0,9,1076,37,679,-28,397,W,0,1,0
2012-06-02 00:00:00.000000,Bolivia,Chile,0,2,FIFA World Cup qualification,La Paz,Bolivia,0,108,308,13,968,95,-660,L,2,1,0
2012-06-02 00:00:00.000000,Burkina Faso,Congo,0,3,FIFA World Cup qualification,Ouagadougou,Burkina Faso,0,80,426,91,366,-11,60,L,2,1,0
2012-06-02 00:00:00.000000,Cameroon,Congo DR,1,0,FIFA World Cup qualification,Yaoundé,Cameroon,0,64,526,124,269,-60,257,W,0,1,0
2012-06-02 00:00:00.000000,Central African Republic,Botswana,2,0,FIFA World Cup qualification,Bangui,Central African Republic,0,123,271,106,321,17,-50,W,0,1,0
2012-06-02 00:00:00.000000,Denmark,Australia,2,0,Friendly,Copenhagen,Denmark,0,10,1069,21,862,-11,207,W,0,1,0
2012-06-02 00:00:00.000000,El Salvador,Honduras,0,3,Friendly,Washington,USA,1,49,591,62,540,-13,51,L,2,0,0
2012-06-02 00:00:00.000000,England,Belgium,1,0,Friendly,London,England,0,7,1132,44,604,-37,528,W,0,1,0
2012-06-02 00:00:00.000000,Fiji,New Zealand,0,1,Oceania Nations Cup,Honiara,Solomon Islands,1,160,133,130,256,30,-123,L,2,0,0
2012-06-02 00:00:00.000000,Gambia,Morocco,1,1,FIFA World Cup qualification,Bakau,Gambia,0,113,292,60,548,53,-256,D,1,1,0
2012-06-02 00:00:00.000000,Kenya,Malawi,0,0,FIFA World Cup qualification,Nairobi,Kenya,0,117,285,102,332,15,-47,D,1,1,0
2012-06-02 00:00:00.000000,Luxembourg,Malta,0,2,Friendly,Luxembourg,Luxembourg,0,119,283,150,161,-31,122,L,2,1,0
2012-06-02 00:00:00.000000,Netherlands,Northern Ireland,6,0,Friendly,Amsterdam,Netherlands,0,4,1207,100,338,-96,869,W,0,1,0
2012-06-02 00:00:00.000000,Norway,Croatia,1,1,Friendly,Oslo,Norway,0,24,805,8,1114,16,-309,D,1,1,0
2012-06-02 00:00:00.000000,Poland,Andorra,4,0,Friendly,Warsaw,Poland,0,65,514,205,0,-140,514,W,0,1,0
2012-06-02 00:00:00.000000,Portugal,Turkey,1,3,Friendly,Lisbon,Portugal,0,5,1190,33,720,-28,470,L,2,1,0
2012-06-02 00:00:00.000000,Senegal,Liberia,3,1,FIFA World Cup qualification,Dakar,Senegal,0,77,448,112,296,-35,152,W,0,1,0
2012-06-02 00:00:00.000000,Solomon Islands,Papua New Guinea,1,0,Oceania Nations Cup,Honiara,Solomon Islands,0,183,75,193,34,-10,41,W,0,1,0
2012-06-02 00:00:00.000000,Sudan,Zambia,0,3,FIFA World Cup qualification,Khartoum,Sudan,0,113,292,40,640,73,-348,L,2,1,0
2012-06-02 00:00:00.000000,Tunisia,Equatorial Guinea,3,1,FIFA World Cup qualification,Monastir,Tunisia,0,56,563,103,330,-47,233,W,0,1,0
2012-06-02 00:00:00.000000,Uruguay,Venezuela,1,1,FIFA World Cup qualification,Montevideo,Uruguay,0,3,1309,43,613,-40,696,D,1,1,0
2012-06-03 00:00:00.000000,Angola,Uganda,1,1,FIFA World Cup qualification,Luanda,Angola,0,78,440,93,362,-15,78,D,1,1,0
2012-06-03 00:00:00.000000,Benin,Mali,1,0,FIFA World Cup qualification,Cotonou,Benin,0,124,269,39,656,85,-387,W,0,1,0
2012-06-03 00:00:00.000000,Canada,USA,0,0,Friendly,Toronto,Canada,0,75,450,29,779,46,-329,D,1,1,0
2012-06-03 00:00:00.000000,Estonia,Lithuania,1,0,Baltic Cup,Tartu,Estonia,0,54,574,89,373,-35,201,W,0,1,0
2012-06-03 00:00:00.000000,Finland,Latvia,1,1,Baltic Cup,Võru,Estonia,1,79,430,74,465,5,-35,D,1,0,0
2012-06-03 00:00:00.000000,Japan,Oman,3,0,FIFA World Cup qualification,Saitama,Japan,0,30,753,92,363,-62,390,W,0,1,0
2012-06-03 00:00:00.000000,Jordan,Iraq,1,1,FIFA World Cup qualification,Amman,Jordan,0,81,420,72,476,9,-56,D,1,1,0
2012-06-03 00:00:00.000000,Lebanon,Qatar,0,1,FIFA World Cup qualification,Beirut,Lebanon,0,129,260,84,384,45,-124,L,2,1,0
2012-06-03 00:00:00.000000,Mexico,Brazil,2,0,Friendly,Arlington,USA,1,20,867,6,1165,14,-298,W,0,0,0
2012-06-03 00:00:00.000000,Niger,Gabon,3,0,FIFA World Cup qualification,Niamey,Niger,0,122,274,42,621,80,-347,W,0,1,0
2012-06-03 00:00:00.000000,Nigeria,Namibia,1,0,FIFA World Cup qualification,Calabar,Nigeria,0,63,537,120,281,-57,256,W,0,1,0
2012-06-03 00:00:00.000000,Peru,Colombia,0,1,FIFA World Cup qualification,Lima,Peru,0,36,691,23,812,13,-121,L,2,1,0
2012-06-03 00:00:00.000000,Puerto Rico,Nicaragua,1,1,Friendly,Bayamón,Puerto Rico,0,138,236,146,211,-8,25,D,1,1,0
2012-06-03 00:00:00.000000,South Africa,Ethiopia,1,1,FIFA World Cup qualification,Rustenburg,South Africa,0,67,500,138,236,-71,264,D,1,1,0
2012-06-03 00:00:00.000000,Tahiti,New Caledonia,4,3,Oceania Nations Cup,Honiara,Solomon Islands,1,179,86,155,150,24,-64,W,0,0,0
2012-06-03 00:00:00.000000,Togo,Libya,1,1,FIFA World Cup qualification,Lomé,Togo,0,88,374,46,602,42,-228,D,1,1,0
2012-06-03 00:00:00.000000,Uzbekistan,Iran,0,1,FIFA World Cup qualification,Tashkent,Uzbekistan,0,70,493,52,575,18,-82,L,2,1,0
2012-06-03 00:00:00.000000,Vanuatu,Samoa,5,0,Oceania Nations Cup,Honiara,Solomon Islands,1,172,103,156,149,16,-46,W,0,0,0
2012-06-03 00:00:00.000000,Zimbabwe,Guinea,0,1,FIFA World Cup qualification,Harare,Zimbabwe,0,104,328,68,499,36,-171,L,2,1,0
2012-06-04 00:00:00.000000,Papua New Guinea,New Zealand,1,2,Oceania Nations Cup,Honiara,Solomon Islands,1,193,34,130,256,63,-222,L,2,0,0
2012-06-04 00:00:00.000000,Solomon Islands,Fiji,0,0,Oceania Nations Cup,Honiara,Solomon Islands,0,183,75,160,133,23,-58,D,1,1,0
2012-06-06 00:00:00.000000,Papua New Guinea,Fiji,1,1,Oceania Nations Cup,Honiara,Solomon Islands,1,193,34,161,133,32,-99,D,1,0,0
2012-06-06 00:00:00.000000,Solomon Islands,New Zealand,1,1,Oceania Nations Cup,Honiara,Solomon Islands,0,183,75,100,341,83,-266,D,1,1,0
2012-06-07 00:00:00.000000,Belarus,Lithuania,1,1,Friendly,Minsk,Belarus,0,69,497,88,380,-19,117,D,1,1,0
2012-06-08 00:00:00.000000,Bahrain,Kuwait,1,1,Friendly,6th of October City,Egypt,1,95,359,87,383,8,-24,D,1,0,0
2012-06-08 00:00:00.000000,Costa Rica,El Salvador,2,2,FIFA World Cup qualification,San José,Costa Rica,0,65,507,55,550,10,-43,D,1,1,0
2012-06-08 00:00:00.000000,Cuba,Canada,0,1,FIFA World Cup qualification,Havana,Cuba,0,145,197,77,457,68,-260,L,2,1,0
2012-06-08 00:00:00.000000,Honduras,Panama,0,2,FIFA World Cup qualification,San Pedro Sula,Honduras,0,55,550,46,591,9,-41,L,2,1,0
2012-06-08 00:00:00.000000,Jamaica,Guatemala,2,1,FIFA World Cup qualification,Kingston,Jamaica,0,60,520,85,412,-25,108,W,0,1,0
2012-06-08 00:00:00.000000,Japan,Jordan,6,0,FIFA World Cup qualification,Saitama,Japan,0,23,822,80,429,-57,393,W,0,1,0
2012-06-08 00:00:00.000000,Lebanon,Uzbekistan,1,1,FIFA World Cup qualification,Beirut,Lebanon,0,143,207,66,503,77,-296,D,1,1,0
2012-06-08 00:00:00.000000,Mexico,Guyana,3,1,FIFA World Cup qualification,Mexico City,Mexico,0,19,889,104,332,-85,557,W,0,1,0
2012-06-08 00:00:00.000000,New Zealand,New Caledonia,0,2,Oceania Nations Cup,Honiara,Solomon Islands,1,100,341,155,150,-55,191,L,2,0,0
2012-06-08 00:00:00.000000,Oman,Australia,0,0,FIFA World Cup qualification,Muscat,Oman,0,97,349,24,820,73,-471,D,1,1,0
2012-06-08 00:00:00.000000,Poland,Greece,1,1,UEFA Euro,Warsaw,Poland,0,62,518,15,953,47,-435,D,1,1,0
2012-06-08 00:00:00.000000,Qatar,Korea Republic,1,4,FIFA World Cup qualification,Doha,Qatar,0,91,372,35,719,56,-347,L,2,1,0
2012-06-08 00:00:00.000000,Russia,Czech Republic,4,1,UEFA Euro,Wrocław,Poland,1,13,975,27,771,-14,204,W,0,0,0
2012-06-08 00:00:00.000000,Singapore,Malaysia,2,2,Friendly,Singapore,Singapore,0,157,143,154,151,3,-8,D,1,1,0
2012-06-08 00:00:00.000000,Solomon Islands,Tahiti,0,1,Oceania Nations Cup,Honiara,Solomon Islands,0,183,75,179,86,4,-11,L,2,1,0
2012-06-08 00:00:00.000000,USA,Antigua and Barbuda,3,1,FIFA World Cup qualification,Tampa,USA,0,28,767,105,330,-77,437,W,0,1,0
2012-06-09 00:00:00.000000,Bolivia,Paraguay,3,1,FIFA World Cup qualification,La Paz,Bolivia,0,110,312,22,833,88,-521,W,0,1,0
2012-06-09 00:00:00.000000,Botswana,South Africa,1,1,FIFA World Cup qualification,Gaborone,Botswana,0,116,295,68,499,48,-204,D,1,1,0
2012-06-09 00:00:00.000000,Brazil,Argentina,3,4,Friendly,East Rutherford,USA,1,5,1155,7,1137,-2,18,L,2,0,0
2012-06-09 00:00:00.000000,Congo,Niger,1,0,FIFA World Cup qualification,Pointe-Noire,Congo,0,83,422,122,279,-39,143,W,0,1,0
2012-06-09 00:00:00.000000,Equatorial Guinea,Sierra Leone,2,2,FIFA World Cup qualification,Malabo,Equatorial Guinea,0,114,298,59,523,55,-225,D,1,1,0
2012-06-09 00:00:00.000000,Gabon,Burkina Faso,1,0,FIFA World Cup qualification,Libreville,Gabon,0,49,586,86,407,-37,179,W,0,1,0
2012-06-09 00:00:00.000000,Germany,Portugal,1,0,UEFA Euro,L'viv,Ukraine,1,3,1288,10,996,-7,292,W,0,0,0
2012-06-09 00:00:00.000000,Malawi,Nigeria,1,1,FIFA World Cup qualification,Blantyre,Malawi,0,107,324,60,520,47,-196,D,1,1,0
2012-06-09 00:00:00.000000,Namibia,Kenya,1,0,FIFA World Cup qualification,Windhoek,Namibia,0,134,246,111,303,23,-57,W,0,1,0
2012-06-09 00:00:00.000000,Netherlands,Denmark,0,1,UEFA Euro,Kharkiv,Ukraine,1,4,1234,9,1019,-5,215,L,2,0,0
2012-06-09 00:00:00.000000,Uganda,Senegal,1,1,FIFA World Cup qualification,Kampala,Uganda,0,94,363,63,517,31,-154,D,1,1,0
2012-06-09 00:00:00.000000,Venezuela,Chile,0,2,FIFA World Cup qualification,Puerto la Cruz,Venezuela,0,40,614,11,994,29,-380,L,2,1,0
2012-06-09 00:00:00.000000,Zambia,Ghana,1,0,FIFA World Cup qualification,Ndola,Zambia,0,43,601,25,818,18,-217,W,0,1,0
2012-06-10 00:00:00.000000,Congo DR,Togo,2,0,FIFA World Cup qualification,Kinshasa,Congo DR,0,127,257,98,343,29,-86,W,0,1,0
2012-06-10 00:00:00.000000,Ecuador,Colombia,1,0,FIFA World Cup qualification,Quito,Ecuador,0,36,693,20,880,16,-187,W,0,1,0
2012-06-10 00:00:00.000000,Ethiopia,Central African Republic,2,0,FIFA World Cup qualification,Addis Ababa,Ethiopia,0,130,249,93,366,37,-117,W,0,1,0
2012-06-10 00:00:00.000000,Guinea,Egypt,2,3,FIFA World Cup qualification,Conakry,Guinea,0,67,502,48,588,19,-86,L,2,1,0
2012-06-10 00:00:00.000000,Hong Kong,Vietnam,1,2,Friendly,Kowloon,Hong Kong,0,158,142,98,343,60,-201,L,2,1,0
2012-06-10 00:00:00.000000,Lesotho,Sudan,0,0,FIFA World Cup qualification,Maseru,Lesotho,0,170,109,101,338,69,-229,D,1,1,0
2012-06-10 00:00:00.000000,Liberia,Angola,0,0,FIFA World Cup qualification,Monrovia,Liberia,0,124,277,84,416,40,-139,D,1,1,0
2012-06-10 00:00:00.000000,Libya,Cameroon,2,1,FIFA World Cup qualification,Sfax,Tunisia,1,42,608,64,515,-22,93,W,0,0,0
2012-06-10 00:00:00.000000,Mali,Algeria,2,1,FIFA World Cup qualification,Ouagadougou,Burkina Faso,1,43,601,32,734,11,-133,W,0,0,0
2012-06-10 00:00:00.000000,Mozambique,Zimbabwe,0,0,FIFA World Cup qualification,Maputo,Mozambique,0,117,290,106,329,11,-39,D,1,1,0
2012-06-10 00:00:00.000000,Rwanda,Benin,1,1,FIFA World Cup qualification,Kigali,Rwanda,0,119,284,72,489,47,-205,D,1,1,0
2012-06-10 00:00:00.000000,Solomon Islands,New Zealand,3,4,Oceania Nations Cup,Honiara,Solomon Islands,0,183,75,100,341,83,-266,L,2,1,0
2012-06-10 00:00:00.000000,Spain,Italy,1,1,UEFA Euro,Gdańsk,Poland,1,1,1456,12,977,-11,479,D,1,0,0
2012-06-10 00:00:00.000000,Tahiti,New Caledonia,1,0,Oceania Nations Cup,Honiara,Solomon Islands,1,179,86,155,150,24,-64,W,0,0,0
2012-06-10 00:00:00.000000,Tanzania,Gambia,2,1,FIFA World Cup qualification,Dar es Salaam,Tanzania,0,139,214,108,320,31,-106,W,0,1,0
2012-06-10 00:00:00.000000,Uruguay,Peru,4,2,FIFA World Cup qualification,Montevideo,Uruguay,0,2,1292,37,688,-35,604,W,0,1,0
2012-06-11 00:00:00.000000,France,England,1,1,UEFA Euro,Donets'k,Ukraine,1,14,964,6,1145,8,-181,D,1,0,0
2012-06-11 00:00:00.000000,Ukraine,Sweden,2,1,UEFA Euro,Kyïv,Ukraine,0,52,572,17,910,35,-338,W,0,1,0
2012-06-12 00:00:00.000000,Antigua and Barbuda,Jamaica,0,0,FIFA World Cup qualification,St. John's,Antigua and Barbuda,0,105,330,60,520,45,-190,D,1,1,0
2012-06-12 00:00:00.000000,Australia,Japan,1,1,FIFA World Cup qualification,Brisbane,Australia,0,24,820,23,822,1,-2,D,1,1,0
2012-06-12 00:00:00.000000,Bahrain,Kuwait,0,1,Friendly,6th of October City,Egypt,1,95,359,87,383,8,-24,L,2,0,0
2012-06-12 00:00:00.000000,Canada,Honduras,0,0,FIFA World Cup qualification,Toronto,Canada,0,77,457,55,550,22,-93,D,1,1,0
2012-06-12 00:00:00.000000,El Salvador,Mexico,1,2,FIFA World Cup qualification,San Salvador,El Salvador,0,55,550,19,889,36,-339,L,2,1,0
2012-06-12 00:00:00.000000,Greece,Czech Republic,1,2,UEFA Euro,Wrocław,Poland,1,15,953,27,771,-12,182,L,2,0,0
2012-06-12 00:00:00.000000,Guatemala,USA,1,1,FIFA World Cup qualification,Guatemala,Guatemala,0,85,412,28,767,57,-355,D,1,1,0
2012-06-12 00:00:00.000000,Guyana,Costa Rica,0,4,FIFA World Cup qualification,Providence,Guyana,0,104,332,65,507,39,-175,L,2,1,0
2012-06-12 00:00:00.000000,Iran,Qatar,0,0,FIFA World Cup qualification,Teheran,Iran,0,45,596,91,372,-46,224,D,1,1,0
2012-06-12 00:00:00.000000,Iraq,Oman,1,1,FIFA World Cup qualification,Doha,Qatar,1,74,477,97,349,-23,128,D,1,0,0
2012-06-12 00:00:00.000000,Korea Republic,Lebanon,3,0,FIFA World Cup qualification,Goyang,Korea Republic,0,35,719,143,207,-108,512,W,0,1,0
2012-06-12 00:00:00.000000,Malaysia,Singapore,2,0,Friendly,Shah Alam,Malaysia,0,154,151,157,143,-3,8,W,0,1,0
2012-06-12 00:00:00.000000,Panama,Cuba,1,0,FIFA World Cup qualification,Panama City,Panama,0,46,591,145,197,-99,394,W,0,1,0
2012-06-12 00:00:00.000000,Philippines,Guam,3,0,Friendly,Bacalod,Philippines,0,149,164,194,32,-45,132,W,0,1,0
2012-06-12 00:00:00.000000,Poland,Russia,1,1,UEFA Euro,Warsaw,Poland,0,62,518,13,975,49,-457,D,1,1,0
2012-06-13 00:00:00.000000,Denmark,Portugal,2,3,UEFA Euro,L'viv,Ukraine,1,9,1019,10,996,-1,23,L,2,0,0
2012-06-13 00:00:00.000000,Netherlands,Germany,1,2,UEFA Euro,Kharkiv,Ukraine,1,4,1234,3,1288,1,-54,L,2,0,0
2012-06-14 00:00:00.000000,Italy,Croatia,1,1,UEFA Euro,Poznań,Poland,1,12,977,8,1053,4,-76,D,1,0,0
2012-06-15 00:00:00.000000,Algeria,Gambia,4,1,African Cup of Nations qualification,Blida,Algeria,0,32,734,108,320,-76,414,W,0,1,0
2012-06-15 00:00:00.000000,Egypt,Central African Republic,2,3,African Cup of Nations qualification,Alexandria,Egypt,0,48,588,93,366,-45,222,L,2,1,0
2012-06-15 00:00:00.000000,South Africa,Gabon,3,0,Friendly,Nelspruit,South Africa,0,68,499,49,586,19,-87,W,0,1,0
2012-06-15 00:00:00.000000,Sweden,England,2,3,UEFA Euro,Kyïv,Ukraine,1,17,910,6,1145,11,-235,L,2,0,0
2012-06-15 00:00:00.000000,Ukraine,France,0,2,UEFA Euro,Donets'k,Ukraine,0,52,572,14,964,38,-392,L,2,1,0
2012-06-16 00:00:00.000000,Cameroon,Guinea-Bissau,1,0,African Cup of Nations qualification,Yaoundé,Cameroon,0,64,515,169,111,-105,404,W,0,1,0
2012-06-16 00:00:00.000000,Greece,Russia,1,0,UEFA Euro,Warsaw,Poland,1,15,953,13,975,2,-22,W,0,0,0
2012-06-16 00:00:00.000000,Malawi,Chad,2,0,African Cup of Nations qualification,Blantyre,Malawi,0,107,324,112,300,-5,24,W,0,1,0
2012-06-16 00:00:00.000000,Namibia,Liberia,0,0,African Cup of Nations qualification,Windhoek,Namibia,0,134,246,124,277,10,-31,D,1,1,0
2012-06-16 00:00:00.000000,Nigeria,Rwanda,2,0,African Cup of Nations qualification,Calabar,Nigeria,0,60,520,119,284,-59,236,W,0,1,0
2012-06-16 00:00:00.000000,Poland,Czech Republic,0,1,UEFA Euro,Wrocław,Poland,0,62,518,27,771,35,-253,L,2,1,0
2012-06-16 00:00:00.000000,Uganda,Congo,4,0,African Cup of Nations qualification,Kampala,Uganda,0,94,363,83,422,11,-59,W,0,1,0
2012-06-17 00:00:00.000000,Benin,Ethiopia,1,1,African Cup of Nations qualification,Cotonou,Benin,0,72,489,130,249,-58,240,D,1,1,0
2012-06-17 00:00:00.000000,Congo DR,Seychelles,3,0,African Cup of Nations qualification,Kinshasa,Congo DR,0,127,257,189,48,-62,209,W,0,1,0
2012-06-17 00:00:00.000000,Denmark,Germany,1,2,UEFA Euro,L'viv,Ukraine,1,9,1019,3,1288,6,-269,L,2,0,0
2012-06-17 00:00:00.000000,Portugal,Netherlands,2,1,UEFA Euro,Kharkiv,Ukraine,1,10,996,4,1234,6,-238,W,0,0,0
2012-06-17 00:00:00.000000,Togo,Kenya,1,0,African Cup of Nations qualification,Lomé,Togo,0,98,343,111,303,-13,40,W,0,1,0
2012-06-17 00:00:00.000000,Zimbabwe,Burundi,1,0,African Cup of Nations qualification,Harare,Zimbabwe,0,106,329,131,248,-25,81,W,0,1,0
2012-06-18 00:00:00.000000,Croatia,Spain,0,1,UEFA Euro,Gdańsk,Poland,1,8,1053,1,1456,7,-403,L,2,0,0
2012-06-18 00:00:00.000000,Saudi Arabia,Morocco,4,0,Friendly,Ta’if,Saudi Arabia,0,92,369,70,491,22,-122,W,0,1,0
2012-06-18 00:00:00.000000,Yemen,Palestine,1,2,Friendly,Sana'a,Yemen,0,159,141,153,153,6,-12,L,2,1,0
2012-06-19 00:00:00.000000,Sweden,France,2,0,UEFA Euro,Kyïv,Ukraine,1,17,910,14,964,3,-54,W,0,0,0
2012-06-19 00:00:00.000000,Ukraine,England,0,1,UEFA Euro,Donets'k,Ukraine,0,52,572,6,1145,46,-573,L,2,1,0
2012-06-21 00:00:00.000000,Czech Republic,Portugal,0,1,UEFA Euro,Warsaw,Poland,1,27,771,10,996,17,-225,L,2,0,0
2012-06-22 00:00:00.000000,Germany,Greece,4,2,UEFA Euro,Gdańsk,Poland,1,3,1288,15,953,-12,335,W,0,0,0
2012-06-22 00:00:00.000000,Saudi Arabia,Kuwait,4,0,UAFA Cup,Ta’if,Saudi Arabia,0,92,369,87,383,5,-14,W,0,1,0
2012-06-23 00:00:00.000000,Libya,Yemen,3,1,UAFA Cup,Jeddah,Saudi Arabia,1,42,608,159,141,-117,467,W,0,0,0
2012-06-23 00:00:00.000000,Morocco,Bahrain,4,0,UAFA Cup,Jeddah,Saudi Arabia,1,70,491,95,359,-25,132,W,0,0,0
2012-06-23 00:00:00.000000,Spain,France,2,0,UEFA Euro,Donets'k,Ukraine,1,1,1456,14,964,-13,492,W,0,0,0
2012-06-24 00:00:00.000000,England,Italy,0,0,UEFA Euro,Kyïv,Ukraine,1,6,1145,12,977,-6,168,D,1,0,0
2012-06-24 00:00:00.000000,Iraq,Lebanon,1,0,UAFA Cup,Jeddah,Saudi Arabia,1,74,477,143,207,-69,270,W,0,0,0
2012-06-25 00:00:00.000000,Kuwait,Palestine,2,0,UAFA Cup,Ta’if,Saudi Arabia,1,87,383,153,153,-66,230,W,0,0,0
2012-06-26 00:00:00.000000,Bahrain,Yemen,0,2,UAFA Cup,Jeddah,Saudi Arabia,1,95,359,159,141,-64,218,L,2,0,0
2012-06-26 00:00:00.000000,Libya,Morocco,0,0,UAFA Cup,Jeddah,Saudi Arabia,1,42,608,70,491,-28,117,D,1,0,0
2012-06-27 00:00:00.000000,Lebanon,Sudan,0,2,UAFA Cup,Jeddah,Saudi Arabia,1,143,207,101,338,42,-131,L,2,0,0
2012-06-27 00:00:00.000000,Portugal,Spain,0,0,UEFA Euro,Donets'k,Ukraine,1,10,996,1,1456,9,-460,D,1,0,0
2012-06-28 00:00:00.000000,Germany,Italy,1,2,UEFA Euro,Warsaw,Poland,1,3,1288,12,977,-9,311,L,2,0,0
2012-06-28 00:00:00.000000,Saudi Arabia,Palestine,2,2,UAFA Cup,Ta’if,Saudi Arabia,0,92,369,153,153,-61,216,D,1,1,0
2012-06-29 00:00:00.000000,Libya,Bahrain,2,1,UAFA Cup,Ta’if,Saudi Arabia,1,42,608,95,359,-53,249,W,0,0,0
2012-06-29 00:00:00.000000,Yemen,Morocco,0,4,UAFA Cup,Jeddah,Saudi Arabia,1,159,141,70,491,89,-350,L,2,0,0
2012-06-30 00:00:00.000000,Central African Republic,Egypt,1,1,African Cup of Nations qualification,Bangui,Central African Republic,0,93,366,48,588,45,-222,D,1,1,0
2012-06-30 00:00:00.000000,Sudan,Iraq,1,1,UAFA Cup,Jeddah,Saudi Arabia,1,101,338,74,477,27,-139,D,1,0,0
2012-07-01 00:00:00.000000,Spain,Italy,4,0,UEFA Euro,Kyïv,Ukraine,1,1,1456,12,977,-11,479,W,0,0,0
2012-07-05 00:00:00.000000,Saudi Arabia,Iraq,0,1,UAFA Cup,Jeddah,Saudi Arabia,0,101,339,81,428,20,-89,L,2,1,0
2012-07-06 00:00:00.000000,Libya,Morocco,1,1,UAFA Cup,Jeddah,Saudi Arabia,1,39,655,71,471,-32,184,D,1,0,0
2012-07-06 00:00:00.000000,Malawi,Zambia,1,0,Friendly,Blantyre,Malawi,0,93,370,41,648,52,-278,W,0,1,0
2012-07-07 00:00:00.000000,British Virgin Islands,Anguilla,1,0,Friendly,Road Town,British Virgin Islands,0,199,13,202,4,-3,9,W,0,1,0
2012-07-12 00:00:00.000000,Kenya,Botswana,3,1,Friendly,Nairobi,Kenya,0,125,256,113,296,12,-40,W,0,1,0
2012-07-13 00:00:00.000000,Aruba,Curaçao,3,2,ABCS Tournament,Oranjestad,Aruba,0,164,120,158,138,6,-18,W,0,1,0
2012-07-15 00:00:00.000000,Aruba,Suriname,1,0,ABCS Tournament,Oranjestad,Aruba,0,164,120,132,240,32,-120,W,0,1,0
2012-07-16 00:00:00.000000,Botswana,Zimbabwe,1,0,Friendly,Molepolole,Botswana,0,113,296,100,347,13,-51,W,0,1,0
2012-07-17 00:00:00.000000,Zimbabwe,Lesotho,5,3,Friendly,Molepolole,Botswana,1,100,347,166,119,-66,228,W,0,0,0
2012-07-18 00:00:00.000000,Botswana,Lesotho,0,0,Friendly,Molepolole,Botswana,0,113,296,166,119,-53,177,D,1,1,0
2012-07-22 00:00:00.000000,Guam,Macau,3,0,EAFF Championship,Yona,Guam,0,194,32,199,13,-5,19,W,0,1,0
2012-08-08 00:00:00.000000,Zambia,Zimbabwe,2,1,Friendly,Ndola,Zambia,0,44,623,106,328,-62,295,W,0,1,0
2012-08-11 00:00:00.000000,El Salvador,Guatemala,1,0,Friendly,Carson,USA,1,64,490,88,399,-24,91,W,0,0,0
2012-08-13 00:00:00.000000,Jordan,Uzbekistan,0,1,Friendly,Amman,Jordan,0,83,425,63,493,20,-68,L,2,1,0
2012-08-14 00:00:00.000000,Burkina Faso,Togo,3,0,Friendly,Saint-Leu-la-Forêt,France,1,87,405,99,342,-12,63,W,0,0,0
2012-08-14 00:00:00.000000,Liechtenstein,Andorra,1,0,Friendly,Vaduz,Liechtenstein,0,148,177,200,15,-52,162,W,0,1,0
2012-08-14 00:00:00.000000,San Marino,Malta,2,3,Friendly,Serravalle,San Marino,0,206,0,143,196,63,-196,L,2,1,0
2012-08-15 00:00:00.000000,Albania,Moldova,0,0,Friendly,Tirana,Albania,0,74,448,137,213,-63,235,D,1,1,0
2012-08-15 00:00:00.000000,Angola,Mozambique,2,0,Friendly,Benguela,Angola,0,85,407,107,316,-22,91,W,0,1,0
2012-08-15 00:00:00.000000,Armenia,Belarus,1,2,Friendly,Yerevan,Armenia,0,56,559,76,447,-20,112,L,2,1,0
2012-08-15 00:00:00.000000,Austria,Turkey,2,0,Friendly,Vienna,Austria,0,60,517,30,735,30,-218,W,0,1,0
2012-08-15 00:00:00.000000,Azerbaijan,Bahrain,3,0,Friendly,Bakıxanov,Azerbaijan,0,108,308,102,331,6,-23,W,0,1,0
2012-08-15 00:00:00.000000,Belgium,Netherlands,4,2,Friendly,Brussels,Belgium,0,53,564,8,1053,45,-489,W,0,1,0
2012-08-15 00:00:00.000000,Bolivia,Guyana,2,0,Friendly,Santa Cruz,Bolivia,0,73,449,109,307,-36,142,W,0,1,0
2012-08-15 00:00:00.000000,Botswana,Tanzania,3,3,Friendly,Molepolole,Botswana,0,112,301,128,253,-16,48,D,1,1,0
2012-08-15 00:00:00.000000,Bulgaria,Cyprus,1,0,Friendly,Sofia,Bulgaria,0,94,373,123,266,-29,107,W,0,1,0
2012-08-15 00:00:00.000000,Canada,Trinidad and Tobago,2,0,Friendly,Lauderhill,USA,1,79,439,80,435,-1,4,W,0,0,0
2012-08-15 00:00:00.000000,Costa Rica,Peru,0,1,Friendly,San José,Costa Rica,0,62,501,47,607,15,-106,L,2,1,0
2012-08-15 00:00:00.000000,Croatia,Switzerland,2,4,Friendly,Split,Croatia,0,9,1050,23,828,-14,222,L,2,1,0
2012-08-15 00:00:00.000000,Denmark,Slovakia,1,3,Friendly,Odense,Denmark,0,10,1017,42,626,-32,391,L,2,1,0
2012-08-15 00:00:00.000000,Ecuador,Chile,3,0,Friendly,New York,USA,1,20,836,15,953,5,-117,W,0,0,0
2012-08-15 00:00:00.000000,El Salvador,Jamaica,0,2,Friendly,Washington,USA,1,64,490,66,479,-2,11,L,2,0,0
2012-08-15 00:00:00.000000,England,Italy,2,1,Friendly,Berne,Switzerland,1,3,1294,6,1192,-3,102,W,0,0,0
2012-08-15 00:00:00.000000,Equatorial Guinea,Liberia,1,0,Friendly,Malabo,Equatorial Guinea,0,111,302,117,287,-6,15,W,0,1,0
2012-08-15 00:00:00.000000,Estonia,Poland,1,0,Friendly,Tallinn,Estonia,0,49,587,54,560,-5,27,W,0,1,0
2012-08-15 00:00:00.000000,France,Uruguay,0,0,Friendly,Le Havre,France,0,14,980,4,1236,10,-256,D,1,1,0
2012-08-15 00:00:00.000000,Germany,Argentina,1,3,Friendly,Frankfurt am Main,Germany,0,2,1474,7,1098,-5,376,L,2,1,0
2012-08-15 00:00:00.000000,Guatemala,Paraguay,3,3,Friendly,Washington,USA,1,88,399,27,747,61,-348,D,1,0,0
2012-08-15 00:00:00.000000,Hungary,Israel,1,1,Friendly,Budapest,Hungary,0,28,746,82,427,-54,319,D,1,1,0
2012-08-15 00:00:00.000000,Iceland,Faroe Islands,2,0,Friendly,Reykjavík,Iceland,0,130,250,153,149,-23,101,W,0,1,0
2012-08-15 00:00:00.000000,Iran,Tunisia,2,2,Friendly,Kecskemét,Hungary,1,48,590,41,627,7,-37,D,1,0,0
2012-08-15 00:00:00.000000,Japan,Venezuela,1,1,Friendly,Sapporo,Japan,0,22,829,52,570,-30,259,D,1,1,0
2012-08-15 00:00:00.000000,Jordan,Uzbekistan,2,0,Friendly,Amman,Jordan,0,83,425,63,493,20,-68,W,0,1,0
2012-08-15 00:00:00.000000,Korea Republic,Zambia,2,1,Friendly,Anyang,Korea Republic,0,29,740,44,623,-15,117,W,0,1,0
2012-08-15 00:00:00.000000,Luxembourg,Georgia,1,2,Friendly,Differdange,Luxembourg,0,110,303,97,357,13,-54,L,2,1,0
2012-08-15 00:00:00.000000,Mexico,USA,0,1,Friendly,Mexico City,Mexico,0,18,862,36,672,-18,190,L,2,1,0
2012-08-15 00:00:00.000000,Montenegro,Latvia,2,0,Friendly,Podgorica,Montenegro,0,50,581,70,463,-20,118,W,0,1,0
2012-08-15 00:00:00.000000,Morocco,Guinea,1,2,Friendly,Rabat,Morocco,0,68,473,74,448,-6,25,L,2,1,0
2012-08-15 00:00:00.000000,Niger,Nigeria,0,0,Friendly,Niamey,Niger,0,115,291,58,525,57,-234,D,1,1,0
2012-08-15 00:00:00.000000,Northern Ireland,Finland,3,3,Friendly,Belfast,Northern Ireland,0,101,336,72,451,29,-115,D,1,1,0
2012-08-15 00:00:00.000000,Norway,Greece,2,3,Friendly,Oslo,Norway,0,25,780,12,1003,13,-223,L,2,1,0
2012-08-15 00:00:00.000000,Oman,Egypt,1,1,Friendly,Salalah,Oman,0,92,375,40,637,52,-262,D,1,1,0
2012-08-15 00:00:00.000000,Portugal,Panama,2,0,Friendly,Faro,Portugal,0,5,1213,54,560,-49,653,W,0,1,0
2012-08-15 00:00:00.000000,Puerto Rico,Spain,1,2,Friendly,Bayamón,Puerto Rico,0,138,210,1,1605,137,-1395,L,2,1,0
2012-08-15 00:00:00.000000,Scotland,Australia,3,1,Friendly,Edinburgh,Scotland,0,46,611,24,807,22,-196,W,0,1,0
2012-08-15 00:00:00.000000,Singapore,Hong Kong,2,0,Friendly,Jurong,Singapore,0,162,125,154,147,8,-22,W,0,1,0
2012-08-15 00:00:00.000000,Slovenia,Romania,4,3,Friendly,Celje,Slovenia,0,33,706,51,580,-18,126,W,0,1,0
2012-08-15 00:00:00.000000,Sweden,Brazil,0,3,Friendly,Solna,Sweden,0,17,909,13,991,4,-82,L,2,1,0
2012-08-15 00:00:00.000000,Ukraine,Czech Republic,0,0,Friendly,L'viv,Ukraine,0,45,621,19,854,26,-233,D,1,1,0
2012-08-22 00:00:00.000000,India,Syria,2,1,Nehru Cup,New Delhi,India,0,168,106,147,180,21,-74,W,0,1,0
2012-08-23 00:00:00.000000,Maldives,Nepal,2,1,Nehru Cup,New Delhi,India,1,161,126,162,125,-1,1,W,0,0,0
2012-08-24 00:00:00.000000,Syria,Cameroon,2,2,Nehru Cup,New Delhi,India,1,147,180,59,520,88,-340,D,1,0,0
2012-08-25 00:00:00.000000,India,Maldives,3,0,Nehru Cup,New Delhi,India,0,168,106,161,126,7,-20,W,0,1,0
2012-08-26 00:00:00.000000,Botswana,Uganda,0,0,Friendly,Gaborone,Botswana,0,112,301,88,399,24,-98,D,1,1,0
2012-08-26 00:00:00.000000,Libya,Sudan,3,0,Friendly,Tunis,Tunisia,1,38,655,104,329,-66,326,W,0,0,0
2012-08-26 00:00:00.000000,Nepal,Cameroon,0,5,Nehru Cup,New Delhi,India,1,162,125,59,520,103,-395,L,2,0,0
2012-08-27 00:00:00.000000,Maldives,Syria,2,1,Nehru Cup,New Delhi,India,1,161,126,147,180,14,-54,W,0,0,0
2012-08-28 00:00:00.000000,India,Nepal,0,0,Nehru Cup,New Delhi,India,0,168,106,162,125,6,-19,D,1,1,0
2012-08-29 00:00:00.000000,Cameroon,Maldives,3,1,Nehru Cup,New Delhi,India,1,59,520,161,126,-102,394,W,0,0,0
2012-08-30 00:00:00.000000,Syria,Nepal,2,0,Nehru Cup,New Delhi,India,1,147,180,162,125,-15,55,W,0,0,0
2012-08-31 00:00:00.000000,India,Cameroon,0,1,Nehru Cup,New Delhi,India,0,168,106,59,520,109,-414,L,2,1,0
2012-09-02 00:00:00.000000,India,Cameroon,2,2,Nehru Cup,New Delhi,India,0,168,106,59,520,109,-414,D,1,1,0
2012-09-05 00:00:00.000000,Cambodia,Philippines,0,0,Friendly,Phnom Penh,Cambodia,0,188,42,150,167,38,-125,D,1,1,0
2012-09-05 00:00:00.000000,Jordan,Iran,0,0,Friendly,Amman,Jordan,0,87,402,54,573,33,-171,D,1,1,0
2012-09-05 00:00:00.000000,Montserrat,Suriname,1,7,CFU Caribbean Cup qualification,Le Lamentin,Martinique,1,206,0,138,207,68,-207,L,2,0,0
2012-09-06 00:00:00.000000,Japan,United Arab Emirates,1,0,Friendly,Niigata,Japan,0,23,793,120,278,-97,515,W,0,1,0
2012-09-06 00:00:00.000000,Lebanon,Australia,0,3,Friendly,Tripoli,Lebanon,0,124,271,25,778,99,-507,L,2,1,0
2012-09-06 00:00:00.000000,Qatar,Tajikistan,1,2,Friendly,Ingolstadt,Germany,1,92,380,142,196,-50,184,L,2,0,0
2012-09-07 00:00:00.000000,Albania,Cyprus,3,1,FIFA World Cup qualification,Tirana,Albania,0,84,410,135,232,-51,178,W,0,1,0
2012-09-07 00:00:00.000000,Andorra,Hungary,0,5,FIFA World Cup qualification,Sant Julià de Lòria,Andorra,0,199,15,37,663,162,-648,L,2,1,0
2012-09-07 00:00:00.000000,Argentina,Paraguay,3,1,FIFA World Cup qualification,Córdoba,Argentina,0,7,1121,29,728,-22,393,W,0,1,0
2012-09-07 00:00:00.000000,Azerbaijan,Israel,1,1,FIFA World Cup qualification,Baku,Azerbaijan,0,107,324,75,446,32,-122,D,1,1,0
2012-09-07 00:00:00.000000,Bermuda,Puerto Rico,1,2,CFU Caribbean Cup qualification,Port-au-Prince,Haiti,1,102,333,137,210,-35,123,L,2,0,0
2012-09-07 00:00:00.000000,Brazil,South Africa,1,0,Friendly,São Paulo,Brazil,0,12,996,74,448,-62,548,W,0,1,0
2012-09-07 00:00:00.000000,British Virgin Islands,Suriname,0,4,CFU Caribbean Cup qualification,Rivière-Pilote,Martinique,1,189,40,138,207,51,-167,L,2,0,0
2012-09-07 00:00:00.000000,Bulgaria,Italy,2,2,FIFA World Cup qualification,Sofia,Bulgaria,0,89,388,6,1174,83,-786,D,1,1,0
2012-09-07 00:00:00.000000,Canada,Panama,1,0,FIFA World Cup qualification,Toronto,Canada,0,73,454,50,591,23,-137,W,0,1,0
2012-09-07 00:00:00.000000,Colombia,Uruguay,4,0,FIFA World Cup qualification,Barranquilla,Colombia,0,22,843,5,1217,17,-374,W,0,1,0
2012-09-07 00:00:00.000000,Costa Rica,Mexico,0,2,FIFA World Cup qualification,San José,Costa Rica,0,66,487,21,845,45,-358,L,2,1,0
2012-09-07 00:00:00.000000,Cuba,Honduras,0,3,FIFA World Cup qualification,Havana,Cuba,0,147,175,72,460,75,-285,L,2,1,0
2012-09-07 00:00:00.000000,Ecuador,Bolivia,1,0,FIFA World Cup qualification,Quito,Ecuador,0,17,890,63,501,-46,389,W,0,1,0
2012-09-07 00:00:00.000000,El Salvador,Guyana,2,2,FIFA World Cup qualification,San Salvador,El Salvador,0,67,481,122,276,-55,205,D,1,1,0
2012-09-07 00:00:00.000000,Estonia,Romania,0,2,FIFA World Cup qualification,Tallinn,Estonia,0,55,572,57,542,-2,30,L,2,1,0
2012-09-07 00:00:00.000000,Finland,France,0,1,FIFA World Cup qualification,Helsinki,Finland,0,96,365,15,965,81,-600,L,2,1,0
2012-09-07 00:00:00.000000,Georgia,Belarus,1,0,FIFA World Cup qualification,Tbilisi,Georgia,0,86,405,76,443,10,-38,W,0,1,0
2012-09-07 00:00:00.000000,Germany,Faroe Islands,3,0,FIFA World Cup qualification,Hanover,Germany,0,2,1437,154,147,-152,1290,W,0,1,0
2012-09-07 00:00:00.000000,Guatemala,Antigua and Barbuda,3,1,FIFA World Cup qualification,Guatemala,Guatemala,0,91,384,101,340,-10,44,W,0,1,0
2012-09-07 00:00:00.000000,Iceland,Norway,2,0,FIFA World Cup qualification,Reykjavík,Iceland,0,118,283,34,682,84,-399,W,0,1,0
2012-09-07 00:00:00.000000,Jamaica,USA,2,1,FIFA World Cup qualification,Kingston,Jamaica,0,60,515,33,697,27,-182,W,0,1,0
2012-09-07 00:00:00.000000,Latvia,Greece,1,2,FIFA World Cup qualification,Riga,Latvia,0,94,375,11,1001,83,-626,L,2,1,0
2012-09-07 00:00:00.000000,Lithuania,Slovakia,1,1,FIFA World Cup qualification,Vilnius,Lithuania,0,116,290,45,616,71,-326,D,1,1,0
2012-09-07 00:00:00.000000,Luxembourg,Portugal,1,2,FIFA World Cup qualification,Luxembourg,Luxembourg,0,106,326,4,1232,102,-906,L,2,1,0
2012-09-07 00:00:00.000000,Malta,Armenia,0,1,FIFA World Cup qualification,Attard,Malta,0,139,206,53,575,86,-369,L,2,1,0
2012-09-07 00:00:00.000000,Moldova,England,0,5,FIFA World Cup qualification,Chişinău,Moldova,0,141,204,3,1274,138,-1070,L,2,1,0
2012-09-07 00:00:00.000000,Montenegro,Poland,2,2,FIFA World Cup qualification,Podgorica,Montenegro,0,48,606,56,547,-8,59,D,1,1,0
2012-09-07 00:00:00.000000,Netherlands,Turkey,2,0,FIFA World Cup qualification,Amsterdam,Netherlands,0,8,1044,35,678,-27,366,W,0,1,0
2012-09-07 00:00:00.000000,New Caledonia,New Zealand,0,2,FIFA World Cup qualification,Nouméa,New Caledonia,0,128,261,95,366,33,-105,L,2,1,0
2012-09-07 00:00:00.000000,Peru,Venezuela,2,1,FIFA World Cup qualification,Lima,Peru,0,51,587,52,584,-1,3,W,0,1,0
2012-09-07 00:00:00.000000,Russia,Northern Ireland,2,0,FIFA World Cup qualification,Moscow,Russia,0,13,990,129,257,-116,733,W,0,1,0
2012-09-07 00:00:00.000000,Singapore,Philippines,0,2,Friendly,Jurong,Singapore,0,161,129,150,167,11,-38,L,2,1,0
2012-09-07 00:00:00.000000,Slovenia,Switzerland,0,2,FIFA World Cup qualification,Ljubljana,Slovenia,0,24,784,20,847,4,-63,L,2,1,0
2012-09-07 00:00:00.000000,Solomon Islands,Tahiti,2,0,FIFA World Cup qualification,Honiara,Solomon Islands,0,153,150,119,282,34,-132,W,0,1,0
2012-09-07 00:00:00.000000,Spain,Saudi Arabia,5,0,Friendly,Pontevedra,Spain,0,1,1617,105,328,-104,1289,W,0,1,0
2012-09-07 00:00:00.000000,Uzbekistan,Kuwait,3,0,Friendly,Tashkent,Uzbekistan,0,70,470,100,348,-30,122,W,0,1,0
2012-09-07 00:00:00.000000,Wales,Belgium,0,2,FIFA World Cup qualification,Cardiff,Wales,0,45,616,40,626,5,-10,L,2,1,0
2012-09-08 00:00:00.000000,Central African Republic,Burkina Faso,1,0,African Cup of Nations qualification,Bangui,Central African Republic,0,64,492,85,406,-21,86,W,0,1,0
2012-09-08 00:00:00.000000,Congo DR,Equatorial Guinea,4,0,African Cup of Nations qualification,Kinshasa,Congo DR,0,110,311,107,324,3,-13,W,0,1,0
2012-09-08 00:00:00.000000,Denmark,Czech Republic,0,0,FIFA World Cup qualification,Copenhagen,Denmark,0,10,1006,19,869,-9,137,D,1,1,0
2012-09-08 00:00:00.000000,Gabon,Togo,1,1,African Cup of Nations qualification,Libreville,Gabon,0,44,617,99,356,-55,261,D,1,1,0
2012-09-08 00:00:00.000000,Ghana,Malawi,2,0,African Cup of Nations qualification,Accra,Ghana,0,31,714,90,385,-59,329,W,0,1,0
2012-09-08 00:00:00.000000,Liberia,Nigeria,2,2,African Cup of Nations qualification,Paynesville,Liberia,0,111,310,58,523,53,-213,D,1,1,0
2012-09-08 00:00:00.000000,Mali,Botswana,3,0,African Cup of Nations qualification,Bamako,Mali,0,32,710,123,275,-91,435,W,0,1,0
2012-09-08 00:00:00.000000,Scotland,Serbia,0,0,FIFA World Cup qualification,Glasgow,Scotland,0,47,610,42,624,5,-14,D,1,1,0
2012-09-08 00:00:00.000000,Sierra Leone,Tunisia,2,2,African Cup of Nations qualification,Freetown,Sierra Leone,0,59,518,41,625,18,-107,D,1,1,0
2012-09-08 00:00:00.000000,Sudan,Ethiopia,5,3,African Cup of Nations qualification,Khartoum,Sudan,0,103,332,114,303,-11,29,W,0,1,0
2012-09-08 00:00:00.000000,Zambia,Uganda,1,0,African Cup of Nations qualification,Ndola,Zambia,0,42,624,88,401,-46,223,W,0,1,0
2012-09-09 00:00:00.000000,British Virgin Islands,Montserrat,0,7,CFU Caribbean Cup qualification,Fort-de-France,Martinique,1,189,40,206,0,-17,40,L,2,0,0
2012-09-09 00:00:00.000000,Guinea,Niger,1,0,African Cup of Nations qualification,Conakry,Guinea,0,69,472,126,267,-57,205,W,0,1,0
2012-09-09 00:00:00.000000,Haiti,Bermuda,3,1,CFU Caribbean Cup qualification,Port-au-Prince,Haiti,0,77,439,102,333,-25,106,W,0,1,0
2012-09-09 00:00:00.000000,Libya,Algeria,0,1,African Cup of Nations qualification,Casablanca,Morocco,1,36,666,28,734,8,-68,L,2,0,0
2012-09-09 00:00:00.000000,Mozambique,Morocco,2,0,African Cup of Nations qualification,Maputo,Mozambique,0,109,312,68,478,41,-166,W,0,1,0
2012-09-09 00:00:00.000000,Zimbabwe,Angola,3,1,African Cup of Nations qualification,Harare,Zimbabwe,0,98,358,80,433,18,-75,W,0,1,0
2012-09-10 00:00:00.000000,Indonesia,Korea DPR,0,2,Friendly,Jakarta,Indonesia,0,168,111,81,429,87,-318,L,2,1,0
2012-09-10 00:00:00.000000,Laos,Philippines,2,1,Friendly,Vientiane,Laos,0,193,38,150,167,43,-129,W,0,1,0
2012-09-11 00:00:00.000000,Antigua and Barbuda,Guatemala,0,1,FIFA World Cup qualification,St. John's,Antigua and Barbuda,0,101,340,91,384,10,-44,L,2,1,0
2012-09-11 00:00:00.000000,Austria,Germany,1,2,FIFA World Cup qualification,Vienna,Austria,0,49,598,2,1437,47,-839,L,2,1,0
2012-09-11 00:00:00.000000,Belgium,Croatia,1,1,FIFA World Cup qualification,Brussels,Belgium,0,40,626,9,1020,31,-394,D,1,1,0
2012-09-11 00:00:00.000000,Bulgaria,Armenia,1,0,FIFA World Cup qualification,Sofia,Bulgaria,0,89,388,53,575,36,-187,W,0,1,0
2012-09-11 00:00:00.000000,Chile,Colombia,1,3,FIFA World Cup qualification,Santiago,Chile,0,14,984,22,843,-8,141,L,2,1,0
2012-09-11 00:00:00.000000,Cyprus,Iceland,1,0,FIFA World Cup qualification,Larnaca,Cyprus,0,135,232,118,283,17,-51,W,0,1,0
2012-09-11 00:00:00.000000,Czech Republic,Finland,0,1,Friendly,Teplice,Czech Republic,0,19,869,96,365,-77,504,L,2,1,0
2012-09-11 00:00:00.000000,England,Ukraine,1,1,FIFA World Cup qualification,London,England,0,3,1274,39,628,-36,646,D,1,1,0
2012-09-11 00:00:00.000000,France,Belarus,3,1,FIFA World Cup qualification,Saint-Denis,France,0,15,965,76,443,-61,522,W,0,1,0
2012-09-11 00:00:00.000000,Gabon,Saudi Arabia,1,0,Friendly,Amiens,France,1,44,617,105,328,-61,289,W,0,0,0
2012-09-11 00:00:00.000000,Georgia,Spain,0,1,FIFA World Cup qualification,Tbilisi,Georgia,0,86,405,1,1617,85,-1212,L,2,1,0
2012-09-11 00:00:00.000000,Greece,Lithuania,2,0,FIFA World Cup qualification,Piraeus,Greece,0,11,1001,116,290,-105,711,W,0,1,0
2012-09-11 00:00:00.000000,Guyana,El Salvador,2,3,FIFA World Cup qualification,Providence,Guyana,0,122,276,67,481,55,-205,L,2,1,0
2012-09-11 00:00:00.000000,Haiti,Puerto Rico,2,1,CFU Caribbean Cup qualification,Port-au-Prince,Haiti,0,77,439,137,210,-60,229,W,0,1,0
2012-09-11 00:00:00.000000,Honduras,Cuba,1,0,FIFA World Cup qualification,San Pedro Sula,Honduras,0,72,460,147,175,-75,285,W,0,1,0
2012-09-11 00:00:00.000000,Hungary,Netherlands,1,4,FIFA World Cup qualification,Budapest,Hungary,0,37,663,8,1044,29,-381,L,2,1,0
2012-09-11 00:00:00.000000,Israel,Russia,0,4,FIFA World Cup qualification,Ramat-Gan,Israel,0,75,446,13,990,62,-544,L,2,1,0
2012-09-11 00:00:00.000000,Italy,Malta,2,0,FIFA World Cup qualification,Modena,Italy,0,6,1174,139,206,-133,968,W,0,1,0
2012-09-11 00:00:00.000000,Japan,Iraq,1,0,FIFA World Cup qualification,Saitama,Japan,0,23,793,78,437,-55,356,W,0,1,0
2012-09-11 00:00:00.000000,Jordan,Australia,2,1,FIFA World Cup qualification,Amman,Jordan,0,87,402,25,778,62,-376,W,0,1,0
2012-09-11 00:00:00.000000,Lebanon,Iran,1,0,FIFA World Cup qualification,Beirut,Lebanon,0,124,271,54,573,70,-302,W,0,1,0
2012-09-11 00:00:00.000000,Liberia,Ghana,2,0,Friendly,Paynesville,Liberia,0,111,310,31,714,80,-404,W,0,1,0
2012-09-11 00:00:00.000000,Malaysia,Vietnam,0,2,Friendly,Shah Alam,Malaysia,0,156,136,146,183,10,-47,L,2,1,0
2012-09-11 00:00:00.000000,Mexico,Costa Rica,1,0,FIFA World Cup qualification,Mexico City,Mexico,0,21,845,66,487,-45,358,W,0,1,0
2012-09-11 00:00:00.000000,New Zealand,Solomon Islands,6,1,FIFA World Cup qualification,Auckland,New Zealand,0,95,366,153,150,-58,216,W,0,1,0
2012-09-11 00:00:00.000000,Northern Ireland,Luxembourg,1,1,FIFA World Cup qualification,Belfast,Northern Ireland,0,129,257,106,326,23,-69,D,1,1,0
2012-09-11 00:00:00.000000,Norway,Slovenia,2,1,FIFA World Cup qualification,Oslo,Norway,0,34,682,24,784,10,-102,W,0,1,0
2012-09-11 00:00:00.000000,Panama,Canada,2,0,FIFA World Cup qualification,Panama City,Panama,0,50,591,73,454,-23,137,W,0,1,0
2012-09-11 00:00:00.000000,Paraguay,Venezuela,0,2,FIFA World Cup qualification,Asunción,Paraguay,0,29,728,52,584,-23,144,L,2,1,0
2012-09-11 00:00:00.000000,Peru,Argentina,1,1,FIFA World Cup qualification,Lima,Peru,0,51,587,7,1121,44,-534,D,1,1,0
2012-09-11 00:00:00.000000,Poland,Moldova,2,0,FIFA World Cup qualification,Wrocław,Poland,0,56,547,141,204,-85,343,W,0,1,0
2012-09-11 00:00:00.000000,Portugal,Azerbaijan,3,0,FIFA World Cup qualification,Braga,Portugal,0,4,1232,107,324,-103,908,W,0,1,0
2012-09-11 00:00:00.000000,Romania,Andorra,4,0,FIFA World Cup qualification,Bucharest,Romania,0,57,542,199,15,-142,527,W,0,1,0
2012-09-11 00:00:00.000000,San Marino,Montenegro,0,6,FIFA World Cup qualification,Serravalle,San Marino,0,206,0,48,606,158,-606,L,2,1,0
2012-09-11 00:00:00.000000,Serbia,Wales,6,1,FIFA World Cup qualification,Novi Sad,Serbia,0,42,624,45,616,-3,8,W,0,1,0
2012-09-11 00:00:00.000000,Slovakia,Liechtenstein,2,0,FIFA World Cup qualification,Bratislava,Slovakia,0,45,616,149,168,-104,448,W,0,1,0
2012-09-11 00:00:00.000000,South Africa,Mozambique,2,0,Friendly,Nelspruit,South Africa,0,74,448,109,312,-35,136,W,0,1,0
2012-09-11 00:00:00.000000,Sweden,Kazakhstan,2,0,FIFA World Cup qualification,Malmö,Sweden,0,18,875,142,196,-124,679,W,0,1,0
2012-09-11 00:00:00.000000,Switzerland,Albania,2,0,FIFA World Cup qualification,Lucerne,Switzerland,0,20,847,84,410,-64,437,W,0,1,0
2012-09-11 00:00:00.000000,Tahiti,New Caledonia,0,4,FIFA World Cup qualification,Pirae,French Polynesia,1,119,282,128,261,-9,21,L,2,0,0
2012-09-11 00:00:00.000000,Turkey,Estonia,3,0,FIFA World Cup qualification,Istanbul,Turkey,0,35,678,55,572,-20,106,W,0,1,0
2012-09-11 00:00:00.000000,United Arab Emirates,Kuwait,3,0,Friendly,Dubai,United Arab Emirates,0,120,278,100,348,20,-70,W,0,1,0
2012-09-11 00:00:00.000000,Uruguay,Ecuador,1,1,FIFA World Cup qualification,Montevideo,Uruguay,0,5,1217,17,890,-12,327,D,1,1,0
2012-09-11 00:00:00.000000,USA,Jamaica,1,0,FIFA World Cup qualification,Columbus,USA,0,33,697,60,515,-27,182,W,0,1,0
2012-09-11 00:00:00.000000,Uzbekistan,Korea Republic,2,2,FIFA World Cup qualification,Tashkent,Uzbekistan,0,70,470,27,763,43,-293,D,1,1,0
2012-09-12 00:00:00.000000,Thailand,Laos,2,1,Friendly,Bangkok,Thailand,0,131,244,193,38,-62,206,W,0,1,0
2012-09-13 00:00:00.000000,Uganda,Zambia,1,0,African Cup of Nations qualification,Kampala,Uganda,0,88,401,42,624,46,-223,W,0,1,0
2012-09-14 00:00:00.000000,Equatorial Guinea,Congo DR,2,1,African Cup of Nations qualification,Malabo,Equatorial Guinea,0,107,324,110,311,-3,13,W,0,1,0
2012-09-19 00:00:00.000000,Brazil,Argentina,2,1,Friendly,Goiânia,Brazil,0,12,996,7,1121,5,-125,W,0,1,0
2012-09-20 00:00:00.000000,Nepal,Bangladesh,1,1,Friendly,Kathmandu,Nepal,0,166,121,170,103,-4,18,D,1,1,0
2012-09-23 00:00:00.000000,Aruba,Dominican Republic,2,2,CFU Caribbean Cup qualification,Bridgetown,Barbados,1,158,134,103,332,55,-198,D,1,0,0
2012-09-23 00:00:00.000000,Barbados,Dominica,1,0,CFU Caribbean Cup qualification,Bridgetown,Barbados,0,175,81,174,84,1,-3,W,0,1,0
2012-09-25 00:00:00.000000,Barbados,Dominican Republic,0,1,CFU Caribbean Cup qualification,Bridgetown,Barbados,0,175,81,103,332,72,-251,L,2,1,0
2012-09-25 00:00:00.000000,Dominica,Aruba,3,2,CFU Caribbean Cup qualification,Bridgetown,Barbados,1,174,84,158,134,16,-50,W,0,0,0
2012-09-25 00:00:00.000000,Philippines,Guam,1,0,Friendly,Manila,Philippines,0,150,167,185,45,-35,122,W,0,1,0
2012-09-26 00:00:00.000000,New Caledonia,Tahiti,0,1,African Nations Championship,Franconville,France,1,128,261,119,282,9,-21,L,2,0,0
2012-09-27 00:00:00.000000,Barbados,Aruba,2,1,CFU Caribbean Cup qualification,Bridgetown,Barbados,0,175,81,158,134,17,-53,W,0,1,0
2012-09-27 00:00:00.000000,Dominican Republic,Dominica,2,1,CFU Caribbean Cup qualification,Bridgetown,Barbados,1,103,332,174,84,-71,248,W,0,0,0
2012-09-27 00:00:00.000000,Philippines,Macau,5,0,Friendly,Manila,Philippines,0,150,167,200,13,-50,154,W,0,1,0
2012-09-28 00:00:00.000000,Oman,Yemen,2,1,Friendly,Muscat,Oman,0,93,376,152,154,-59,222,W,0,1,0
2012-09-29 00:00:00.000000,Macau,Guam,0,3,Friendly,Manila,Philippines,1,200,13,185,45,15,-32,L,2,0,0
2012-10-07 00:00:00.000000,Laos,Cambodia,1,0,AFF Championship,Rangoon,Burma,1,193,38,189,42,4,-4,W,0,0,0
2012-10-11 00:00:00.000000,Brazil,Iraq,6,0,Friendly,Malmö,Sweden,1,14,1001,80,439,-66,562,W,0,0,0
2012-10-11 00:00:00.000000,Kuwait,Syria,1,1,Friendly,Muscat,Oman,1,112,308,150,169,-38,139,D,1,0,0
2012-10-12 00:00:00.000000,Albania,Iceland,1,2,FIFA World Cup qualification,Tirana,Albania,0,84,414,97,362,-13,52,L,2,1,0
2012-10-12 00:00:00.000000,Antigua and Barbuda,USA,1,2,FIFA World Cup qualification,St. John's,Antigua and Barbuda,0,106,324,32,720,74,-396,L,2,1,0
2012-10-12 00:00:00.000000,Argentina,Uruguay,3,0,FIFA World Cup qualification,Mendoza,Argentina,0,4,1208,7,1140,-3,68,W,0,1,0
2012-10-12 00:00:00.000000,Armenia,Italy,1,3,FIFA World Cup qualification,Yerevan,Armenia,0,64,503,8,1106,56,-603,L,2,1,0
2012-10-12 00:00:00.000000,Bahrain,Philippines,0,0,Friendly,Arad,Bahrain,0,115,291,147,178,-32,113,D,1,1,0
2012-10-12 00:00:00.000000,Belarus,Spain,0,4,FIFA World Cup qualification,Minsk,Belarus,0,87,410,1,1611,86,-1201,L,2,1,0
2012-10-12 00:00:00.000000,Bolivia,Peru,1,1,FIFA World Cup qualification,La Paz,Bolivia,0,72,465,37,681,35,-216,D,1,1,0
2012-10-12 00:00:00.000000,Bulgaria,Denmark,1,1,FIFA World Cup qualification,Sofia,Bulgaria,0,55,565,18,944,37,-379,D,1,1,0
2012-10-12 00:00:00.000000,Canada,Cuba,3,0,FIFA World Cup qualification,Toronto,Canada,0,61,516,146,179,-85,337,W,0,1,0
2012-10-12 00:00:00.000000,Colombia,Paraguay,2,0,FIFA World Cup qualification,Barranquilla,Colombia,0,9,1102,38,665,-29,437,W,0,1,0
2012-10-12 00:00:00.000000,Czech Republic,Malta,3,1,FIFA World Cup qualification,Plzeň,Czech Republic,0,22,837,153,156,-131,681,W,0,1,0
2012-10-12 00:00:00.000000,Ecuador,Chile,3,1,FIFA World Cup qualification,Quito,Ecuador,0,20,902,17,948,3,-46,W,0,1,0
2012-10-12 00:00:00.000000,Egypt,Congo,3,0,Friendly,Sharjah,United Arab Emirates,1,40,634,94,374,-54,260,W,0,0,0
2012-10-12 00:00:00.000000,El Salvador,Costa Rica,0,1,FIFA World Cup qualification,San Salvador,El Salvador,0,78,441,72,465,6,-24,L,2,1,0
2012-10-12 00:00:00.000000,England,San Marino,5,0,FIFA World Cup qualification,London,England,0,5,1196,207,0,-202,1196,W,0,1,0
2012-10-12 00:00:00.000000,Estonia,Hungary,0,1,FIFA World Cup qualification,Tallinn,Estonia,0,69,485,49,593,20,-108,L,2,1,0
2012-10-12 00:00:00.000000,Faroe Islands,Sweden,1,2,FIFA World Cup qualification,Tórshavn,Faroe Islands,0,158,135,21,859,137,-724,L,2,1,0
2012-10-12 00:00:00.000000,Finland,Georgia,1,1,FIFA World Cup qualification,Helsinki,Finland,0,88,407,65,501,23,-94,D,1,1,0
2012-10-12 00:00:00.000000,France,Japan,0,1,Friendly,Saint-Denis,France,0,13,1011,23,818,-10,193,L,2,1,0
2012-10-12 00:00:00.000000,Guatemala,Jamaica,2,1,FIFA World Cup qualification,Guatemala,Guatemala,0,81,431,52,583,29,-152,W,0,1,0
2012-10-12 00:00:00.000000,Guyana,Mexico,0,5,FIFA World Cup qualification,Houston,USA,1,122,276,19,925,103,-649,L,2,0,0
2012-10-12 00:00:00.000000,Kazakhstan,Austria,0,0,FIFA World Cup qualification,Astana,Kazakhstan,0,147,178,59,528,88,-350,D,1,1,0
2012-10-12 00:00:00.000000,Lesotho,Swaziland,2,1,Friendly,Maseru,Lesotho,0,158,135,190,39,-32,96,W,0,1,0
2012-10-12 00:00:00.000000,Liechtenstein,Lithuania,0,2,FIFA World Cup qualification,Vaduz,Liechtenstein,0,155,150,110,311,45,-161,L,2,1,0
2012-10-12 00:00:00.000000,Luxembourg,Israel,0,6,FIFA World Cup qualification,Luxembourg,Luxembourg,0,142,191,82,423,60,-232,L,2,1,0
2012-10-12 00:00:00.000000,Moldova,Ukraine,0,0,FIFA World Cup qualification,Chişinău,Moldova,0,145,187,42,630,103,-443,D,1,1,0
2012-10-12 00:00:00.000000,Netherlands,Andorra,3,0,FIFA World Cup qualification,Rotterdam,Netherlands,0,6,1141,201,13,-195,1128,W,0,1,0
2012-10-12 00:00:00.000000,Panama,Honduras,0,0,FIFA World Cup qualification,Panama City,Panama,0,43,625,66,500,-23,125,D,1,1,0
2012-10-12 00:00:00.000000,Poland,South Africa,1,0,Friendly,Warsaw,Poland,0,54,573,76,448,-22,125,W,0,1,0
2012-10-12 00:00:00.000000,Russia,Portugal,1,0,FIFA World Cup qualification,Moscow,Russia,0,12,1014,3,1259,9,-245,W,0,1,0
2012-10-12 00:00:00.000000,Serbia,Belgium,0,3,FIFA World Cup qualification,Belgrade,Serbia,0,33,706,30,723,3,-17,L,2,1,0
2012-10-12 00:00:00.000000,Slovakia,Latvia,2,1,FIFA World Cup qualification,Bratislava,Slovakia,0,48,608,118,284,-70,324,W,0,1,0
2012-10-12 00:00:00.000000,Slovenia,Cyprus,2,1,FIFA World Cup qualification,Maribor,Slovenia,0,35,694,107,321,-72,373,W,0,1,0
2012-10-12 00:00:00.000000,Solomon Islands,New Caledonia,2,6,FIFA World Cup qualification,Honiara,Solomon Islands,0,141,202,113,303,28,-101,L,2,1,0
2012-10-12 00:00:00.000000,Switzerland,Norway,1,1,FIFA World Cup qualification,Berne,Switzerland,0,15,983,26,764,-11,219,D,1,1,0
2012-10-12 00:00:00.000000,Tahiti,New Zealand,0,2,FIFA World Cup qualification,Pirae,French Polynesia,1,127,265,92,390,35,-125,L,2,0,0
2012-10-12 00:00:00.000000,Turkey,Romania,0,1,FIFA World Cup qualification,Istanbul,Turkey,0,36,689,46,619,-10,70,L,2,1,0
2012-10-12 00:00:00.000000,United Arab Emirates,Uzbekistan,2,2,Friendly,Dubai,United Arab Emirates,0,116,288,70,479,46,-191,D,1,1,0
2012-10-12 00:00:00.000000,Wales,Scotland,2,1,FIFA World Cup qualification,Cardiff,Wales,0,57,551,56,556,1,-5,W,0,1,0
2012-10-13 00:00:00.000000,Namibia,Rwanda,0,0,Friendly,Windhoek,Namibia,0,108,318,124,272,-16,46,D,1,1,0
2012-10-14 00:00:00.000000,Lesotho,Swaziland,0,1,Friendly,Maseru,Lesotho,0,158,135,190,39,-32,96,L,2,1,0
2012-10-14 00:00:00.000000,Saudi Arabia,Congo,3,2,Friendly,al-Ahsa,Saudi Arabia,0,113,303,94,374,19,-71,W,0,1,0
2012-10-14 00:00:00.000000,Trinidad and Tobago,Anguilla,10,0,CFU Caribbean Cup qualification,Basseterre,St. Kitts and Nevis,1,77,442,204,4,-127,438,W,0,0,0
2012-10-16 00:00:00.000000,Albania,Slovenia,1,0,FIFA World Cup qualification,Tirana,Albania,0,84,414,35,694,49,-280,W,0,1,0
2012-10-16 00:00:00.000000,Andorra,Estonia,0,1,FIFA World Cup qualification,Sant Julià de Lòria,Andorra,0,201,13,69,485,132,-472,L,2,1,0
2012-10-16 00:00:00.000000,Austria,Kazakhstan,4,0,FIFA World Cup qualification,Vienna,Austria,0,59,528,147,178,-88,350,W,0,1,0
2012-10-16 00:00:00.000000,Belarus,Georgia,2,0,FIFA World Cup qualification,Minsk,Belarus,0,87,410,65,501,22,-91,W,0,1,0
2012-10-16 00:00:00.000000,Belgium,Scotland,2,0,FIFA World Cup qualification,Brussels,Belgium,0,30,723,56,556,-26,167,W,0,1,0
2012-10-16 00:00:00.000000,Bolivia,Uruguay,4,1,FIFA World Cup qualification,La Paz,Bolivia,0,72,465,7,1140,65,-675,W,0,1,0
2012-10-16 00:00:00.000000,Chile,Argentina,1,2,FIFA World Cup qualification,Santiago,Chile,0,17,948,4,1208,13,-260,L,2,1,0
2012-10-16 00:00:00.000000,Colombia,Cameroon,3,0,Friendly,Barranquilla,Colombia,0,9,1102,71,475,-62,627,W,0,1,0
2012-10-16 00:00:00.000000,Costa Rica,Guyana,7,0,FIFA World Cup qualification,San José,Costa Rica,0,72,465,122,276,-50,189,W,0,1,0
2012-10-16 00:00:00.000000,Croatia,Wales,2,0,FIFA World Cup qualification,Osijek,Croatia,0,11,1023,57,551,-46,472,W,0,1,0
2012-10-16 00:00:00.000000,Cuba,Panama,1,1,FIFA World Cup qualification,Havana,Cuba,0,146,179,43,625,103,-446,D,1,1,0
2012-10-16 00:00:00.000000,Cyprus,Norway,1,3,FIFA World Cup qualification,Larnaca,Cyprus,0,107,321,26,764,81,-443,L,2,1,0
2012-10-16 00:00:00.000000,Czech Republic,Bulgaria,0,0,FIFA World Cup qualification,Prague,Czech Republic,0,22,837,55,565,-33,272,D,1,1,0
2012-10-16 00:00:00.000000,Egypt,Tunisia,0,1,Friendly,Abu Dhabi,United Arab Emirates,1,40,634,45,620,-5,14,L,2,0,0
2012-10-16 00:00:00.000000,Germany,Sweden,4,4,FIFA World Cup qualification,Berlin,Germany,0,2,1459,21,859,-19,600,D,1,1,0
2012-10-16 00:00:00.000000,Honduras,Canada,8,1,FIFA World Cup qualification,San Pedro Sula,Honduras,0,66,500,61,516,5,-16,W,0,1,0
2012-10-16 00:00:00.000000,Hong Kong,Malaysia,0,3,Friendly,Kowloon,Hong Kong,0,160,133,162,126,-2,7,L,2,1,0
2012-10-16 00:00:00.000000,Hungary,Turkey,3,1,FIFA World Cup qualification,Budapest,Hungary,0,49,593,36,689,13,-96,W,0,1,0
2012-10-16 00:00:00.000000,Iceland,Switzerland,0,2,FIFA World Cup qualification,Reykjavík,Iceland,0,97,362,15,983,82,-621,L,2,1,0
2012-10-16 00:00:00.000000,Iran,Korea Republic,1,0,FIFA World Cup qualification,Teheran,Iran,0,58,549,25,776,33,-227,W,0,1,0
2012-10-16 00:00:00.000000,Iraq,Australia,1,2,FIFA World Cup qualification,Doha,Qatar,1,80,439,34,702,46,-263,L,2,0,0
2012-10-16 00:00:00.000000,Israel,Luxembourg,3,0,FIFA World Cup qualification,Ramat-Gan,Israel,0,82,423,142,191,-60,232,W,0,1,0
2012-10-16 00:00:00.000000,Italy,Denmark,3,1,FIFA World Cup qualification,Milan,Italy,0,8,1106,18,944,-10,162,W,0,1,0
2012-10-16 00:00:00.000000,Jamaica,Antigua and Barbuda,4,1,FIFA World Cup qualification,Kingston,Jamaica,0,52,583,106,324,-54,259,W,0,1,0
2012-10-16 00:00:00.000000,Japan,Brazil,0,4,Friendly,Wrocław,Poland,1,23,818,14,1001,9,-183,L,2,0,0
2012-10-16 00:00:00.000000,Kenya,South Africa,1,2,Friendly,Nairobi,Kenya,0,128,262,76,448,52,-186,L,2,1,0
2012-10-16 00:00:00.000000,Kuwait,Philippines,2,1,Friendly,Hawalli,Kuwait,0,112,308,147,178,-35,130,W,0,1,0
2012-10-16 00:00:00.000000,Latvia,Liechtenstein,2,0,FIFA World Cup qualification,Riga,Latvia,0,118,284,155,150,-37,134,W,0,1,0
2012-10-16 00:00:00.000000,Lebanon,Yemen,2,1,Friendly,Beirut,Lebanon,0,109,314,157,141,-48,173,W,0,1,0
2012-10-16 00:00:00.000000,Mexico,El Salvador,2,0,FIFA World Cup qualification,Torreón,Mexico,0,19,925,78,441,-59,484,W,0,1,0
2012-10-16 00:00:00.000000,New Caledonia,Solomon Islands,5,0,FIFA World Cup qualification,Nouméa,New Caledonia,0,113,303,141,202,-28,101,W,0,1,0
2012-10-16 00:00:00.000000,New Zealand,Tahiti,3,0,FIFA World Cup qualification,Christchurch,New Zealand,0,92,390,127,265,-35,125,W,0,1,0
2012-10-16 00:00:00.000000,Oman,Jordan,2,1,FIFA World Cup qualification,Muscat,Oman,0,95,370,78,441,17,-71,W,0,1,0
2012-10-16 00:00:00.000000,Paraguay,Peru,1,0,FIFA World Cup qualification,Asunción,Paraguay,0,38,665,37,681,1,-16,W,0,1,0
2012-10-16 00:00:00.000000,Portugal,Northern Ireland,1,1,FIFA World Cup qualification,Porto,Portugal,0,3,1259,117,287,-114,972,D,1,1,0
2012-10-16 00:00:00.000000,Qatar,Uzbekistan,0,1,FIFA World Cup qualification,Doha,Qatar,0,101,350,70,479,31,-129,L,2,1,0
2012-10-16 00:00:00.000000,Romania,Netherlands,1,4,FIFA World Cup qualification,Bucharest,Romania,0,46,619,6,1141,40,-522,L,2,1,0
2012-10-16 00:00:00.000000,Russia,Azerbaijan,1,0,FIFA World Cup qualification,Moscow,Russia,0,12,1014,111,309,-99,705,W,0,1,0
2012-10-16 00:00:00.000000,San Marino,Moldova,0,2,FIFA World Cup qualification,Serravalle,San Marino,0,207,0,145,187,62,-187,L,2,1,0
2012-10-16 00:00:00.000000,Singapore,India,2,0,Friendly,Choa Chu Kang,Singapore,0,162,126,168,114,-6,12,W,0,1,0
2012-10-16 00:00:00.000000,Slovakia,Greece,0,1,FIFA World Cup qualification,Bratislava,Slovakia,0,48,608,10,1029,38,-421,L,2,1,0
2012-10-16 00:00:00.000000,Spain,France,1,1,FIFA World Cup qualification,Madrid,Spain,0,1,1611,13,1011,-12,600,D,1,1,0
2012-10-16 00:00:00.000000,Ukraine,Montenegro,0,1,FIFA World Cup qualification,Kyïv,Ukraine,0,42,630,44,623,-2,7,L,2,1,0
2012-10-16 00:00:00.000000,United Arab Emirates,Bahrain,6,2,Friendly,Dubai,United Arab Emirates,0,116,288,115,291,1,-3,W,0,1,0
2012-10-16 00:00:00.000000,USA,Guatemala,3,1,FIFA World Cup qualification,Kansas City,USA,0,32,720,81,431,-49,289,W,0,1,0
2012-10-16 00:00:00.000000,Venezuela,Ecuador,0,0,FIFA World Cup qualification,Puerto la Cruz,Venezuela,0,39,635,20,902,19,-267,D,1,1,0
2012-10-16 00:00:00.000000,Vietnam,Indonesia,0,0,Friendly,Hanoi,Vietnam,0,140,203,170,111,-30,92,D,1,1,0
2012-10-17 00:00:00.000000,Poland,England,1,1,FIFA World Cup qualification,Warsaw,Poland,0,54,573,5,1196,49,-623,D,1,1,0
2012-10-21 00:00:00.000000,St. Lucia,Curaçao,5,1,CFU Caribbean Cup qualification,Gros Islet,St. Lucia,0,185,55,151,166,34,-111,W,0,1,0
2012-10-23 00:00:00.000000,Curaçao,Guyana,1,2,CFU Caribbean Cup qualification,Gros Islet,St. Lucia,1,151,166,122,276,29,-110,L,2,0,0
2012-10-24 00:00:00.000000,Vietnam,Turkmenistan,0,1,VFF Cup,Ho Chi Minh City,Vietnam,0,140,203,125,266,15,-63,L,2,1,0
2012-10-25 00:00:00.000000,St. Vincent and the Grenadines,Curaçao,4,0,CFU Caribbean Cup qualification,Gros Islet,St. Lucia,1,143,190,151,166,-8,24,W,0,0,0
2012-10-26 00:00:00.000000,Vietnam,Laos,4,0,VFF Cup,Ho Chi Minh City,Vietnam,0,140,203,193,38,-53,165,W,0,1,0
2012-10-27 00:00:00.000000,Puerto Rico,Dominican Republic,1,3,CFU Caribbean Cup qualification,Les Abymes,Guadeloupe,1,129,244,102,346,27,-102,L,2,0,0
2012-10-28 00:00:00.000000,Laos,Turkmenistan,2,4,VFF Cup,Ho Chi Minh City,Vietnam,1,193,38,125,266,68,-228,L,2,0,0
2012-11-03 00:00:00.000000,Vietnam,Malaysia,1,0,Friendly,Hanoi,Vietnam,0,140,203,162,126,-22,77,W,0,1,0
2012-11-07 00:00:00.000000,Thailand,Malaysia,2,0,Friendly,Nonthaburi,Thailand,0,152,160,163,127,-11,33,W,0,1,0
2012-11-08 00:00:00.000000,Bahrain,Jordan,3,0,Friendly,Arad,Bahrain,0,124,270,90,420,34,-150,W,0,1,0
2012-11-08 00:00:00.000000,Oman,Estonia,1,2,Friendly,Muscat,Oman,0,86,428,84,430,2,-2,L,2,1,0
2012-11-11 00:00:00.000000,Swaziland,Lesotho,0,0,Friendly,Lobamba,Swaziland,0,185,56,158,140,27,-84,D,1,1,0
2012-11-14 00:00:00.000000,Albania,Cameroon,0,0,Friendly,Geneva,Switzerland,1,67,496,62,520,5,-24,D,1,0,0
2012-11-14 00:00:00.000000,Andorra,Iceland,0,2,Friendly,Sant Julià de Lòria,Andorra,0,203,13,96,392,107,-379,L,2,1,0
2012-11-14 00:00:00.000000,Angola,Congo,1,1,Friendly,Estoril,Portugal,1,79,446,115,309,-36,137,D,1,0,0
2012-11-14 00:00:00.000000,Armenia,Lithuania,4,2,Friendly,Yerevan,Armenia,0,82,444,119,296,-37,148,W,0,1,0
2012-11-14 00:00:00.000000,Bolivia,Costa Rica,1,1,Friendly,Santa Cruz,Bolivia,0,51,585,64,509,-13,76,D,1,1,0
2012-11-14 00:00:00.000000,Brazil,Colombia,1,1,Friendly,East Rutherford,USA,1,13,994,8,1110,5,-116,D,1,0,0
2012-11-14 00:00:00.000000,Bulgaria,Ukraine,0,1,Friendly,Sofia,Bulgaria,0,40,627,55,575,-15,52,L,2,1,0
2012-11-14 00:00:00.000000,Congo DR,Burkina Faso,0,1,Friendly,Kinshasa,Congo DR,0,99,360,89,423,10,-63,L,2,1,0
2012-11-14 00:00:00.000000,Cuba,Suriname,5,0,CFU Caribbean Cup qualification,Bacolet,Trinidad and Tobago,1,141,198,125,265,16,-67,W,0,0,0
2012-11-14 00:00:00.000000,Cyprus,Finland,0,3,Friendly,Nicosia,Cyprus,0,127,258,91,411,36,-153,L,2,1,0
2012-11-14 00:00:00.000000,Czech Republic,Slovakia,3,0,Friendly,Olomouc,Czech Republic,0,25,806,43,619,-18,187,W,0,1,0
2012-11-14 00:00:00.000000,Gabon,Portugal,2,2,Friendly,Libreville,Gabon,0,52,581,4,1178,48,-597,D,1,1,0
2012-11-14 00:00:00.000000,Georgia,Egypt,0,0,Friendly,Tbilisi,Georgia,0,65,499,40,627,25,-128,D,1,1,0
2012-11-14 00:00:00.000000,Haiti,Guyana,1,0,CFU Caribbean Cup qualification,St. George's,Grenada,1,57,553,116,305,-59,248,W,0,0,0
2012-11-14 00:00:00.000000,Honduras,Peru,0,0,Friendly,Houston,USA,1,56,572,44,611,12,-39,D,1,0,0
2012-11-14 00:00:00.000000,Hungary,Norway,0,2,Friendly,Budapest,Hungary,0,30,753,26,778,4,-25,L,2,1,0
2012-11-14 00:00:00.000000,Iran,Uzbekistan,0,1,FIFA World Cup qualification,Teheran,Iran,0,44,611,69,490,-25,121,L,2,1,0
2012-11-14 00:00:00.000000,Iraq,Jordan,1,0,FIFA World Cup qualification,Doha,Qatar,1,97,390,90,420,7,-30,W,0,0,0
2012-11-14 00:00:00.000000,Israel,Belarus,1,2,Friendly,Jerusalem,Israel,0,78,452,74,478,4,-26,L,2,1,0
2012-11-14 00:00:00.000000,Italy,France,1,2,Friendly,Parma,Italy,0,5,1169,18,938,-13,231,L,2,1,0
2012-11-14 00:00:00.000000,Korea Republic,Australia,1,2,Friendly,Hwaseong,Korea Republic,0,32,728,33,719,-1,9,L,2,1,0
2012-11-14 00:00:00.000000,Kuwait,Bahrain,1,1,Friendly,Kuwait City,Kuwait,0,110,318,124,270,-14,48,D,1,1,0
2012-11-14 00:00:00.000000,Liechtenstein,Malta,0,1,Friendly,Vaduz,Liechtenstein,0,157,147,149,166,8,-19,L,2,1,0
2012-11-14 00:00:00.000000,Luxembourg,Scotland,1,2,Friendly,Luxembourg,Luxembourg,0,144,179,70,488,74,-309,L,2,1,0
2012-11-14 00:00:00.000000,Malaysia,Hong Kong,1,1,Friendly,Shah Alam,Malaysia,0,163,127,172,108,-9,19,D,1,1,0
2012-11-14 00:00:00.000000,Montenegro,San Marino,3,0,FIFA World Cup qualification,Podgorica,Montenegro,0,34,691,207,0,-173,691,W,0,1,0
2012-11-14 00:00:00.000000,Morocco,Togo,0,1,Friendly,Casablanca,Morocco,0,72,482,73,479,-1,3,L,2,1,0
2012-11-14 00:00:00.000000,Netherlands,Germany,0,0,Friendly,Amsterdam,Netherlands,0,7,1128,2,1421,5,-293,D,1,1,0
2012-11-14 00:00:00.000000,Niger,Senegal,1,1,Friendly,Niamey,Niger,0,107,324,75,471,32,-147,D,1,1,0
2012-11-14 00:00:00.000000,Northern Ireland,Azerbaijan,1,1,FIFA World Cup qualification,Belfast,Northern Ireland,0,100,356,123,277,-23,79,D,1,1,0
2012-11-14 00:00:00.000000,Oman,Japan,1,2,FIFA World Cup qualification,Muscat,Oman,0,86,428,24,810,62,-382,L,2,1,0
2012-11-14 00:00:00.000000,Panama,Spain,1,5,Friendly,Panama City,Panama,0,46,609,1,1564,45,-955,L,2,1,0
2012-11-14 00:00:00.000000,Paraguay,Guatemala,3,1,Friendly,Luque,Paraguay,0,35,690,76,467,-41,223,W,0,1,0
2012-11-14 00:00:00.000000,Poland,Uruguay,1,3,Friendly,Gdańsk,Poland,0,54,579,11,1047,43,-468,L,2,1,0
2012-11-14 00:00:00.000000,Qatar,Lebanon,1,0,FIFA World Cup qualification,Doha,Qatar,0,104,330,112,313,-8,17,W,0,1,0
2012-11-14 00:00:00.000000,Romania,Belgium,2,1,Friendly,Bucharest,Romania,0,37,669,20,881,17,-212,W,0,1,0
2012-11-14 00:00:00.000000,Russia,USA,2,2,Friendly,Krasnodar,Russia,0,9,1084,27,776,-18,308,D,1,1,0
2012-11-14 00:00:00.000000,Rwanda,Namibia,2,2,Friendly,Kigali,Rwanda,0,122,280,117,299,5,-19,D,1,1,0
2012-11-14 00:00:00.000000,Saudi Arabia,Argentina,0,0,Friendly,Riyadh,Saudi Arabia,0,112,313,3,1349,109,-1036,D,1,1,0
2012-11-14 00:00:00.000000,Serbia,Chile,3,1,Friendly,St. Gallen,Switzerland,1,42,626,21,853,21,-227,W,0,0,0
2012-11-14 00:00:00.000000,South Africa,Zambia,0,1,Friendly,Johannesburg,South Africa,0,84,430,39,633,45,-203,L,2,1,0
2012-11-14 00:00:00.000000,Sweden,England,4,2,Friendly,Solna,Sweden,0,23,826,6,1167,17,-341,W,0,1,0
2012-11-14 00:00:00.000000,Tanzania,Kenya,1,0,Friendly,Mwanza,Tanzania,0,134,237,130,248,4,-11,W,0,1,0
2012-11-14 00:00:00.000000,Thailand,Bhutan,5,0,Friendly,Bangkok,Thailand,0,152,160,207,0,-55,160,W,0,1,0
2012-11-14 00:00:00.000000,Tunisia,Switzerland,1,2,Friendly,Sousse,Tunisia,0,46,609,16,966,30,-357,L,2,1,0
2012-11-14 00:00:00.000000,Turkey,Denmark,1,1,Friendly,Istanbul,Turkey,0,38,639,22,851,16,-212,D,1,1,0
2012-11-14 00:00:00.000000,United Arab Emirates,Estonia,2,1,Friendly,Abu Dhabi,United Arab Emirates,0,109,320,84,430,25,-110,W,0,1,0
2012-11-14 00:00:00.000000,Venezuela,Nigeria,1,3,Friendly,Miami,USA,1,48,600,57,553,-9,47,L,2,0,0
2012-11-15 00:00:00.000000,Philippines,Singapore,1,0,Friendly,Cebu City,Philippines,0,143,184,163,127,-20,57,W,0,1,0
2012-11-16 00:00:00.000000,Trinidad and Tobago,Suriname,3,0,CFU Caribbean Cup qualification,Bacolet,Trinidad and Tobago,0,79,446,125,265,-46,181,W,0,1,0
2012-11-17 00:00:00.000000,Indonesia,Cameroon,0,0,Friendly,Jakarta,Indonesia,0,165,124,62,520,103,-396,D,1,1,0
2012-11-17 00:00:00.000000,Palestine,Syria,1,1,Friendly,Amman,Jordan,1,148,168,147,172,1,-4,D,1,0,0
2012-11-17 00:00:00.000000,Thailand,Bangladesh,5,0,Friendly,Bangkok,Thailand,0,152,160,171,114,-19,46,W,0,1,0
2012-11-19 00:00:00.000000,Singapore,Pakistan,4,0,Friendly,Jurong,Singapore,0,163,127,180,72,-17,55,W,0,1,0
2012-11-20 00:00:00.000000,Malaysia,Bangladesh,1,1,Friendly,Kuala Lumpur,Malaysia,0,163,127,171,114,-8,13,D,1,1,0
2012-11-20 00:00:00.000000,Palestine,Syria,2,1,Friendly,Zarqa,Jordan,1,148,168,147,172,1,-4,W,0,0,0
2012-11-21 00:00:00.000000,Argentina,Brazil,2,1,Friendly,Buenos Aires,Argentina,0,3,1349,13,994,-10,355,W,0,1,0
2012-11-24 00:00:00.000000,Ethiopia,South Sudan,1,0,CECAFA Cup,Kampala,Uganda,1,102,333,200,20,-98,313,W,0,0,0
2012-11-24 00:00:00.000000,Thailand,Philippines,2,1,AFF Championship,Bangkok,Thailand,0,152,160,143,184,9,-24,W,0,1,0
2012-11-24 00:00:00.000000,Uganda,Kenya,1,0,CECAFA Cup,Kampala,Uganda,0,86,428,130,248,-44,180,W,0,1,0
2012-11-25 00:00:00.000000,Burundi,Somalia,5,1,CECAFA Cup,Kampala,Uganda,1,128,255,193,43,-65,212,W,0,0,0
2012-11-25 00:00:00.000000,Indonesia,Laos,2,2,AFF Championship,Kuala Lumpur,Malaysia,1,165,124,177,87,-12,37,D,1,0,0
2012-11-25 00:00:00.000000,Malaysia,Singapore,0,3,AFF Championship,Kuala Lumpur,Malaysia,0,163,127,163,127,0,0,L,2,1,0
2012-11-25 00:00:00.000000,Tanzania,Sudan,2,0,CECAFA Cup,Kampala,Uganda,1,134,237,102,333,32,-96,W,0,0,0
2012-11-26 00:00:00.000000,Rwanda,Malawi,2,0,CECAFA Cup,Kampala,Uganda,1,122,280,101,337,21,-57,W,0,0,0
2012-11-27 00:00:00.000000,South Sudan,Kenya,0,2,CECAFA Cup,Kampala,Uganda,1,200,20,130,248,70,-228,L,2,0,0
2012-11-27 00:00:00.000000,Uganda,Ethiopia,1,0,CECAFA Cup,Kampala,Uganda,0,86,428,102,333,-16,95,W,0,1,0
2012-11-27 00:00:00.000000,Vietnam,Philippines,0,1,AFF Championship,Bangkok,Thailand,1,138,217,143,184,-5,33,L,2,0,0
2012-11-28 00:00:00.000000,Indonesia,Singapore,1,0,AFF Championship,Kuala Lumpur,Malaysia,1,165,124,163,127,2,-3,W,0,0,0
2012-11-28 00:00:00.000000,Malaysia,Laos,4,1,AFF Championship,Kuala Lumpur,Malaysia,0,163,127,177,87,-14,40,W,0,1,0
2012-11-28 00:00:00.000000,Somalia,Sudan,0,1,CECAFA Cup,Kampala,Uganda,1,193,43,102,333,91,-290,L,2,0,0
2012-11-28 00:00:00.000000,Tanzania,Burundi,0,1,CECAFA Cup,Kampala,Uganda,1,134,237,128,255,6,-18,L,2,0,0
2012-11-29 00:00:00.000000,Malawi,Eritrea,3,2,CECAFA Cup,Kampala,Uganda,1,101,337,192,45,-91,292,W,0,0,0
2012-11-29 00:00:00.000000,Palestine,Bahrain,0,2,Friendly,al-Wakrah,Qatar,1,148,168,124,270,24,-102,L,2,0,0
2012-11-30 00:00:00.000000,Kenya,Ethiopia,3,1,CECAFA Cup,Kampala,Uganda,1,130,248,102,333,28,-85,W,0,0,0
2012-11-30 00:00:00.000000,Thailand,Vietnam,3,1,AFF Championship,Bangkok,Thailand,0,152,160,138,217,14,-57,W,0,1,0
2012-11-30 00:00:00.000000,Uganda,South Sudan,4,0,CECAFA Cup,Kampala,Uganda,0,86,428,200,20,-114,408,W,0,1,0
2012-12-01 00:00:00.000000,Burkina Faso,Togo,2,1,African Nations Championship,Ouagadougou,Burkina Faso,0,89,423,73,479,16,-56,W,0,1,0
2012-12-01 00:00:00.000000,Eritrea,Rwanda,0,2,CECAFA Cup,Kampala,Uganda,1,192,45,122,280,70,-235,L,2,0,0
2012-12-01 00:00:00.000000,Hong Kong,Guam,2,1,EAFF Championship,Kowloon,Hong Kong,0,172,108,181,71,-9,37,W,0,1,0
2012-12-01 00:00:00.000000,Malaysia,Indonesia,2,0,AFF Championship,Kuala Lumpur,Malaysia,0,163,127,165,124,-2,3,W,0,1,0
2012-12-01 00:00:00.000000,Mauritius,Comoros,2,0,African Nations Championship,Curepipe,Mauritius,0,203,13,196,36,7,-23,W,0,1,0
2012-12-01 00:00:00.000000,Singapore,Laos,4,3,AFF Championship,Shah Alam,Malaysia,1,163,127,177,87,-14,40,W,0,0,0
2012-12-01 00:00:00.000000,Somalia,Tanzania,0,7,CECAFA Cup,Kampala,Uganda,1,193,43,134,237,59,-194,L,2,0,0
2012-12-01 00:00:00.000000,Sudan,Burundi,0,1,CECAFA Cup,Kampala,Uganda,1,102,333,128,255,-26,78,L,2,0,0
2012-12-02 00:00:00.000000,Guinea,Sierra Leone,0,0,African Nations Championship,Conakry,Guinea,0,71,485,61,521,10,-36,D,1,1,0
2012-12-02 00:00:00.000000,Liberia,Mauritania,0,1,African Nations Championship,Paynesville,Liberia,0,114,312,206,3,-92,309,L,2,1,0
2012-12-02 00:00:00.000000,Mozambique,Seychelles,4,0,African Nations Championship,Maputo,Mozambique,0,110,318,194,39,-84,279,W,0,1,0
2012-12-03 00:00:00.000000,Hong Kong,Australia,0,1,EAFF Championship,Kowloon,Hong Kong,0,172,108,33,719,139,-611,L,2,1,0
2012-12-03 00:00:00.000000,Korea DPR,Guam,5,0,EAFF Championship,Kowloon,Hong Kong,1,81,445,181,71,-100,374,W,0,0,0
2012-12-03 00:00:00.000000,Rwanda,Tanzania,0,2,CECAFA Cup,Kampala,Uganda,1,122,280,134,237,-12,43,L,2,0,0
2012-12-04 00:00:00.000000,Kenya,Malawi,1,0,CECAFA Cup,Kampala,Uganda,1,130,248,101,337,29,-89,W,0,0,0
2012-12-04 00:00:00.000000,Uganda,Ethiopia,2,0,CECAFA Cup,Kampala,Uganda,0,86,428,102,333,-16,95,W,0,1,0
2012-12-05 00:00:00.000000,Korea DPR,Australia,1,1,EAFF Championship,So Kon Po,Hong Kong,1,81,445,33,719,48,-274,D,1,0,0
2012-12-06 00:00:00.000000,Uganda,Tanzania,3,0,CECAFA Cup,Kampala,Uganda,0,86,428,134,237,-48,191,W,0,1,0
2012-12-07 00:00:00.000000,Antigua and Barbuda,Dominican Republic,1,2,CFU Caribbean Cup,St. John's,Antigua and Barbuda,0,121,281,92,406,29,-125,L,2,1,0
2012-12-07 00:00:00.000000,Guam,Australia,0,9,EAFF Championship,So Kon Po,Hong Kong,1,181,71,33,719,148,-648,L,2,0,0
2012-12-07 00:00:00.000000,Haiti,Trinidad and Tobago,0,0,CFU Caribbean Cup,St. John's,Antigua and Barbuda,1,57,553,79,446,-22,107,D,1,0,0
2012-12-08 00:00:00.000000,Kuwait,Palestine,2,1,WAFF Championship,Kuwait City,Kuwait,0,110,318,148,168,-38,150,W,0,1,0
2012-12-08 00:00:00.000000,Oman,Lebanon,0,1,WAFF Championship,al-Farwaniyah,Kuwait,1,86,428,112,313,-26,115,L,2,0,0
2012-12-08 00:00:00.000000,Philippines,Singapore,0,0,AFF Championship,Manila,Philippines,0,143,184,163,127,-20,57,D,1,1,0
2012-12-08 00:00:00.000000,Uganda,Kenya,2,1,CECAFA Cup,Kampala,Uganda,0,86,428,130,248,-44,180,W,0,1,0
2012-12-09 00:00:00.000000,Antigua and Barbuda,Trinidad and Tobago,2,0,CFU Caribbean Cup,St. John's,Antigua and Barbuda,0,121,281,79,446,42,-165,W,0,1,0
2012-12-09 00:00:00.000000,Bahrain,Yemen,1,0,WAFF Championship,al-Farwaniyah,Kuwait,1,124,270,162,131,-38,139,W,0,0,0
2012-12-09 00:00:00.000000,Dominican Republic,Haiti,1,2,CFU Caribbean Cup,St. John's,Antigua and Barbuda,1,92,406,57,553,35,-147,L,2,0,0
2012-12-09 00:00:00.000000,Hong Kong,Korea DPR,0,4,EAFF Championship,So Kon Po,Hong Kong,0,172,108,81,445,91,-337,L,2,1,0
2012-12-09 00:00:00.000000,Iran,Saudi Arabia,0,0,WAFF Championship,Kuwait City,Kuwait,1,44,611,112,313,-68,298,D,1,0,0
2012-12-09 00:00:00.000000,Malaysia,Thailand,1,1,AFF Championship,Kuala Lumpur,Malaysia,0,163,127,152,160,11,-33,D,1,1,0
2012-12-10 00:00:00.000000,Iraq,Jordan,1,0,WAFF Championship,al-Farwaniyah,Kuwait,1,97,390,90,420,7,-30,W,0,0,0
2012-12-11 00:00:00.000000,Antigua and Barbuda,Haiti,0,1,CFU Caribbean Cup,St. John's,Antigua and Barbuda,0,121,281,57,553,64,-272,L,2,1,0
2012-12-11 00:00:00.000000,Kuwait,Oman,0,2,WAFF Championship,Kuwait City,Kuwait,0,110,318,86,428,24,-110,L,2,1,0
2012-12-11 00:00:00.000000,Lebanon,Palestine,0,1,WAFF Championship,al-Farwaniyah,Kuwait,1,112,313,148,168,-36,145,L,2,0,0
2012-12-11 00:00:00.000000,Trinidad and Tobago,Dominican Republic,2,1,CFU Caribbean Cup,St. John's,Antigua and Barbuda,1,79,446,92,406,-13,40,W,0,0,0
2012-12-12 00:00:00.000000,Iran,Bahrain,0,0,WAFF Championship,Kuwait City,Kuwait,1,44,611,124,270,-80,341,D,1,0,0
2012-12-12 00:00:00.000000,Jamaica,Cuba,0,1,CFU Caribbean Cup,North Sound,Antigua and Barbuda,1,50,586,141,198,-91,388,L,2,0,0
2012-12-12 00:00:00.000000,Singapore,Philippines,1,0,AFF Championship,Singapore,Singapore,0,163,127,143,184,20,-57,W,0,1,0
2012-12-12 00:00:00.000000,Yemen,Saudi Arabia,0,1,WAFF Championship,al-Farwaniyah,Kuwait,1,162,131,112,313,50,-182,L,2,0,0
2012-12-13 00:00:00.000000,Iraq,Syria,1,1,WAFF Championship,Kuwait City,Kuwait,1,97,390,147,172,-50,218,D,1,0,0
2012-12-13 00:00:00.000000,Thailand,Malaysia,2,0,AFF Championship,Bangkok,Thailand,0,152,160,163,127,-11,33,W,0,1,0
2012-12-14 00:00:00.000000,Haiti,Cuba,0,1,CFU Caribbean Cup,St. John's,Antigua and Barbuda,1,57,553,141,198,-84,355,L,2,0,0
2012-12-14 00:00:00.000000,Kuwait,Lebanon,2,1,WAFF Championship,Kuwait City,Kuwait,0,110,318,112,313,-2,5,W,0,1,0
2012-12-14 00:00:00.000000,Oman,Palestine,2,1,WAFF Championship,al-Farwaniyah,Kuwait,1,86,428,148,168,-62,260,W,0,0,0
2012-12-15 00:00:00.000000,Angola,Gambia,1,1,Friendly,Benguela,Angola,0,79,446,142,186,-63,260,D,1,1,0
2012-12-15 00:00:00.000000,Bahrain,Saudi Arabia,1,0,WAFF Championship,al-Farwaniyah,Kuwait,1,124,270,112,313,12,-43,W,0,0,0
2012-12-15 00:00:00.000000,Comoros,Mauritius,0,0,African Nations Championship,Mitsamiouli,Comoros,0,196,36,203,13,-7,23,D,1,1,0
2012-12-15 00:00:00.000000,Iran,Yemen,2,1,WAFF Championship,Kuwait City,Kuwait,1,44,611,162,131,-118,480,W,0,0,0
2012-12-15 00:00:00.000000,Mauritania,Liberia,2,1,African Nations Championship,Nouakchott,Mauritania,0,206,3,114,312,92,-309,W,0,1,0
2012-12-15 00:00:00.000000,Seychelles,Mozambique,1,2,African Nations Championship,Roche Caiman,Seychelles,0,194,39,110,318,84,-279,L,2,1,0
2012-12-15 00:00:00.000000,Sierra Leone,Guinea,1,1,African Nations Championship,Freetown,Sierra Leone,0,61,521,71,485,-10,36,D,1,1,0
2012-12-16 00:00:00.000000,Burundi,Kenya,1,0,African Nations Championship,Bujumbura,Burundi,0,128,255,130,248,-2,7,W,0,1,0
2012-12-16 00:00:00.000000,Cuba,Trinidad and Tobago,1,0,CFU Caribbean Cup,St. John's,Antigua and Barbuda,1,141,198,79,446,62,-248,W,0,0,0
2012-12-16 00:00:00.000000,Syria,Jordan,2,1,WAFF Championship,Kuwait City,Kuwait,1,147,172,90,420,57,-248,W,0,0,0
2012-12-16 00:00:00.000000,Togo,Burkina Faso,0,1,African Nations Championship,Lomé,Togo,0,73,479,89,423,-16,56,L,2,1,0
2012-12-19 00:00:00.000000,Oman,Benin,2,0,Friendly,Sur,Oman,0,95,369,75,457,20,-88,W,0,1,0
2012-12-19 00:00:00.000000,Singapore,Thailand,3,1,AFF Championship,Singapore,Singapore,0,154,146,136,233,18,-87,W,0,1,0
2012-12-20 00:00:00.000000,Iraq,Syria,0,1,WAFF Championship,Kuwait City,Kuwait,1,92,385,144,186,-52,199,L,2,0,0
2012-12-20 00:00:00.000000,Oman,Bahrain,1,0,WAFF Championship,Kuwait City,Kuwait,1,95,369,119,275,-24,94,W,0,0,0
2012-12-22 00:00:00.000000,Angola,Rwanda,1,0,Friendly,Luanda,Angola,0,84,428,134,246,-50,182,W,0,1,0
2012-12-22 00:00:00.000000,South Africa,Malawi,3,1,Friendly,Durban,South Africa,0,87,416,111,318,-24,98,W,0,1,0
2012-12-22 00:00:00.000000,Tanzania,Zambia,1,0,Friendly,Dar es Salaam,Tanzania,0,130,253,34,697,96,-444,W,0,1,0
2012-12-22 00:00:00.000000,Thailand,Singapore,1,0,AFF Championship,Bangkok,Thailand,0,136,233,154,146,-18,87,W,0,1,0
2012-12-25 00:00:00.000000,United Arab Emirates,Yemen,2,0,Friendly,Doha,Qatar,1,96,367,164,108,-68,259,W,0,0,0
2012-12-26 00:00:00.000000,Bahrain,Burkina Faso,0,0,Friendly,Riffa,Bahrain,0,119,275,89,408,30,-133,D,1,1,0
2012-12-28 00:00:00.000000,Qatar,Egypt,0,2,Friendly,Doha,Qatar,0,98,365,41,615,57,-250,L,2,1,0
2012-12-29 00:00:00.000000,Bahrain,Guinea,3,0,Friendly,Riffa,Bahrain,0,119,275,60,527,59,-252,W,0,1,0
2012-12-29 00:00:00.000000,Oman,Togo,0,1,Friendly,Sohar,Oman,0,95,369,71,491,24,-122,L,2,1,0
2012-12-29 00:00:00.000000,United Arab Emirates,Yemen,3,1,Friendly,Doha,Qatar,1,96,367,164,108,-68,259,W,0,0,0
2012-12-30 00:00:00.000000,Ethiopia,Niger,1,0,Friendly,Addis Ababa,Ethiopia,0,110,323,105,335,5,-12,W,0,1,0
2012-12-30 00:00:00.000000,Iraq,Tunisia,1,2,Friendly,Baghdad,Iraq,0,92,385,45,606,47,-221,L,2,1,0
2013-01-05 00:00:00.000000,Bahrain,Oman,0,0,Gulf Cup,Riffa,Bahrain,0,119,275,95,369,24,-94,D,1,1,0
2013-01-05 00:00:00.000000,Niger,Togo,3,1,Friendly,Niamey,Niger,0,105,335,71,491,34,-156,W,0,1,0
2013-01-05 00:00:00.000000,Qatar,United Arab Emirates,1,3,Gulf Cup,Riffa,Bahrain,1,98,365,96,367,2,-2,L,2,0,0
2013-01-05 00:00:00.000000,Zambia,Angola,0,2,Friendly,Johannesburg,South Africa,1,34,697,84,428,-50,269,L,2,0,0
2013-01-06 00:00:00.000000,Kenya,Burundi,0,0,African Nations Championship,Nairobi,Kenya,0,134,246,104,342,30,-96,D,1,1,0
2013-01-06 00:00:00.000000,Kuwait,Yemen,2,0,Gulf Cup,Isa Town,Bahrain,1,117,281,164,108,-47,173,W,0,0,0
2013-01-06 00:00:00.000000,Saudi Arabia,Iraq,0,2,Gulf Cup,Isa Town,Bahrain,1,126,264,92,385,34,-121,L,2,0,0
2013-01-07 00:00:00.000000,Tunisia,Ethiopia,1,1,Friendly,al-Wakrah,Qatar,1,45,606,110,323,-65,283,D,1,0,0
2013-01-08 00:00:00.000000,Bahrain,United Arab Emirates,1,2,Gulf Cup,Riffa,Bahrain,0,119,275,96,367,23,-92,L,2,1,0
2013-01-08 00:00:00.000000,Qatar,Oman,2,1,Gulf Cup,Riffa,Bahrain,1,98,365,95,369,3,-4,W,0,0,0
2013-01-08 00:00:00.000000,South Africa,Norway,0,1,Friendly,Cape Town,South Africa,0,87,416,24,810,63,-394,L,2,1,0
2013-01-08 00:00:00.000000,Zambia,Morocco,0,0,Friendly,Johannesburg,South Africa,1,34,697,74,466,-40,231,D,1,0,0
2013-01-09 00:00:00.000000,Iraq,Kuwait,1,0,Gulf Cup,Isa Town,Bahrain,1,92,385,117,281,-25,104,W,0,0,0
2013-01-09 00:00:00.000000,Yemen,Saudi Arabia,0,2,Gulf Cup,Isa Town,Bahrain,1,164,108,126,264,38,-156,L,2,0,0
2013-01-10 00:00:00.000000,Gabon,Tunisia,1,1,Friendly,Abu Dhabi,United Arab Emirates,1,42,609,45,606,-3,3,D,1,0,0
2013-01-10 00:00:00.000000,Ghana,Egypt,3,0,Friendly,Abu Dhabi,United Arab Emirates,1,30,777,41,615,-11,162,W,0,0,0
2013-01-10 00:00:00.000000,Panama,Guatemala,3,0,Friendly,Panama City,Panama,0,51,582,80,438,-29,144,W,0,1,0
2013-01-11 00:00:00.000000,Bahrain,Qatar,1,0,Gulf Cup,Riffa,Bahrain,0,119,275,98,365,21,-90,W,0,1,0
2013-01-11 00:00:00.000000,Ethiopia,Tanzania,2,1,Friendly,Addis Ababa,Ethiopia,0,110,323,130,253,-20,70,W,0,1,0
2013-01-11 00:00:00.000000,United Arab Emirates,Oman,2,0,Gulf Cup,Isa Town,Bahrain,1,96,367,95,369,1,-2,W,0,0,0
2013-01-12 00:00:00.000000,Iraq,Yemen,2,0,Gulf Cup,Isa Town,Bahrain,1,92,385,164,108,-72,277,W,0,0,0
2013-01-12 00:00:00.000000,Kuwait,Saudi Arabia,1,0,Gulf Cup,Riffa,Bahrain,1,117,281,126,264,-9,17,W,0,0,0
2013-01-12 00:00:00.000000,Namibia,Morocco,1,2,Friendly,Johannesburg,South Africa,1,121,274,74,466,47,-192,L,2,0,0
2013-01-12 00:00:00.000000,South Africa,Algeria,0,0,Friendly,Johannesburg,South Africa,0,87,416,19,887,68,-471,D,1,1,0
2013-01-12 00:00:00.000000,Zambia,Norway,0,0,Friendly,Ndola,Zambia,0,34,697,24,810,10,-113,D,1,1,0
2013-01-13 00:00:00.000000,Angola,Botswana,2,0,Friendly,Johannesburg,South Africa,1,84,428,121,274,-37,154,W,0,0,0
2013-01-13 00:00:00.000000,Ghana,Tunisia,4,2,Friendly,Abu Dhabi,United Arab Emirates,1,30,777,45,606,-15,171,W,0,0,0
2013-01-13 00:00:00.000000,Panama,Guatemala,2,0,Friendly,Panama City,Panama,0,51,582,80,438,-29,144,W,0,1,0
2013-01-13 00:00:00.000000,Togo,Niger,2,1,Friendly,Lomé,Togo,0,71,491,105,335,-34,156,W,0,1,0
2013-01-15 00:00:00.000000,Bahrain,Iraq,1,1,Gulf Cup,Riffa,Bahrain,0,119,275,92,385,27,-110,D,1,1,0
2013-01-15 00:00:00.000000,Lebanon,Gabon,0,0,Friendly,Sidon,Lebanon,0,127,259,42,609,85,-350,D,1,1,0
2013-01-15 00:00:00.000000,United Arab Emirates,Kuwait,1,0,Gulf Cup,Riffa,Bahrain,1,96,367,117,281,-21,86,W,0,0,0
2013-01-17 00:00:00.000000,Swaziland,Burkina Faso,0,3,Friendly,Nelspruit,South Africa,1,178,61,92,389,86,-328,L,2,0,0
2013-01-18 00:00:00.000000,Bahrain,Kuwait,1,6,Gulf Cup,Isa Town,Bahrain,0,117,282,120,276,-3,6,L,2,1,0
2013-01-18 00:00:00.000000,Costa Rica,Belize,1,0,UNCAF Cup,San José,Costa Rica,0,66,515,164,110,-98,405,W,0,1,0
2013-01-18 00:00:00.000000,Guatemala,Nicaragua,1,1,UNCAF Cup,San José,Costa Rica,1,87,412,145,192,-58,220,D,1,0,0
2013-01-18 00:00:00.000000,Honduras,El Salvador,1,1,UNCAF Cup,San José,Costa Rica,1,59,543,96,374,-37,169,D,1,0,0
2013-01-18 00:00:00.000000,United Arab Emirates,Iraq,2,1,Gulf Cup,Riffa,Bahrain,1,103,346,89,392,14,-46,W,0,0,0
2013-01-19 00:00:00.000000,Angola,Morocco,0,0,African Cup of Nations,Johannesburg,South Africa,1,78,443,74,461,4,-18,D,1,0,0
2013-01-19 00:00:00.000000,Chile,Haiti,3,0,Friendly,Concepción,Chile,0,30,774,38,650,-8,124,W,0,1,0
2013-01-20 00:00:00.000000,Belize,Guatemala,0,0,UNCAF Cup,San José,Costa Rica,1,164,110,87,412,77,-302,D,1,0,0
2013-01-20 00:00:00.000000,Costa Rica,Nicaragua,2,0,UNCAF Cup,San José,Costa Rica,0,66,515,145,192,-79,323,W,0,1,0
2013-01-20 00:00:00.000000,El Salvador,Panama,0,0,UNCAF Cup,San José,Costa Rica,1,96,374,46,594,50,-220,D,1,0,0
2013-01-20 00:00:00.000000,Ghana,Congo DR,2,2,African Cup of Nations,Port Elizabeth,South Africa,1,26,788,101,355,-75,433,D,1,0,0
2013-01-20 00:00:00.000000,Mali,Niger,1,0,African Cup of Nations,Port Elizabeth,South Africa,1,25,807,97,371,-72,436,W,0,0,0
2013-01-21 00:00:00.000000,Nigeria,Burkina Faso,1,1,African Cup of Nations,Nelspruit,South Africa,1,52,573,92,389,-40,184,D,1,0,0
2013-01-21 00:00:00.000000,Zambia,Ethiopia,1,1,African Cup of Nations,Nelspruit,South Africa,1,39,646,110,316,-71,330,D,1,0,0
2013-01-22 00:00:00.000000,Costa Rica,Guatemala,1,1,UNCAF Cup,San José,Costa Rica,0,66,515,87,412,-21,103,D,1,1,0
2013-01-22 00:00:00.000000,Nicaragua,Belize,1,2,UNCAF Cup,San José,Costa Rica,1,145,192,164,110,-19,82,L,2,0,0
2013-01-22 00:00:00.000000,Panama,Honduras,1,1,UNCAF Cup,San José,Costa Rica,1,46,594,59,543,-13,51,D,1,0,0
2013-01-22 00:00:00.000000,Tunisia,Algeria,1,0,African Cup of Nations,Rustenburg,South Africa,1,53,570,22,829,31,-259,W,0,0,0
2013-01-23 00:00:00.000000,South Africa,Angola,2,0,African Cup of Nations,Durban,South Africa,0,85,423,78,443,7,-20,W,0,1,0
2013-01-23 00:00:00.000000,Sweden,Korea DPR,1,1,King's Cup,Chiang Mai,Thailand,1,19,870,99,363,-80,507,D,1,0,0
2013-01-23 00:00:00.000000,Thailand,Finland,1,3,King's Cup,Chiang Mai,Thailand,0,138,228,84,431,54,-203,L,2,1,0
2013-01-24 00:00:00.000000,Ghana,Mali,1,0,African Cup of Nations,Port Elizabeth,South Africa,1,26,788,25,807,1,-19,W,0,0,0
2013-01-24 00:00:00.000000,Niger,Congo DR,0,0,African Cup of Nations,Port Elizabeth,South Africa,1,97,371,101,355,-4,16,D,1,0,0
2013-01-25 00:00:00.000000,Burkina Faso,Ethiopia,4,0,African Cup of Nations,Nelspruit,South Africa,1,92,389,110,316,-18,73,W,0,0,0
2013-01-25 00:00:00.000000,Costa Rica,El Salvador,1,0,UNCAF Cup,San José,Costa Rica,0,66,515,96,374,-30,141,W,0,1,0
2013-01-25 00:00:00.000000,Guatemala,Panama,1,3,UNCAF Cup,San José,Costa Rica,1,87,412,46,594,41,-182,L,2,0,0
2013-01-25 00:00:00.000000,Honduras,Belize,1,0,UNCAF Cup,San José,Costa Rica,1,59,543,164,110,-105,433,W,0,0,0
2013-01-25 00:00:00.000000,Zambia,Nigeria,1,1,African Cup of Nations,Nelspruit,South Africa,1,39,646,52,573,-13,73,D,1,0,0
2013-01-26 00:00:00.000000,Algeria,Togo,0,2,African Cup of Nations,Rustenburg,South Africa,1,22,829,77,451,-55,378,L,2,0,0
2013-01-26 00:00:00.000000,Sweden,Finland,3,0,King's Cup,Chiang Mai,Thailand,1,19,870,84,431,-65,439,W,0,0,0
2013-01-26 00:00:00.000000,Thailand,Korea DPR,2,2,King's Cup,Chiang Mai,Thailand,0,138,228,99,363,39,-135,D,1,1,0
2013-01-27 00:00:00.000000,Costa Rica,Honduras,1,0,UNCAF Cup,San José,Costa Rica,0,66,515,59,543,7,-28,W,0,1,0
2013-01-27 00:00:00.000000,El Salvador,Belize,1,0,UNCAF Cup,San José,Costa Rica,1,96,374,164,110,-68,264,W,0,0,0
2013-01-27 00:00:00.000000,South Africa,Morocco,2,2,African Cup of Nations,Durban,South Africa,0,85,423,74,461,11,-38,D,1,1,0
2013-01-28 00:00:00.000000,Congo DR,Mali,1,1,African Cup of Nations,Durban,South Africa,1,101,355,25,807,76,-452,D,1,0,0
2013-01-28 00:00:00.000000,Niger,Ghana,0,3,African Cup of Nations,Port Elizabeth,South Africa,1,97,371,26,788,71,-417,L,2,0,0
2013-01-29 00:00:00.000000,Burkina Faso,Zambia,0,0,African Cup of Nations,Nelspruit,South Africa,1,92,389,39,646,53,-257,D,1,0,0
2013-01-29 00:00:00.000000,Ethiopia,Nigeria,0,2,African Cup of Nations,Rustenburg,South Africa,1,110,316,52,573,58,-257,L,2,0,0
2013-01-29 00:00:00.000000,USA,Canada,0,0,Friendly,Houston,USA,0,28,782,64,517,-36,265,D,1,1,0
2013-01-30 00:00:00.000000,Togo,Tunisia,1,1,African Cup of Nations,Nelspruit,South Africa,1,77,451,53,570,24,-119,D,1,0,0
2013-01-31 00:00:00.000000,Jordan,Indonesia,5,0,Friendly,Amman,Jordan,0,95,375,156,145,-61,230,W,0,1,0
2013-01-31 00:00:00.000000,Qatar,Lebanon,1,0,Friendly,Doha,Qatar,0,106,331,130,253,-24,78,W,0,1,0
2013-02-01 00:00:00.000000,Uzbekistan,Azerbaijan,0,0,Friendly,Dubai,United Arab Emirates,1,56,555,118,277,-62,278,D,1,0,0
2013-02-02 00:00:00.000000,Romania,Poland,1,4,Friendly,Málaga,Spain,1,33,700,56,555,-23,145,L,2,0,0
2013-02-02 00:00:00.000000,South Africa,Mali,1,1,African Cup of Nations,Durban,South Africa,0,85,423,25,807,60,-384,D,1,1,0
2013-02-03 00:00:00.000000,Burkina Faso,Togo,1,0,African Cup of Nations,Nelspruit,South Africa,1,92,389,77,451,15,-62,W,0,0,0
2013-02-05 00:00:00.000000,Armenia,Luxembourg,1,1,Friendly,Valence,France,1,75,457,148,172,-73,285,D,1,0,0
2013-02-06 00:00:00.000000,Albania,Georgia,1,2,Friendly,Tirana,Albania,0,63,518,72,481,-9,37,L,2,1,0
2013-02-06 00:00:00.000000,Azerbaijan,Liechtenstein,1,0,Friendly,Dubai,United Arab Emirates,1,118,277,154,146,-36,131,W,0,0,0
2013-02-06 00:00:00.000000,Belgium,Slovakia,2,1,Friendly,Bruges,Belgium,0,20,868,44,595,-24,273,W,0,1,0
2013-02-06 00:00:00.000000,Burkina Faso,Ghana,1,1,African Cup of Nations,Nelspruit,South Africa,1,92,389,26,788,66,-399,D,1,0,0
2013-02-06 00:00:00.000000,Chile,Egypt,2,1,Friendly,Madrid,Spain,1,30,774,54,566,-24,208,W,0,0,0
2013-02-06 00:00:00.000000,Croatia,Korea Republic,4,0,Friendly,London,England,1,10,1064,34,687,-24,377,W,0,0,0
2013-02-06 00:00:00.000000,Cyprus,Serbia,1,3,Friendly,Nicosia,Cyprus,0,131,248,37,659,94,-411,L,2,1,0
2013-02-06 00:00:00.000000,England,Brazil,2,1,Friendly,London,England,0,6,1151,18,946,-12,205,W,0,1,0
2013-02-06 00:00:00.000000,France,Germany,1,2,Friendly,Saint-Denis,France,0,17,949,2,1437,15,-488,L,2,1,0
2013-02-06 00:00:00.000000,Greece,Switzerland,0,0,Friendly,Piraeus,Greece,0,11,1033,13,1004,-2,29,D,1,1,0
2013-02-06 00:00:00.000000,Honduras,USA,2,1,FIFA World Cup qualification,San Pedro Sula,Honduras,0,59,543,28,782,31,-239,W,0,1,0
2013-02-06 00:00:00.000000,Hungary,Belarus,1,1,Friendly,Belek,Turkey,1,32,750,65,516,-33,234,D,1,0,0
2013-02-06 00:00:00.000000,Iceland,Russia,0,2,Friendly,Marbella,Spain,1,89,392,9,1070,80,-678,L,2,0,0
2013-02-06 00:00:00.000000,India,Palestine,2,4,Friendly,Kochi,India,0,166,100,152,154,14,-54,L,2,1,0
2013-02-06 00:00:00.000000,Iran,Lebanon,5,0,AFC Asian Cup qualification,Teheran,Iran,0,60,537,130,253,-70,284,W,0,1,0
2013-02-06 00:00:00.000000,Iraq,Indonesia,1,0,AFC Asian Cup qualification,Dubai,United Arab Emirates,1,89,392,156,145,-67,247,W,0,0,0
2013-02-06 00:00:00.000000,Israel,Finland,2,1,Friendly,Netanya,Israel,0,76,454,84,431,-8,23,W,0,1,0
2013-02-06 00:00:00.000000,Japan,Latvia,3,0,Friendly,Kobe,Japan,0,21,834,104,334,-83,500,W,0,1,0
2013-02-06 00:00:00.000000,Jordan,Singapore,4,0,AFC Asian Cup qualification,Amman,Jordan,0,95,375,154,146,-59,229,W,0,1,0
2013-02-06 00:00:00.000000,Kenya,Libya,3,0,Friendly,Tunis,Tunisia,1,127,256,47,591,80,-335,W,0,0,0
2013-02-06 00:00:00.000000,Korea DPR,Laos,1,0,Friendly,Kunming,China,1,99,363,170,83,-71,280,W,0,0,0
2013-02-06 00:00:00.000000,Mali,Nigeria,1,4,African Cup of Nations,Durban,South Africa,1,25,807,52,573,-27,234,L,2,0,0
2013-02-06 00:00:00.000000,Malta,Northern Ireland,0,0,Friendly,Attard,Malta,0,146,178,98,367,48,-189,D,1,1,0
2013-02-06 00:00:00.000000,Mexico,Jamaica,0,0,FIFA World Cup qualification,Mexico City,Mexico,0,15,994,58,552,-43,442,D,1,1,0
2013-02-06 00:00:00.000000,Moldova,Kazakhstan,1,3,Friendly,Antalya,Turkey,1,128,255,142,200,-14,55,L,2,0,0
2013-02-06 00:00:00.000000,Nepal,Pakistan,0,1,Friendly,Kathmandu,Nepal,0,170,83,189,37,-19,46,L,2,1,0
2013-02-06 00:00:00.000000,Netherlands,Italy,1,1,Friendly,Amsterdam,Netherlands,0,8,1124,4,1165,4,-41,D,1,1,0
2013-02-06 00:00:00.000000,Norway,Ukraine,0,2,Friendly,Seville,Spain,1,24,810,44,595,-20,215,L,2,0,0
2013-02-06 00:00:00.000000,Oman,Syria,1,0,AFC Asian Cup qualification,Muscat,Oman,0,108,328,136,237,-28,91,W,0,1,0
2013-02-06 00:00:00.000000,Panama,Costa Rica,2,2,FIFA World Cup qualification,Panama City,Panama,0,46,594,66,515,-20,79,D,1,1,0
2013-02-06 00:00:00.000000,Portugal,Ecuador,2,3,Friendly,Guimarães,Portugal,0,7,1144,12,1007,-5,137,L,2,1,0
2013-02-06 00:00:00.000000,Qatar,Malaysia,2,0,AFC Asian Cup qualification,Doha,Qatar,0,106,331,158,134,-52,197,W,0,1,0
2013-02-06 00:00:00.000000,Romania,Australia,3,2,Friendly,Málaga,Spain,1,33,700,36,674,-3,26,W,0,0,0
2013-02-06 00:00:00.000000,Rwanda,Uganda,2,2,Friendly,Kigali,Rwanda,0,137,236,81,435,56,-199,D,1,1,0
2013-02-06 00:00:00.000000,Scotland,Estonia,1,0,Friendly,Aberdeen,Scotland,0,69,490,83,433,-14,57,W,0,1,0
2013-02-06 00:00:00.000000,Spain,Uruguay,3,1,Friendly,Doha,Qatar,1,1,1606,16,975,-15,631,W,0,0,0
2013-02-06 00:00:00.000000,Sweden,Argentina,2,3,Friendly,Solna,Sweden,0,19,870,3,1290,16,-420,L,2,1,0
2013-02-06 00:00:00.000000,Tanzania,Cameroon,1,0,Friendly,Dar es Salaam,Tanzania,0,124,264,67,500,57,-236,W,0,1,0
2013-02-06 00:00:00.000000,Thailand,Kuwait,1,3,AFC Asian Cup qualification,Bangkok,Thailand,0,138,228,120,276,18,-48,L,2,1,0
2013-02-06 00:00:00.000000,Turkey,Czech Republic,0,2,Friendly,Manisa,Turkey,0,40,627,29,781,11,-154,L,2,1,0
2013-02-06 00:00:00.000000,Uzbekistan,Hong Kong,0,0,AFC Asian Cup qualification,Tashkent,Uzbekistan,0,56,555,163,111,-107,444,D,1,1,0
2013-02-06 00:00:00.000000,Vietnam,United Arab Emirates,1,2,AFC Asian Cup qualification,Hanoi,Vietnam,0,134,242,103,346,31,-104,L,2,1,0
2013-02-06 00:00:00.000000,Wales,Austria,2,1,Friendly,Swansea,Wales,0,81,435,68,492,13,-57,W,0,1,0
2013-02-06 00:00:00.000000,Yemen,Bahrain,0,2,AFC Asian Cup qualification,Sharjah,United Arab Emirates,1,165,106,117,282,48,-176,L,2,0,0
2013-02-06 00:00:00.000000,Zimbabwe,Botswana,2,1,Friendly,Harare,Zimbabwe,0,102,354,124,264,-22,90,W,0,1,0
2013-02-09 00:00:00.000000,Mali,Ghana,3,1,African Cup of Nations,Port Elizabeth,South Africa,1,25,807,26,788,-1,19,W,0,0,0
2013-02-09 00:00:00.000000,Nepal,Pakistan,0,1,Friendly,Kathmandu,Nepal,0,170,83,189,37,-19,46,L,2,1,0
2013-02-10 00:00:00.000000,Nigeria,Burkina Faso,1,0,African Cup of Nations,Johannesburg,South Africa,1,52,573,92,389,-40,184,W,0,0,0
2013-02-12 00:00:00.000000,Maldives,Pakistan,1,1,Friendly,Malé,Maldives,0,159,130,189,37,-30,93,D,1,1,0
2013-02-14 00:00:00.000000,Maldives,Pakistan,3,0,Friendly,Malé,Maldives,0,159,130,170,88,-11,42,W,0,1,0
2013-02-27 00:00:00.000000,Gambia,Mauritania,0,2,Friendly,Bakau,Gambia,0,145,187,168,94,-23,93,L,2,1,0
2013-03-02 00:00:00.000000,Afghanistan,Sri Lanka,1,0,AFC Challenge Cup qualification,Vientiane,Laos,1,189,39,193,36,-4,3,W,0,0,0
2013-03-02 00:00:00.000000,Gambia,Mauritania,0,0,Friendly,Bakau,Gambia,0,145,187,168,94,-23,93,D,1,1,0
2013-03-02 00:00:00.000000,Laos,Mongolia,1,1,AFC Challenge Cup qualification,Vientiane,Laos,0,173,83,181,55,-8,28,D,1,1,0
2013-03-02 00:00:00.000000,Palestine,Bangladesh,1,0,AFC Challenge Cup qualification,Kathmandu,Nepal,1,153,160,169,90,-16,70,W,0,0,0
2013-03-04 00:00:00.000000,Guam,India,0,4,AFC Challenge Cup qualification,Rangoon,Burma,1,183,53,167,98,16,-45,L,2,0,0
2013-03-04 00:00:00.000000,Laos,Sri Lanka,4,2,AFC Challenge Cup qualification,Vientiane,Laos,0,173,83,193,36,-20,47,W,0,1,0
2013-03-04 00:00:00.000000,Mongolia,Afghanistan,0,1,AFC Challenge Cup qualification,Vientiane,Laos,1,181,55,189,39,-8,16,L,2,0,0
2013-03-04 00:00:00.000000,Nepal,Bangladesh,0,2,AFC Challenge Cup qualification,Kathmandu,Nepal,0,174,80,169,90,5,-10,L,2,1,0
2013-03-06 00:00:00.000000,Laos,Afghanistan,1,1,AFC Challenge Cup qualification,Vientiane,Laos,0,173,83,189,39,-16,44,D,1,1,0
2013-03-06 00:00:00.000000,Nepal,Palestine,0,0,AFC Challenge Cup qualification,Kathmandu,Nepal,0,174,80,153,160,21,-80,D,1,1,0
2013-03-06 00:00:00.000000,Sri Lanka,Mongolia,3,0,AFC Challenge Cup qualification,Vientiane,Laos,1,193,36,181,55,12,-19,W,0,0,0
2013-03-07 00:00:00.000000,Qatar,Egypt,3,1,Friendly,Doha,Qatar,0,101,357,70,490,31,-133,W,0,1,0
2013-03-16 00:00:00.000000,Senegal,Libya,0,4,Friendly,Casablanca,Morocco,1,82,434,65,507,17,-73,L,2,0,0
2013-03-17 00:00:00.000000,Bahrain,Lebanon,0,0,Friendly,Riffa,Bahrain,0,117,271,130,234,-13,37,D,1,1,0
2013-03-17 00:00:00.000000,Malaysia,Saudi Arabia,1,4,Friendly,Shah Alam,Malaysia,0,164,129,106,327,58,-198,L,2,1,0
2013-03-17 00:00:00.000000,Qatar,Thailand,1,0,Friendly,Doha,Qatar,0,98,364,135,220,-37,144,W,0,1,0
2013-03-17 00:00:00.000000,Tajikistan,Pakistan,1,0,AFC Challenge Cup qualification,Bishkek,Kyrgyzstan,1,152,154,171,97,-19,57,W,0,0,0
2013-03-19 00:00:00.000000,Botswana,Malawi,1,0,Friendly,Gaborone,Botswana,0,122,260,111,310,11,-50,W,0,1,0
2013-03-19 00:00:00.000000,Macau,Tajikistan,0,3,AFC Challenge Cup qualification,Bishkek,Kyrgyzstan,1,198,22,152,154,46,-132,L,2,0,0
2013-03-20 00:00:00.000000,Oman,Haiti,3,0,Friendly,Muscat,Oman,0,105,329,51,584,54,-255,W,0,1,0
2013-03-20 00:00:00.000000,Rwanda,Libya,0,1,Friendly,Kigali,Rwanda,0,132,228,65,507,67,-279,L,2,1,0
2013-03-21 00:00:00.000000,Ecuador,El Salvador,5,0,Friendly,Quito,Ecuador,0,11,1037,83,432,-72,605,W,0,1,0
2013-03-21 00:00:00.000000,Italy,Brazil,2,2,Friendly,Geneva,Switzerland,1,5,1173,18,908,-13,265,D,1,0,0
2013-03-21 00:00:00.000000,Jordan,Belarus,1,0,Friendly,Amman,Jordan,0,90,394,62,524,28,-130,W,0,1,0
2013-03-21 00:00:00.000000,Kuwait,Palestine,2,1,Friendly,Kuwait City,Kuwait,0,113,294,150,161,-37,133,W,0,1,0
2013-03-21 00:00:00.000000,Pakistan,Macau,2,0,AFC Challenge Cup qualification,Bishkek,Kyrgyzstan,1,171,97,198,22,-27,75,W,0,0,0
2013-03-22 00:00:00.000000,Andorra,Turkey,0,2,FIFA World Cup qualification,Sant Julià de Lòria,Andorra,0,204,11,45,616,159,-605,L,2,1,0
2013-03-22 00:00:00.000000,Argentina,Venezuela,3,0,FIFA World Cup qualification,Buenos Aires,Argentina,0,3,1309,43,622,-40,687,W,0,1,0
2013-03-22 00:00:00.000000,Austria,Faroe Islands,6,0,FIFA World Cup qualification,Vienna,Austria,0,79,453,153,151,-74,302,W,0,1,0
2013-03-22 00:00:00.000000,Bahrain,Qatar,1,0,AFC Asian Cup qualification,Riffa,Bahrain,0,117,271,98,364,19,-93,W,0,1,0
2013-03-22 00:00:00.000000,Bulgaria,Malta,6,0,FIFA World Cup qualification,Sofia,Bulgaria,0,46,615,147,166,-101,449,W,0,1,0
2013-03-22 00:00:00.000000,Colombia,Bolivia,5,0,FIFA World Cup qualification,Barranquilla,Colombia,0,6,1159,37,641,-31,518,W,0,1,0
2013-03-22 00:00:00.000000,Croatia,Serbia,2,0,FIFA World Cup qualification,Zagreb,Croatia,0,9,1080,35,657,-26,423,W,0,1,0
2013-03-22 00:00:00.000000,Czech Republic,Denmark,0,3,FIFA World Cup qualification,Olomouc,Czech Republic,0,27,809,25,814,2,-5,L,2,1,0
2013-03-22 00:00:00.000000,Egypt,Swaziland,10,0,Friendly,Alexandria,Egypt,0,75,478,183,63,-108,415,W,0,1,0
2013-03-22 00:00:00.000000,France,Georgia,3,1,FIFA World Cup qualification,Saint-Denis,France,0,17,921,69,494,-52,427,W,0,1,0
2013-03-22 00:00:00.000000,Honduras,Mexico,2,2,FIFA World Cup qualification,San Pedro Sula,Honduras,0,49,592,15,995,34,-403,D,1,1,0
2013-03-22 00:00:00.000000,Hong Kong,Vietnam,1,0,AFC Asian Cup qualification,Kowloon,Hong Kong,0,159,141,129,239,30,-98,W,0,1,0
2013-03-22 00:00:00.000000,Hungary,Romania,2,2,FIFA World Cup qualification,Budapest,Hungary,0,32,752,31,768,1,-16,D,1,1,0
2013-03-22 00:00:00.000000,Israel,Portugal,3,3,FIFA World Cup qualification,Ramat-Gan,Israel,0,74,485,7,1133,67,-648,D,1,1,0
2013-03-22 00:00:00.000000,Jamaica,Panama,1,1,FIFA World Cup qualification,Kingston,Jamaica,0,54,576,41,624,13,-48,D,1,1,0
2013-03-22 00:00:00.000000,Japan,Canada,2,1,Friendly,Doha,Qatar,1,26,811,68,496,-42,315,W,0,0,0
2013-03-22 00:00:00.000000,Kazakhstan,Germany,0,3,FIFA World Cup qualification,Astana,Kazakhstan,0,139,212,2,1473,137,-1261,L,2,1,0
2013-03-22 00:00:00.000000,Lebanon,Thailand,5,2,AFC Asian Cup qualification,Beirut,Lebanon,0,130,234,135,220,-5,14,W,0,1,0
2013-03-22 00:00:00.000000,Liechtenstein,Latvia,1,1,FIFA World Cup qualification,Vaduz,Liechtenstein,0,157,143,108,319,49,-176,D,1,1,0
2013-03-22 00:00:00.000000,Luxembourg,Azerbaijan,0,0,FIFA World Cup qualification,Luxembourg,Luxembourg,0,151,157,116,286,35,-129,D,1,1,0
2013-03-22 00:00:00.000000,Malaysia,Yemen,2,1,AFC Asian Cup qualification,Shah Alam,Malaysia,0,164,129,170,101,-6,28,W,0,1,0
2013-03-22 00:00:00.000000,Moldova,Montenegro,0,1,FIFA World Cup qualification,Chişinău,Moldova,0,131,232,28,790,103,-558,L,2,1,0
2013-03-22 00:00:00.000000,Netherlands,Estonia,3,0,FIFA World Cup qualification,Amsterdam,Netherlands,0,8,1106,89,408,-81,698,W,0,1,0
2013-03-22 00:00:00.000000,New Zealand,New Caledonia,2,1,FIFA World Cup qualification,Dunedin,New Zealand,0,88,419,103,336,-15,83,W,0,1,0
2013-03-22 00:00:00.000000,Norway,Albania,0,1,FIFA World Cup qualification,Oslo,Norway,0,29,784,64,510,-35,274,L,2,1,0
2013-03-22 00:00:00.000000,Peru,Chile,1,0,FIFA World Cup qualification,Lima,Peru,0,41,624,22,829,19,-205,W,0,1,0
2013-03-22 00:00:00.000000,Poland,Ukraine,1,3,FIFA World Cup qualification,Warsaw,Poland,0,61,529,48,598,13,-69,L,2,1,0
2013-03-22 00:00:00.000000,San Marino,England,0,8,FIFA World Cup qualification,Serravalle,San Marino,0,207,0,4,1174,203,-1174,L,2,1,0
2013-03-22 00:00:00.000000,Scotland,Wales,1,2,FIFA World Cup qualification,Glasgow,Scotland,0,66,501,71,491,-5,10,L,2,1,0
2013-03-22 00:00:00.000000,Slovakia,Lithuania,1,1,FIFA World Cup qualification,Žilina,Slovakia,0,55,574,115,287,-60,287,D,1,1,0
2013-03-22 00:00:00.000000,Slovenia,Iceland,1,2,FIFA World Cup qualification,Ljubljana,Slovenia,0,56,567,92,392,-36,175,L,2,1,0
2013-03-22 00:00:00.000000,Spain,Finland,1,1,FIFA World Cup qualification,Gijón,Spain,0,1,1610,87,423,-86,1187,D,1,1,0
2013-03-22 00:00:00.000000,Tahiti,Solomon Islands,2,0,FIFA World Cup qualification,Pirae,French Polynesia,1,138,215,147,166,-9,49,W,0,0,0
2013-03-22 00:00:00.000000,Turkmenistan,Cambodia,7,0,AFC Challenge Cup qualification,Manila,Philippines,1,140,207,185,58,-45,149,W,0,0,0
2013-03-22 00:00:00.000000,United Arab Emirates,Uzbekistan,2,1,AFC Asian Cup qualification,Abu Dhabi,United Arab Emirates,0,98,364,59,536,39,-172,W,0,1,0
2013-03-22 00:00:00.000000,Uruguay,Paraguay,1,1,FIFA World Cup qualification,Montevideo,Uruguay,0,16,950,38,640,-22,310,D,1,1,0
2013-03-22 00:00:00.000000,USA,Costa Rica,1,0,FIFA World Cup qualification,Commerce City,USA,0,33,733,53,577,-20,156,W,0,1,0
2013-03-23 00:00:00.000000,Belize,Trinidad and Tobago,0,0,Friendly,Belmopan,Belize,0,128,240,69,494,59,-254,D,1,1,0
2013-03-23 00:00:00.000000,Burkina Faso,Niger,4,0,FIFA World Cup qualification,Ouagadougou,Burkina Faso,0,50,588,93,389,-43,199,W,0,1,0
2013-03-23 00:00:00.000000,Cameroon,Togo,2,1,FIFA World Cup qualification,Yaoundé,Cameroon,0,79,453,67,500,12,-47,W,0,1,0
2013-03-23 00:00:00.000000,Congo,Gabon,1,0,FIFA World Cup qualification,Pointe-Noire,Congo,0,101,358,75,478,26,-120,W,0,1,0
2013-03-23 00:00:00.000000,Cyprus,Switzerland,0,0,FIFA World Cup qualification,Nicosia,Cyprus,0,133,225,14,1019,119,-794,D,1,1,0
2013-03-23 00:00:00.000000,Indonesia,Saudi Arabia,1,2,AFC Asian Cup qualification,Jakarta,Indonesia,0,166,121,106,327,60,-206,L,2,1,0
2013-03-23 00:00:00.000000,Namibia,Malawi,0,1,FIFA World Cup qualification,Windhoek,Namibia,0,121,261,111,310,10,-49,L,2,1,0
2013-03-23 00:00:00.000000,Nigeria,Kenya,1,1,FIFA World Cup qualification,Calabar,Nigeria,0,30,775,126,247,-96,528,D,1,1,0
2013-03-23 00:00:00.000000,Senegal,Angola,1,1,FIFA World Cup qualification,Conakry,Guinea,1,82,434,95,381,-13,53,D,1,0,0
2013-03-23 00:00:00.000000,South Africa,Central African Republic,2,0,FIFA World Cup qualification,Cape Town,South Africa,0,60,531,52,581,8,-50,W,0,1,0
2013-03-23 00:00:00.000000,Tunisia,Sierra Leone,2,1,FIFA World Cup qualification,Radès,Tunisia,0,44,619,63,517,-19,102,W,0,1,0
2013-03-24 00:00:00.000000,Congo DR,Libya,0,0,FIFA World Cup qualification,Kinshasa,Congo DR,0,81,437,65,507,16,-70,D,1,1,0
2013-03-24 00:00:00.000000,Dominican Republic,Haiti,3,1,Friendly,San Cristóbal,Dominican Republic,0,96,378,51,584,45,-206,W,0,1,0
2013-03-24 00:00:00.000000,Ethiopia,Botswana,1,0,FIFA World Cup qualification,Addis Ababa,Ethiopia,0,112,307,122,260,-10,47,W,0,1,0
2013-03-24 00:00:00.000000,Ghana,Sudan,4,0,FIFA World Cup qualification,Kumasi,Ghana,0,20,883,127,241,-107,642,W,0,1,0
2013-03-24 00:00:00.000000,Lesotho,Zambia,1,1,FIFA World Cup qualification,Maseru,Lesotho,0,166,121,36,643,130,-522,D,1,1,0
2013-03-24 00:00:00.000000,Liberia,Uganda,2,0,FIFA World Cup qualification,Paynesville,Liberia,0,118,265,85,427,33,-162,W,0,1,0
2013-03-24 00:00:00.000000,Mozambique,Guinea,0,0,FIFA World Cup qualification,Maputo,Mozambique,0,107,321,72,489,35,-168,D,1,1,0
2013-03-24 00:00:00.000000,Philippines,Cambodia,8,0,AFC Challenge Cup qualification,Manila,Philippines,0,145,173,185,58,-40,115,W,0,1,0
2013-03-24 00:00:00.000000,Rwanda,Mali,1,2,FIFA World Cup qualification,Kigali,Rwanda,0,132,228,24,815,108,-587,L,2,1,0
2013-03-24 00:00:00.000000,Tanzania,Morocco,3,1,FIFA World Cup qualification,Dar es Salaam,Tanzania,0,119,263,77,475,42,-212,W,0,1,0
2013-03-25 00:00:00.000000,Canada,Belarus,0,2,Friendly,Doha,Qatar,1,68,496,62,524,6,-28,L,2,0,0
2013-03-25 00:00:00.000000,Russia,Brazil,1,1,Friendly,London,England,1,10,1064,18,908,-8,156,D,1,0,0
2013-03-26 00:00:00.000000,Albania,Lithuania,4,1,Friendly,Tirana,Albania,0,64,510,115,287,-51,223,W,0,1,0
2013-03-26 00:00:00.000000,Algeria,Benin,3,1,FIFA World Cup qualification,Blida,Algeria,0,34,722,86,424,-52,298,W,0,1,0
2013-03-26 00:00:00.000000,Armenia,Czech Republic,0,3,FIFA World Cup qualification,Yerevan,Armenia,0,84,431,27,809,57,-378,L,2,1,0
2013-03-26 00:00:00.000000,Australia,Oman,2,2,FIFA World Cup qualification,Sydney,Australia,0,39,634,105,329,-66,305,D,1,1,0
2013-03-26 00:00:00.000000,Azerbaijan,Portugal,0,2,FIFA World Cup qualification,Baku,Azerbaijan,0,116,286,7,1133,109,-847,L,2,1,0
2013-03-26 00:00:00.000000,Bolivia,Argentina,1,1,FIFA World Cup qualification,La Paz,Bolivia,0,37,641,3,1309,34,-668,D,1,1,0
2013-03-26 00:00:00.000000,Chile,Uruguay,2,0,FIFA World Cup qualification,Santiago,Chile,0,22,829,16,950,6,-121,W,0,1,0
2013-03-26 00:00:00.000000,Costa Rica,Jamaica,2,0,FIFA World Cup qualification,San José,Costa Rica,0,53,577,54,576,-1,1,W,0,1,0
2013-03-26 00:00:00.000000,Denmark,Bulgaria,1,1,FIFA World Cup qualification,Copenhagen,Denmark,0,25,814,46,615,-21,199,D,1,1,0
2013-03-26 00:00:00.000000,Ecuador,Paraguay,4,1,FIFA World Cup qualification,Quito,Ecuador,0,11,1037,38,640,-27,397,W,0,1,0
2013-03-26 00:00:00.000000,Egypt,Zimbabwe,2,1,FIFA World Cup qualification,Alexandria,Egypt,0,75,478,100,361,-25,117,W,0,1,0
2013-03-26 00:00:00.000000,Estonia,Andorra,2,0,FIFA World Cup qualification,Tallinn,Estonia,0,89,408,204,11,-115,397,W,0,1,0
2013-03-26 00:00:00.000000,France,Spain,0,1,FIFA World Cup qualification,Saint-Denis,France,0,17,921,1,1610,16,-689,L,2,1,0
2013-03-26 00:00:00.000000,Germany,Kazakhstan,4,1,FIFA World Cup qualification,Nuremberg,Germany,0,2,1473,139,212,-137,1261,W,0,1,0
2013-03-26 00:00:00.000000,Iraq,Syria,2,1,Friendly,Baghdad,Iraq,0,94,387,134,222,-40,165,W,0,1,0
2013-03-26 00:00:00.000000,Jordan,Japan,2,1,FIFA World Cup qualification,Amman,Jordan,0,90,394,26,811,64,-417,W,0,1,0
2013-03-26 00:00:00.000000,Korea Republic,Qatar,2,1,FIFA World Cup qualification,Seoul,Korea Republic,0,47,601,98,364,-51,237,W,0,1,0
2013-03-26 00:00:00.000000,Kuwait,Iran,1,1,AFC Asian Cup qualification,Kuwait City,Kuwait,0,113,294,57,540,56,-246,D,1,1,0
2013-03-26 00:00:00.000000,Luxembourg,Finland,0,3,Friendly,Luxembourg,Luxembourg,0,151,157,87,423,64,-266,L,2,1,0
2013-03-26 00:00:00.000000,Malaysia,Palestine,0,2,Friendly,Kuantan,Malaysia,0,164,129,150,161,14,-32,L,2,1,0
2013-03-26 00:00:00.000000,Malta,Italy,0,2,FIFA World Cup qualification,Attard,Malta,0,147,166,5,1173,142,-1007,L,2,1,0
2013-03-26 00:00:00.000000,Mexico,USA,0,0,FIFA World Cup qualification,Mexico City,Mexico,0,15,995,33,733,-18,262,D,1,1,0
2013-03-26 00:00:00.000000,Montenegro,England,1,1,FIFA World Cup qualification,Podgorica,Montenegro,0,28,790,4,1174,24,-384,D,1,1,0
2013-03-26 00:00:00.000000,Netherlands,Romania,4,0,FIFA World Cup qualification,Amsterdam,Netherlands,0,8,1106,31,768,-23,338,W,0,1,0
2013-03-26 00:00:00.000000,New Caledonia,Tahiti,1,0,FIFA World Cup qualification,Nouméa,New Caledonia,0,103,336,138,215,-35,121,W,0,1,0
2013-03-26 00:00:00.000000,Northern Ireland,Israel,0,2,FIFA World Cup qualification,Belfast,Northern Ireland,0,97,367,74,485,23,-118,L,2,1,0
2013-03-26 00:00:00.000000,Panama,Honduras,2,0,FIFA World Cup qualification,Panama City,Panama,0,41,624,49,592,-8,32,W,0,1,0
2013-03-26 00:00:00.000000,Peru,Trinidad and Tobago,3,0,Friendly,Lima,Peru,0,41,624,69,494,-28,130,W,0,1,0
2013-03-26 00:00:00.000000,Philippines,Turkmenistan,1,0,AFC Challenge Cup qualification,Manila,Philippines,0,145,173,140,207,5,-34,W,0,1,0
2013-03-26 00:00:00.000000,Poland,San Marino,5,0,FIFA World Cup qualification,Warsaw,Poland,0,61,529,207,0,-146,529,W,0,1,0
2013-03-26 00:00:00.000000,Serbia,Scotland,2,0,FIFA World Cup qualification,Novi Sad,Serbia,0,35,657,66,501,-31,156,W,0,1,0
2013-03-26 00:00:00.000000,Slovakia,Sweden,0,0,Friendly,Žilina,Slovakia,0,55,574,21,849,34,-275,D,1,1,0
2013-03-26 00:00:00.000000,Solomon Islands,New Zealand,0,2,FIFA World Cup qualification,Honiara,Solomon Islands,0,147,166,88,419,59,-253,L,2,1,0
2013-03-26 00:00:00.000000,Turkey,Hungary,1,1,FIFA World Cup qualification,Istanbul,Turkey,0,45,616,32,752,13,-136,D,1,1,0
2013-03-26 00:00:00.000000,Ukraine,Moldova,2,1,FIFA World Cup qualification,Odesa,Ukraine,0,48,598,131,232,-83,366,W,0,1,0
2013-03-26 00:00:00.000000,Uzbekistan,Lebanon,1,0,FIFA World Cup qualification,Tashkent,Uzbekistan,0,59,536,130,234,-71,302,W,0,1,0
2013-03-26 00:00:00.000000,Venezuela,Colombia,1,0,FIFA World Cup qualification,Puerto Ordaz,Venezuela,0,43,622,6,1159,37,-537,W,0,1,0
2013-03-26 00:00:00.000000,Wales,Croatia,1,2,FIFA World Cup qualification,Swansea,Wales,0,71,491,9,1080,62,-589,L,2,1,0
2013-04-06 00:00:00.000000,Bolivia,Brazil,0,4,Friendly,Santa Cruz,Bolivia,0,37,641,18,908,19,-267,L,2,1,0
2013-04-17 00:00:00.000000,Mexico,Peru,0,0,Friendly,San Francisco,USA,1,14,971,32,752,-18,219,D,1,0,0
2013-04-17 00:00:00.000000,Qatar,Palestine,2,0,Friendly,Doha,Qatar,0,102,346,151,170,-49,176,W,0,1,0
2013-04-21 00:00:00.000000,St. Vincent and the Grenadines,St. Lucia,0,2,Windward Islands Tournament,Kingstown,St. Vincent and the Grenadines,0,121,271,152,168,-31,103,L,2,1,0
2013-04-24 00:00:00.000000,Brazil,Chile,2,2,Friendly,Belo Horizonte,Brazil,0,19,909,23,870,-4,39,D,1,1,0
2013-04-28 00:00:00.000000,Zambia,Zimbabwe,2,0,Friendly,Lusaka,Zambia,0,45,632,101,349,-56,283,W,0,1,0
2013-05-13 00:00:00.000000,Libya,Mauritania,2,0,Friendly,Tripoli,Libya,0,65,524,175,94,-110,430,W,0,1,0
2013-05-22 00:00:00.000000,Oman,Iran,3,1,Friendly,Muscat,Oman,0,102,344,57,538,45,-194,W,0,1,0
2013-05-22 00:00:00.000000,Venezuela,El Salvador,2,1,Friendly,Mérida,Venezuela,0,36,703,85,440,-49,263,W,0,1,0
2013-05-24 00:00:00.000000,Qatar,Latvia,3,1,Friendly,Doha,Qatar,0,101,345,110,322,-9,23,W,0,1,0
2013-05-25 00:00:00.000000,Algeria,Mauritania,1,0,Friendly,Blida,Algeria,0,35,735,175,94,-140,641,W,0,1,0
2013-05-25 00:00:00.000000,Ethiopia,Sudan,2,0,Friendly,Addis Ababa,Ethiopia,0,107,328,134,224,-27,104,W,0,1,0
2013-05-25 00:00:00.000000,Malawi,Zimbabwe,1,1,Friendly,Blantyre,Malawi,0,109,323,105,330,4,-7,D,1,1,0
2013-05-25 00:00:00.000000,Namibia,Zambia,0,0,Friendly,Windhoek,Namibia,0,125,257,46,628,79,-371,D,1,1,0
2013-05-27 00:00:00.000000,Iraq,Liberia,0,1,Friendly,Baghdad,Iraq,0,97,391,103,334,-6,57,L,2,1,0
2013-05-27 00:00:00.000000,Jordan,Libya,1,0,Friendly,Amman,Jordan,0,77,462,65,524,12,-62,W,0,1,0
2013-05-28 00:00:00.000000,Canada,Costa Rica,0,1,Friendly,Edmonton,Canada,0,80,457,48,616,32,-159,L,2,1,0
2013-05-28 00:00:00.000000,Turkey,Latvia,3,3,Friendly,Duisburg,Germany,1,44,634,110,322,-66,312,D,1,0,0
2013-05-29 00:00:00.000000,Ecuador,Germany,2,4,Friendly,Boca Raton,USA,1,10,1058,2,1428,8,-370,L,2,0,0
2013-05-29 00:00:00.000000,Oman,Lebanon,1,1,Friendly,Doha,Qatar,1,102,344,129,242,-27,102,D,1,0,0
2013-05-29 00:00:00.000000,Qatar,Azerbaijan,1,1,Friendly,Doha,Qatar,0,101,345,120,276,-19,69,D,1,1,0
2013-05-29 00:00:00.000000,USA,Belgium,2,4,Friendly,Cleveland,USA,0,29,779,15,953,14,-174,L,2,1,0
2013-05-30 00:00:00.000000,Japan,Bulgaria,0,2,Friendly,Toyota,Japan,0,30,773,52,583,-22,190,L,2,1,0
2013-05-31 00:00:00.000000,Italy,San Marino,4,0,Friendly,Bologna,Italy,0,8,1117,207,0,-199,1117,W,0,1,0
2013-05-31 00:00:00.000000,Mexico,Nigeria,2,2,Friendly,Houston,USA,1,16,945,28,780,-12,165,D,1,0,0
2013-05-31 00:00:00.000000,Turkey,Slovenia,0,2,Friendly,Bielefeld,Germany,1,44,634,55,560,-11,74,L,2,0,0
2013-06-01 00:00:00.000000,Libya,Uganda,3,0,Friendly,Tripoli,Libya,0,65,524,91,413,-26,111,W,0,1,0
2013-06-01 00:00:00.000000,Panama,Peru,1,2,Friendly,Panama City,Panama,0,38,663,32,753,6,-90,L,2,1,0
2013-06-02 00:00:00.000000,Algeria,Burkina Faso,2,0,Friendly,Blida,Algeria,0,35,735,50,587,-15,148,W,0,1,0
2013-06-02 00:00:00.000000,Brazil,England,2,2,Friendly,Rio de Janeiro,Brazil,0,19,902,7,1135,12,-233,D,1,1,0
2013-06-02 00:00:00.000000,Honduras,Israel,0,2,Friendly,New York,USA,1,50,587,59,536,-9,51,L,2,0,0
2013-06-02 00:00:00.000000,Lesotho,South Africa,0,2,Friendly,Maseru,Lesotho,0,155,154,56,541,99,-387,L,2,1,0
2013-06-02 00:00:00.000000,Sudan,Tanzania,0,0,Friendly,Addis Ababa,Ethiopia,1,134,224,116,306,18,-82,D,1,0,0
2013-06-02 00:00:00.000000,Ukraine,Cameroon,0,0,Friendly,Kyïv,Ukraine,0,37,675,62,533,-25,142,D,1,1,0
2013-06-02 00:00:00.000000,USA,Germany,4,3,Friendly,Washington,USA,0,29,779,2,1428,27,-649,W,0,1,0
2013-06-03 00:00:00.000000,Estonia,Belarus,0,2,Friendly,Tallinn,Estonia,0,92,411,69,502,23,-91,L,2,1,0
2013-06-04 00:00:00.000000,Egypt,Botswana,1,1,Friendly,Cairo,Egypt,0,68,512,125,257,-57,255,D,1,1,0
2013-06-04 00:00:00.000000,Hong Kong,Philippines,0,1,Friendly,Kowloon,Hong Kong,0,151,176,144,199,7,-23,L,2,1,0
2013-06-04 00:00:00.000000,Jamaica,Mexico,0,1,FIFA World Cup qualification,Kingston,Jamaica,0,53,571,16,945,37,-374,L,2,1,0
2013-06-04 00:00:00.000000,Japan,Australia,1,1,FIFA World Cup qualification,Saitama,Japan,0,30,773,47,624,-17,149,D,1,1,0
2013-06-04 00:00:00.000000,Kazakhstan,Bulgaria,1,2,Friendly,Almaty,Kazakhstan,0,144,199,52,583,92,-384,L,2,1,0
2013-06-04 00:00:00.000000,Lebanon,Korea Republic,1,1,FIFA World Cup qualification,Beirut,Lebanon,0,129,242,42,644,87,-402,D,1,1,0
2013-06-04 00:00:00.000000,Oman,Iraq,1,0,FIFA World Cup qualification,Muscat,Oman,0,102,344,97,391,5,-47,W,0,1,0
2013-06-04 00:00:00.000000,Poland,Liechtenstein,2,0,Friendly,Cracow,Poland,0,63,529,148,182,-85,347,W,0,1,0
2013-06-04 00:00:00.000000,Qatar,Iran,0,1,FIFA World Cup qualification,Doha,Qatar,0,101,345,57,538,44,-193,L,2,1,0
2013-06-04 00:00:00.000000,Romania,Trinidad and Tobago,4,0,Friendly,Bucharest,Romania,0,34,746,82,447,-48,299,W,0,1,0
2013-06-04 00:00:00.000000,Tajikistan,Afghanistan,3,2,Friendly,Qurghonteppa,Tajikistan,0,112,312,140,210,-28,102,W,0,1,0
2013-06-06 00:00:00.000000,Hungary,Kuwait,1,0,Friendly,Győr,Hungary,0,33,759,111,315,-78,444,W,0,1,0
2013-06-07 00:00:00.000000,Albania,Norway,1,1,FIFA World Cup qualification,Tirana,Albania,0,38,690,29,794,9,-104,D,1,1,0
2013-06-07 00:00:00.000000,Argentina,Colombia,0,0,FIFA World Cup qualification,Buenos Aires,Argentina,0,3,1287,7,1123,-4,164,D,1,1,0
2013-06-07 00:00:00.000000,Armenia,Malta,0,1,FIFA World Cup qualification,Yerevan,Armenia,0,89,408,156,148,-67,260,L,2,1,0
2013-06-07 00:00:00.000000,Austria,Sweden,2,1,FIFA World Cup qualification,Vienna,Austria,0,76,469,27,830,49,-361,W,0,1,0
2013-06-07 00:00:00.000000,Azerbaijan,Luxembourg,1,1,FIFA World Cup qualification,Baku,Azerbaijan,0,118,291,145,186,-27,105,D,1,1,0
2013-06-07 00:00:00.000000,Belgium,Serbia,2,1,FIFA World Cup qualification,Brussels,Belgium,0,12,1035,36,723,-24,312,W,0,1,0
2013-06-07 00:00:00.000000,Bolivia,Venezuela,1,1,FIFA World Cup qualification,La Paz,Bolivia,0,53,578,37,712,16,-134,D,1,1,0
2013-06-07 00:00:00.000000,Costa Rica,Honduras,1,0,FIFA World Cup qualification,San José,Costa Rica,0,48,617,52,582,-4,35,W,0,1,0
2013-06-07 00:00:00.000000,Croatia,Scotland,0,1,FIFA World Cup qualification,Zagreb,Croatia,0,4,1222,74,481,-70,741,L,2,1,0
2013-06-07 00:00:00.000000,Czech Republic,Italy,0,0,FIFA World Cup qualification,Prague,Czech Republic,0,24,853,8,1097,16,-244,D,1,1,0
2013-06-07 00:00:00.000000,Estonia,Trinidad and Tobago,1,0,Friendly,Tallinn,Estonia,0,89,408,81,447,8,-39,W,0,1,0
2013-06-07 00:00:00.000000,Finland,Belarus,1,0,FIFA World Cup qualification,Helsinki,Finland,0,84,442,67,506,17,-64,W,0,1,0
2013-06-07 00:00:00.000000,Iceland,Slovenia,2,4,FIFA World Cup qualification,Reykjavík,Iceland,0,61,541,55,568,6,-27,L,2,1,0
2013-06-07 00:00:00.000000,Indonesia,Netherlands,0,3,Friendly,Jakarta,Indonesia,0,170,116,5,1158,165,-1042,L,2,1,0
2013-06-07 00:00:00.000000,Jamaica,USA,1,2,FIFA World Cup qualification,Kingston,Jamaica,0,49,602,28,798,21,-196,L,2,1,0
2013-06-07 00:00:00.000000,Laos,Singapore,2,5,Friendly,Vientiane,Laos,0,168,118,165,134,3,-16,L,2,1,0
2013-06-07 00:00:00.000000,Libya,Congo DR,0,0,FIFA World Cup qualification,Tripoli,Libya,0,69,498,79,454,-10,44,D,1,1,0
2013-06-07 00:00:00.000000,Liechtenstein,Slovakia,1,1,FIFA World Cup qualification,Vaduz,Liechtenstein,0,158,145,56,565,102,-420,D,1,1,0
2013-06-07 00:00:00.000000,Lithuania,Greece,0,1,FIFA World Cup qualification,Vilnius,Lithuania,0,105,330,16,1006,89,-676,L,2,1,0
2013-06-07 00:00:00.000000,Moldova,Poland,1,1,FIFA World Cup qualification,Chişinău,Moldova,0,134,230,65,517,69,-287,D,1,1,0
2013-06-07 00:00:00.000000,Montenegro,Ukraine,0,4,FIFA World Cup qualification,Podgorica,Montenegro,0,25,841,39,687,-14,154,L,2,1,0
2013-06-07 00:00:00.000000,Panama,Mexico,0,0,FIFA World Cup qualification,Panama City,Panama,0,43,649,17,928,26,-279,D,1,1,0
2013-06-07 00:00:00.000000,Paraguay,Chile,1,2,FIFA World Cup qualification,Asunción,Paraguay,0,44,640,25,841,19,-201,L,2,1,0
2013-06-07 00:00:00.000000,Peru,Ecuador,1,0,FIFA World Cup qualification,Lima,Peru,0,30,791,10,1066,20,-275,W,0,1,0
2013-06-07 00:00:00.000000,Portugal,Russia,1,0,FIFA World Cup qualification,Lisbon,Portugal,0,6,1137,11,1059,-5,78,W,0,1,0
2013-06-07 00:00:00.000000,Sudan,Ghana,1,3,FIFA World Cup qualification,Omdurman,Sudan,0,135,224,21,887,114,-663,L,2,1,0
2013-06-08 00:00:00.000000,Angola,Senegal,1,1,FIFA World Cup qualification,Luanda,Angola,0,91,406,99,366,-8,40,D,1,1,0
2013-06-08 00:00:00.000000,Botswana,Ethiopia,3,0,FIFA World Cup qualification,Lobatse,Botswana,0,127,245,106,328,21,-83,W,0,1,0
2013-06-08 00:00:00.000000,Central African Republic,South Africa,0,3,FIFA World Cup qualification,Yaoundé,Cameroon,1,59,543,60,542,-1,1,L,2,0,0
2013-06-08 00:00:00.000000,Gabon,Congo,0,0,FIFA World Cup qualification,Franceville,Gabon,0,82,444,80,452,2,-8,D,1,1,0
2013-06-08 00:00:00.000000,Haiti,Spain,1,2,Friendly,Miami Gardens,USA,1,63,538,1,1614,62,-1076,L,2,0,0
2013-06-08 00:00:00.000000,Morocco,Tanzania,2,1,FIFA World Cup qualification,Marrakech,Morocco,0,77,463,109,317,-32,146,W,0,1,0
2013-06-08 00:00:00.000000,Sierra Leone,Tunisia,2,2,FIFA World Cup qualification,Freetown,Sierra Leone,0,70,497,42,652,28,-155,D,1,1,0
2013-06-08 00:00:00.000000,Switzerland,Cyprus,1,0,FIFA World Cup qualification,Geneva,Switzerland,0,14,1010,122,269,-108,741,W,0,1,0
2013-06-08 00:00:00.000000,Uganda,Liberia,1,0,FIFA World Cup qualification,Kampala,Uganda,0,93,401,100,356,-7,45,W,0,1,0
2013-06-08 00:00:00.000000,Zambia,Lesotho,4,0,FIFA World Cup qualification,Ndola,Zambia,0,49,602,153,156,-104,446,W,0,1,0
2013-06-09 00:00:00.000000,Benin,Algeria,1,3,FIFA World Cup qualification,Porto-Novo,Benin,0,115,308,35,737,80,-429,L,2,1,0
2013-06-09 00:00:00.000000,Brazil,France,3,0,Friendly,Porto Alegre,Brazil,0,22,872,18,922,4,-50,W,0,1,0
2013-06-09 00:00:00.000000,Guinea,Mozambique,6,1,FIFA World Cup qualification,Conakry,Guinea,0,85,438,103,349,-18,89,W,0,1,0
2013-06-09 00:00:00.000000,Mali,Rwanda,1,1,FIFA World Cup qualification,Bamako,Mali,0,23,869,135,224,-112,645,D,1,1,0
2013-06-09 00:00:00.000000,Niger,Burkina Faso,0,1,FIFA World Cup qualification,Niamey,Niger,0,107,325,51,594,56,-269,L,2,1,0
2013-06-09 00:00:00.000000,Togo,Cameroon,0,3,FIFA World Cup qualification,Lomé,Togo,0,73,483,65,517,8,-34,L,2,1,0
2013-06-09 00:00:00.000000,Zimbabwe,Egypt,2,4,FIFA World Cup qualification,Harare,Zimbabwe,0,102,350,71,491,31,-141,L,2,1,0
2013-06-10 00:00:00.000000,Croatia,Portugal,0,1,Friendly,Geneva,Switzerland,1,4,1222,6,1137,-2,85,L,2,0,0
2013-06-11 00:00:00.000000,Australia,Jordan,4,0,FIFA World Cup qualification,Melbourne,Australia,0,47,619,75,472,-28,147,W,0,1,0
2013-06-11 00:00:00.000000,Belarus,Finland,1,1,FIFA World Cup qualification,Homel,Belarus,0,67,506,84,442,-17,64,D,1,1,0
2013-06-11 00:00:00.000000,Chile,Bolivia,3,1,FIFA World Cup qualification,Santiago,Chile,0,25,841,53,578,-28,263,W,0,1,0
2013-06-11 00:00:00.000000,Colombia,Peru,2,0,FIFA World Cup qualification,Barranquilla,Colombia,0,7,1123,30,791,-23,332,W,0,1,0
2013-06-11 00:00:00.000000,Denmark,Armenia,0,4,FIFA World Cup qualification,Copenhagen,Denmark,0,20,890,89,408,-69,482,L,2,1,0
2013-06-11 00:00:00.000000,Ecuador,Argentina,1,1,FIFA World Cup qualification,Quito,Ecuador,0,10,1066,3,1287,7,-221,D,1,1,0
2013-06-11 00:00:00.000000,Guatemala,Belize,0,0,Friendly,Antigua Guatemala,Guatemala,0,88,410,129,239,-41,171,D,1,1,0
2013-06-11 00:00:00.000000,Honduras,Jamaica,2,0,FIFA World Cup qualification,Tegucigalpa,Honduras,0,52,582,49,602,3,-20,W,0,1,0
2013-06-11 00:00:00.000000,Iran,Lebanon,4,0,FIFA World Cup qualification,Teheran,Iran,0,67,506,131,233,-64,273,W,0,1,0
2013-06-11 00:00:00.000000,Iraq,Japan,0,1,FIFA World Cup qualification,Doha,Qatar,1,98,370,32,765,66,-395,L,2,0,0
2013-06-11 00:00:00.000000,Italy,Haiti,2,2,Friendly,Rio de Janeiro,Brazil,1,8,1097,63,538,-55,559,D,1,0,0
2013-06-11 00:00:00.000000,Korea Republic,Uzbekistan,1,0,FIFA World Cup qualification,Seoul,Korea Republic,0,40,666,58,550,-18,116,W,0,1,0
2013-06-11 00:00:00.000000,Mexico,Costa Rica,0,0,FIFA World Cup qualification,Mexico City,Mexico,0,17,928,48,617,-31,311,D,1,1,0
2013-06-11 00:00:00.000000,Qatar,Korea DPR,0,0,Friendly,Doha,Qatar,0,104,338,114,309,-10,29,D,1,1,0
2013-06-11 00:00:00.000000,Sweden,Faroe Islands,2,0,FIFA World Cup qualification,Solna,Sweden,0,27,830,162,138,-135,692,W,0,1,0
2013-06-11 00:00:00.000000,USA,Panama,2,0,FIFA World Cup qualification,Seattle,USA,0,28,798,43,649,-15,149,W,0,1,0
2013-06-11 00:00:00.000000,Venezuela,Uruguay,0,1,FIFA World Cup qualification,Puerto Ordaz,Venezuela,0,37,712,19,913,18,-201,L,2,1,0
2013-06-12 00:00:00.000000,Malawi,Kenya,2,2,FIFA World Cup qualification,Blantyre,Malawi,0,109,317,123,268,-14,49,D,1,1,0
2013-06-12 00:00:00.000000,Namibia,Nigeria,1,1,FIFA World Cup qualification,Windhoek,Namibia,0,120,281,31,785,89,-504,D,1,1,0
2013-06-14 00:00:00.000000,Guatemala,Argentina,0,4,Friendly,Guatemala,Guatemala,0,88,410,3,1287,85,-877,L,2,1,0
2013-06-14 00:00:00.000000,Libya,Togo,2,0,FIFA World Cup qualification,Tripoli,Libya,0,69,498,73,483,-4,15,W,0,1,0
2013-06-15 00:00:00.000000,Botswana,Central African Republic,3,2,FIFA World Cup qualification,Lobatse,Botswana,0,127,245,59,543,68,-298,W,0,1,0
2013-06-15 00:00:00.000000,Brazil,Japan,3,0,Confederations Cup,Brasília,Brazil,0,22,872,32,765,-10,107,W,0,1,0
2013-06-15 00:00:00.000000,Congo,Burkina Faso,0,1,FIFA World Cup qualification,Pointe-Noire,Congo,0,80,452,51,594,29,-142,L,2,1,0
2013-06-15 00:00:00.000000,Gabon,Niger,4,1,FIFA World Cup qualification,Franceville,Gabon,0,82,444,107,325,-25,119,W,0,1,0
2013-06-15 00:00:00.000000,Morocco,Gambia,2,0,FIFA World Cup qualification,Marrakech,Morocco,0,77,463,162,138,-85,325,W,0,1,0
2013-06-15 00:00:00.000000,Uganda,Angola,2,1,FIFA World Cup qualification,Kampala,Uganda,0,93,401,91,406,2,-5,W,0,1,0
2013-06-15 00:00:00.000000,Zambia,Sudan,1,1,FIFA World Cup qualification,Ndola,Zambia,0,49,602,135,224,-86,378,D,1,1,0
2013-06-16 00:00:00.000000,Congo DR,Cameroon,0,0,FIFA World Cup qualification,Kinshasa,Congo DR,0,79,454,65,517,14,-63,D,1,1,0
2013-06-16 00:00:00.000000,Equatorial Guinea,Tunisia,1,1,FIFA World Cup qualification,Malabo,Equatorial Guinea,0,64,523,42,652,22,-129,D,1,1,0
2013-06-16 00:00:00.000000,Ethiopia,South Africa,2,1,FIFA World Cup qualification,Addis Ababa,Ethiopia,0,106,328,60,542,46,-214,W,0,1,0
2013-06-16 00:00:00.000000,Guinea,Zimbabwe,2,0,FIFA World Cup qualification,Conakry,Guinea,0,85,438,102,350,-17,88,W,0,1,0
2013-06-16 00:00:00.000000,Lesotho,Ghana,0,2,FIFA World Cup qualification,Maseru,Lesotho,0,153,156,21,887,132,-731,L,2,1,0
2013-06-16 00:00:00.000000,Liberia,Senegal,0,2,FIFA World Cup qualification,Paynesville,Liberia,0,100,356,99,366,1,-10,L,2,1,0
2013-06-16 00:00:00.000000,Mali,Benin,2,2,FIFA World Cup qualification,Bamako,Mali,0,23,869,115,308,-92,561,D,1,1,0
2013-06-16 00:00:00.000000,Mexico,Italy,1,2,Confederations Cup,Rio de Janeiro,Brazil,1,17,928,8,1097,9,-169,L,2,0,0
2013-06-16 00:00:00.000000,Mozambique,Egypt,0,1,FIFA World Cup qualification,Maputo,Mozambique,0,103,349,71,491,32,-142,L,2,1,0
2013-06-16 00:00:00.000000,Rwanda,Algeria,0,1,FIFA World Cup qualification,Kigali,Rwanda,0,135,224,35,737,100,-513,L,2,1,0
2013-06-16 00:00:00.000000,Spain,Uruguay,2,1,Confederations Cup,Recife,Brazil,1,1,1614,19,913,-18,701,W,0,0,0
2013-06-17 00:00:00.000000,Tahiti,Nigeria,1,6,Confederations Cup,Belo Horizonte,Brazil,1,138,215,31,785,107,-570,L,2,0,0
2013-06-18 00:00:00.000000,Australia,Iraq,1,0,FIFA World Cup qualification,Sydney,Australia,0,47,619,98,370,-51,249,W,0,1,0
2013-06-18 00:00:00.000000,Costa Rica,Panama,2,0,FIFA World Cup qualification,San José,Costa Rica,0,48,617,43,649,5,-32,W,0,1,0
2013-06-18 00:00:00.000000,Jordan,Oman,1,0,FIFA World Cup qualification,Amman,Jordan,0,75,472,101,351,-26,121,W,0,1,0
2013-06-18 00:00:00.000000,Korea Republic,Iran,0,1,FIFA World Cup qualification,Ulsan,Korea Republic,0,40,666,67,506,-27,160,L,2,1,0
2013-06-18 00:00:00.000000,USA,Honduras,1,0,FIFA World Cup qualification,Sandy,USA,0,28,798,52,582,-24,216,W,0,1,0
2013-06-18 00:00:00.000000,Uzbekistan,Qatar,5,1,FIFA World Cup qualification,Tashkent,Uzbekistan,0,58,550,104,338,-46,212,W,0,1,0
2013-06-19 00:00:00.000000,Brazil,Mexico,2,0,Confederations Cup,Fortaleza,Brazil,0,22,872,17,928,5,-56,W,0,1,0
2013-06-19 00:00:00.000000,Italy,Japan,4,3,Confederations Cup,Recife,Brazil,1,8,1097,32,765,-24,332,W,0,0,0
2013-06-20 00:00:00.000000,Nigeria,Uruguay,1,2,Confederations Cup,Salvador,Brazil,1,31,785,19,913,12,-128,L,2,0,0
2013-06-20 00:00:00.000000,Spain,Tahiti,10,0,Confederations Cup,Rio de Janeiro,Brazil,1,1,1614,138,215,-137,1399,W,0,0,0
2013-06-22 00:00:00.000000,Brazil,Italy,4,2,Confederations Cup,Salvador,Brazil,0,22,872,8,1097,14,-225,W,0,1,0
2013-06-22 00:00:00.000000,Japan,Mexico,1,2,Confederations Cup,Belo Horizonte,Brazil,1,32,765,17,928,15,-163,L,2,0,0
2013-06-23 00:00:00.000000,Nigeria,Spain,0,3,Confederations Cup,Fortaleza,Brazil,1,31,785,1,1614,30,-829,L,2,0,0
2013-06-23 00:00:00.000000,Swaziland,Angola,0,1,African Nations Championship,Lobamba,Swaziland,0,178,65,91,406,87,-341,L,2,1,0
2013-06-23 00:00:00.000000,Uruguay,Tahiti,8,0,Confederations Cup,Recife,Brazil,1,19,913,138,215,-119,698,W,0,0,0
2013-06-26 00:00:00.000000,Brazil,Uruguay,2,1,Confederations Cup,Belo Horizonte,Brazil,0,22,872,19,913,3,-41,W,0,1,0
2013-06-27 00:00:00.000000,Spain,Italy,0,0,Confederations Cup,Fortaleza,Brazil,1,1,1614,8,1097,-7,517,D,1,0,0
2013-06-29 00:00:00.000000,Angola,Swaziland,1,0,African Nations Championship,Luanda,Angola,0,91,406,178,65,-87,341,W,0,1,0
2013-06-29 00:00:00.000000,Libya,Burkina Faso,2,1,Friendly,Misrata,Libya,0,69,498,51,594,18,-96,W,0,1,0
2013-06-30 00:00:00.000000,Brazil,Spain,3,0,Confederations Cup,Rio de Janeiro,Brazil,0,22,872,1,1614,21,-742,W,0,1,0
2013-06-30 00:00:00.000000,Uruguay,Italy,2,2,Confederations Cup,Salvador,Brazil,1,19,913,8,1097,11,-184,D,1,0,0
2013-07-05 00:00:00.000000,Mali,Guinea,3,1,African Nations Championship,Bamako,Mali,0,28,774,61,545,-33,229,W,0,1,0
2013-07-06 00:00:00.000000,Namibia,Mauritius,2,1,COSAFA Cup,Lusaka,Zambia,1,127,252,182,52,-55,200,W,0,0,0
2013-07-07 00:00:00.000000,Botswana,Swaziland,0,0,COSAFA Cup,Kitwe,Zambia,1,116,301,179,60,-63,241,D,1,0,0
2013-07-07 00:00:00.000000,Congo DR,Congo,2,1,African Nations Championship,Kinshasa,Congo DR,0,84,434,90,396,-6,38,W,0,1,0
2013-07-07 00:00:00.000000,Mexico,Panama,1,2,Gold Cup,Pasadena,USA,1,20,880,51,601,-31,279,L,2,0,0
2013-07-08 00:00:00.000000,El Salvador,Trinidad and Tobago,2,2,Gold Cup,Harrison,USA,1,94,382,87,419,7,-37,D,1,0,0
2013-07-08 00:00:00.000000,Haiti,Honduras,0,2,Gold Cup,Harrison,USA,1,69,522,55,582,14,-60,L,2,0,0
2013-07-08 00:00:00.000000,Kenya,Lesotho,2,2,COSAFA Cup,Kitwe,Zambia,1,123,264,161,133,-38,131,D,1,0,0
2013-07-08 00:00:00.000000,Namibia,Seychelles,4,2,COSAFA Cup,Lusaka,Zambia,1,127,252,200,19,-73,233,W,0,0,0
2013-07-09 00:00:00.000000,Costa Rica,Cuba,3,0,Gold Cup,Portland,USA,1,39,688,82,458,-43,230,W,0,0,0
2013-07-09 00:00:00.000000,Kenya,Swaziland,2,0,COSAFA Cup,Kitwe,Zambia,1,123,264,179,60,-56,204,W,0,0,0
2013-07-09 00:00:00.000000,Lesotho,Botswana,3,3,COSAFA Cup,Kitwe,Zambia,1,161,133,116,301,45,-168,D,1,0,0
2013-07-09 00:00:00.000000,USA,Belize,6,1,Gold Cup,Portland,USA,0,22,865,130,242,-108,623,W,0,1,0
2013-07-10 00:00:00.000000,Mauritius,Seychelles,4,0,COSAFA Cup,Kitwe,Zambia,1,182,52,200,19,-18,33,W,0,0,0
2013-07-11 00:00:00.000000,Kenya,Botswana,1,2,COSAFA Cup,Kitwe,Zambia,1,123,264,116,301,7,-37,L,2,0,0
2013-07-11 00:00:00.000000,Lesotho,Swaziland,2,0,COSAFA Cup,Lusaka,Zambia,1,161,133,179,60,-18,73,W,0,0,0
2013-07-11 00:00:00.000000,Mexico,Canada,2,0,Gold Cup,Seattle,USA,1,20,880,88,413,-68,467,W,0,0,0
2013-07-12 00:00:00.000000,Honduras,El Salvador,1,0,Gold Cup,Miami Gardens,USA,1,55,582,94,382,-39,200,W,0,0,0
2013-07-12 00:00:00.000000,Trinidad and Tobago,Haiti,0,2,Gold Cup,Miami Gardens,USA,1,87,419,69,522,18,-103,L,2,0,0
2013-07-13 00:00:00.000000,Costa Rica,Belize,1,0,Gold Cup,Sandy,USA,1,39,688,130,242,-91,446,W,0,0,0
2013-07-13 00:00:00.000000,Morocco,Tunisia,0,0,African Nations Championship,Tangier,Morocco,0,79,470,47,627,32,-157,D,1,1,0
2013-07-13 00:00:00.000000,South Africa,Namibia,2,1,COSAFA Cup,Lusaka,Zambia,1,59,558,127,252,-68,306,W,0,0,0
2013-07-13 00:00:00.000000,USA,Cuba,4,1,Gold Cup,Sandy,USA,0,22,865,82,458,-60,407,W,0,1,0
2013-07-13 00:00:00.000000,Zimbabwe,Malawi,1,1,COSAFA Cup,Lusaka,Zambia,1,114,304,108,312,6,-8,D,1,0,0
2013-07-14 00:00:00.000000,Panama,Canada,0,0,Gold Cup,Denver,USA,1,51,601,88,413,-37,188,D,1,0,0
2013-07-14 00:00:00.000000,Zambia,Mozambique,3,1,COSAFA Cup,Kitwe,Zambia,0,60,554,102,326,-42,228,W,0,1,0
2013-07-15 00:00:00.000000,El Salvador,Haiti,1,0,Gold Cup,Houston,USA,1,94,382,69,522,25,-140,W,0,0,0
2013-07-15 00:00:00.000000,Honduras,Trinidad and Tobago,0,2,Gold Cup,Houston,USA,1,55,582,87,419,-32,163,L,2,0,0
2013-07-16 00:00:00.000000,Cuba,Belize,4,0,Gold Cup,East Hartford,USA,1,82,458,130,242,-48,216,W,0,0,0
2013-07-16 00:00:00.000000,Namibia,Mozambique,0,1,COSAFA Cup,Kitwe,Zambia,1,127,252,102,326,25,-74,L,2,0,0
2013-07-16 00:00:00.000000,USA,Costa Rica,1,0,Gold Cup,East Hartford,USA,0,22,865,39,688,-17,177,W,0,1,0
2013-07-17 00:00:00.000000,Zambia,South Africa,0,0,COSAFA Cup,Ndola,Zambia,0,60,554,59,558,1,-4,D,1,1,0
2013-07-17 00:00:00.000000,Zimbabwe,Lesotho,2,1,COSAFA Cup,Ndola,Zambia,1,114,304,161,133,-47,171,W,0,0,0
2013-07-20 00:00:00.000000,Korea Republic,Australia,0,0,EAFF Championship,Seoul,Korea Republic,0,43,642,40,671,3,-29,D,1,1,0
2013-07-20 00:00:00.000000,Lesotho,South Africa,1,2,COSAFA Cup,Ndola,Zambia,1,161,133,59,558,102,-425,L,2,0,0
2013-07-20 00:00:00.000000,Mauritania,Senegal,2,0,African Nations Championship,Nouakchott,Mauritania,0,172,94,74,497,98,-403,W,0,1,0
2013-07-20 00:00:00.000000,Mexico,Trinidad and Tobago,1,0,Gold Cup,Atlanta,USA,1,20,880,87,419,-67,461,W,0,0,0
2013-07-20 00:00:00.000000,Panama,Cuba,6,1,Gold Cup,Atlanta,USA,1,51,601,82,458,-31,143,W,0,0,0
2013-07-20 00:00:00.000000,Zambia,Zimbabwe,2,0,COSAFA Cup,Ndola,Zambia,0,60,554,114,304,-54,250,W,0,1,0
2013-07-21 00:00:00.000000,Honduras,Costa Rica,1,0,Gold Cup,Baltimore,USA,1,55,582,39,688,16,-106,W,0,0,0
2013-07-21 00:00:00.000000,USA,El Salvador,5,1,Gold Cup,Baltimore,USA,0,22,865,94,382,-72,483,W,0,1,0
2013-07-24 00:00:00.000000,Panama,Mexico,2,1,Gold Cup,Arlington,USA,1,51,601,20,880,31,-279,W,0,0,0
2013-07-24 00:00:00.000000,USA,Honduras,3,1,Gold Cup,Arlington,USA,0,22,865,55,582,-33,283,W,0,1,0
2013-07-25 00:00:00.000000,Japan,Australia,3,2,EAFF Championship,Hwaseong,Korea Republic,1,37,689,40,671,-3,18,W,0,0,0
2013-07-27 00:00:00.000000,Niger,Burkina Faso,1,0,African Nations Championship,Niamey,Niger,0,107,313,42,656,65,-343,W,0,1,0
2013-07-27 00:00:00.000000,Rwanda,Ethiopia,1,0,African Nations Championship,Kigali,Rwanda,0,134,233,95,381,39,-148,W,0,1,0
2013-07-27 00:00:00.000000,Uganda,Tanzania,3,1,African Nations Championship,Kampala,Uganda,0,80,466,121,271,-41,195,W,0,1,0
2013-07-28 00:00:00.000000,Cameroon,Gabon,1,0,African Nations Championship,Yaoundé,Cameroon,0,71,517,81,459,-10,58,W,0,1,0
2013-07-28 00:00:00.000000,Congo,Congo DR,1,0,African Nations Championship,Dolisie,Congo,0,90,396,84,434,6,-38,W,0,1,0
2013-07-28 00:00:00.000000,Guinea,Mali,1,0,African Nations Championship,Conakry,Guinea,0,61,545,28,774,33,-229,W,0,1,0
2013-07-28 00:00:00.000000,Korea Republic,Japan,1,2,EAFF Championship,Seoul,Korea Republic,0,43,642,37,689,6,-47,L,2,1,0
2013-07-28 00:00:00.000000,Mauritius,Zimbabwe,0,3,African Nations Championship,Curepipe,Mauritius,0,182,52,114,304,68,-252,L,2,1,0
2013-07-28 00:00:00.000000,Mozambique,Namibia,3,0,African Nations Championship,Maputo,Mozambique,0,102,326,127,252,-25,74,W,0,1,0
2013-07-28 00:00:00.000000,Sudan,Burundi,1,1,African Nations Championship,Omdurman,Sudan,0,134,233,120,273,14,-40,D,1,1,0
2013-07-28 00:00:00.000000,USA,Panama,1,0,Gold Cup,Chicago,USA,0,22,865,51,601,-29,264,W,0,1,0
2013-08-02 00:00:00.000000,Namibia,Mozambique,3,0,African Nations Championship,Windhoek,Namibia,0,127,252,102,326,25,-74,W,0,1,0
2013-08-02 00:00:00.000000,Zimbabwe,Mauritius,1,0,African Nations Championship,Harare,Zimbabwe,0,114,304,182,52,-68,252,W,0,1,0
2013-08-09 00:00:00.000000,Gabon,Cameroon,1,0,African Nations Championship,Libreville,Gabon,0,81,440,51,604,30,-164,W,0,1,0
2013-08-09 00:00:00.000000,Jordan,Libya,2,1,Friendly,Amman,Jordan,0,71,495,69,518,2,-23,W,0,1,0
2013-08-14 00:00:00.000000,Albania,Armenia,2,0,Friendly,Tirana,Albania,0,38,689,66,534,-28,155,W,0,1,0
2013-08-14 00:00:00.000000,Algeria,Guinea,2,2,Friendly,Blida,Algeria,0,34,730,68,526,-34,204,D,1,1,0
2013-08-14 00:00:00.000000,Austria,Greece,0,2,Friendly,Salzburg,Austria,0,55,595,11,1038,44,-443,L,2,1,0
2013-08-14 00:00:00.000000,Azerbaijan,Malta,3,0,Friendly,Baku,Azerbaijan,0,115,298,134,236,-19,62,W,0,1,0
2013-08-14 00:00:00.000000,Belarus,Montenegro,1,1,Friendly,Zhodzina,Belarus,0,73,482,28,774,45,-292,D,1,1,0
2013-08-14 00:00:00.000000,Belgium,France,0,0,Friendly,Brussels,Belgium,0,10,1079,23,838,-13,241,D,1,1,0
2013-08-14 00:00:00.000000,Chile,Iraq,6,0,Friendly,Brøndby,Denmark,1,21,871,104,328,-83,543,W,0,0,0
2013-08-14 00:00:00.000000,Colombia,Serbia,1,0,Friendly,Barcelona,Spain,1,3,1219,41,661,-38,558,W,0,0,0
2013-08-14 00:00:00.000000,Dominican Republic,Costa Rica,0,4,Friendly,Santo Domingo,Dominican Republic,0,86,421,42,651,44,-230,L,2,1,0
2013-08-14 00:00:00.000000,Ecuador,Spain,0,2,Friendly,Guayaquil,Ecuador,0,17,972,1,1484,16,-512,L,2,1,0
2013-08-14 00:00:00.000000,Egypt,Uganda,3,0,Friendly,el-Gouna,Egypt,0,61,544,77,468,-16,76,W,0,1,0
2013-08-14 00:00:00.000000,England,Scotland,3,2,Friendly,London,England,0,14,994,50,610,-36,384,W,0,1,0
2013-08-14 00:00:00.000000,Estonia,Latvia,1,1,Friendly,Tallinn,Estonia,0,85,423,119,280,-34,143,D,1,1,0
2013-08-14 00:00:00.000000,Finland,Slovenia,2,0,Friendly,Turku,Finland,0,65,537,45,634,20,-97,W,0,1,0
2013-08-14 00:00:00.000000,Germany,Paraguay,3,3,Friendly,Kaiserslautern,Germany,0,2,1257,49,614,-47,643,D,1,1,0
2013-08-14 00:00:00.000000,Hungary,Czech Republic,1,1,Friendly,Budapest,Hungary,0,31,749,26,797,5,-48,D,1,1,0
2013-08-14 00:00:00.000000,Iceland,Faroe Islands,1,0,Friendly,Reykjavík,Iceland,0,70,499,175,81,-105,418,W,0,1,0
2013-08-14 00:00:00.000000,Indonesia,Philippines,2,0,Friendly,Surakarta,Indonesia,0,169,99,141,208,28,-109,W,0,1,0
2013-08-14 00:00:00.000000,Italy,Argentina,1,2,Friendly,Rome,Italy,0,6,1142,4,1210,2,-68,L,2,1,0
2013-08-14 00:00:00.000000,Japan,Uruguay,2,4,Friendly,Rifu,Japan,0,37,695,12,998,25,-303,L,2,1,0
2013-08-14 00:00:00.000000,Kazakhstan,Georgia,1,0,Friendly,Astana,Kazakhstan,0,149,172,97,369,52,-197,W,0,1,0
2013-08-14 00:00:00.000000,Korea Republic,Peru,0,0,Friendly,Suwon,Korea Republic,0,56,594,22,855,34,-261,D,1,1,0
2013-08-14 00:00:00.000000,Libya,Central African Republic,0,0,Friendly,Tripoli,Libya,0,69,518,88,398,-19,120,D,1,1,0
2013-08-14 00:00:00.000000,Liechtenstein,Croatia,2,3,Friendly,Vaduz,Liechtenstein,0,148,173,8,1098,140,-925,L,2,1,0
2013-08-14 00:00:00.000000,Luxembourg,Lithuania,2,1,Friendly,Luxembourg,Luxembourg,0,140,210,106,321,34,-111,W,0,1,0
2013-08-14 00:00:00.000000,Moldova,Andorra,1,1,Friendly,Chișinău,Moldova,0,123,256,205,8,-82,248,D,1,1,0
2013-08-14 00:00:00.000000,Morocco,Burkina Faso,1,2,Friendly,Tangier,Morocco,0,75,474,48,618,27,-144,L,2,1,0
2013-08-14 00:00:00.000000,Northern Ireland,Russia,1,0,FIFA World Cup qualification,Belfast,Northern Ireland,0,109,307,16,979,93,-672,W,0,1,0
2013-08-14 00:00:00.000000,Poland,Denmark,3,2,Friendly,Gdańsk,Poland,0,72,493,27,788,45,-295,W,0,1,0
2013-08-14 00:00:00.000000,Portugal,Netherlands,1,1,Friendly,Faro,Portugal,0,7,1099,5,1165,2,-66,D,1,1,0
2013-08-14 00:00:00.000000,Romania,Slovakia,1,1,Friendly,Bucharest,Romania,0,33,732,62,542,-29,190,D,1,1,0
2013-08-14 00:00:00.000000,Rwanda,Malawi,0,1,Friendly,Kigali,Rwanda,0,131,240,118,283,13,-43,L,2,1,0
2013-08-14 00:00:00.000000,Singapore,Oman,0,2,AFC Asian Cup qualification,Jalan Besar,Singapore,0,155,142,95,370,60,-228,L,2,1,0
2013-08-14 00:00:00.000000,South Africa,Nigeria,0,2,Friendly,Durban,South Africa,0,67,530,35,700,32,-170,L,2,1,0
2013-08-14 00:00:00.000000,Sweden,Norway,4,2,Friendly,Solna,Sweden,0,30,765,25,801,5,-36,W,0,1,0
2013-08-14 00:00:00.000000,Switzerland,Brazil,1,0,Friendly,Basel,Switzerland,0,15,987,9,1089,6,-102,W,0,1,0
2013-08-14 00:00:00.000000,Tajikistan,India,3,0,Friendly,Khujand,Tajikistan,0,114,301,145,177,-31,124,W,0,1,0
2013-08-14 00:00:00.000000,Tunisia,Congo,3,0,Friendly,Radès,Tunisia,0,53,596,92,385,-39,211,W,0,1,0
2013-08-14 00:00:00.000000,Turkey,Ghana,2,2,Friendly,Istanbul,Turkey,0,58,573,24,830,34,-257,D,1,1,0
2013-08-14 00:00:00.000000,Ukraine,Israel,2,0,Friendly,Kyïv,Ukraine,0,28,774,63,540,-35,234,W,0,1,0
2013-08-14 00:00:00.000000,Venezuela,Bolivia,2,2,Friendly,San Cristóbal,Venezuela,0,39,688,64,538,-25,150,D,1,1,0
2013-08-14 00:00:00.000000,Zambia,Senegal,1,1,Friendly,Saint-Leu-la-Forêt,France,1,60,550,78,452,-18,98,D,1,0,0
2013-08-15 00:00:00.000000,Syria,Jordan,1,1,AFC Asian Cup qualification,Teheran,Iran,1,147,174,71,495,76,-321,D,1,0,0
2013-08-17 00:00:00.000000,South Africa,Burkina Faso,2,0,Friendly,Johannesburg,South Africa,0,67,530,48,618,19,-88,W,0,1,0
2013-08-18 00:00:00.000000,Zimbabwe,Zambia,0,0,African Nations Championship,Harare,Zimbabwe,0,116,292,60,550,56,-258,D,1,1,0
2013-08-20 00:00:00.000000,Afghanistan,Pakistan,3,0,Friendly,Kabul,Afghanistan,0,139,214,167,114,-28,100,W,0,1,0
2013-08-24 00:00:00.000000,Zambia,Zimbabwe,0,1,African Nations Championship,Ndola,Zambia,0,60,550,116,292,-56,258,L,2,1,0
2013-08-25 00:00:00.000000,Mozambique,Angola,0,0,African Nations Championship,Maputo,Mozambique,0,108,314,98,364,10,-50,D,1,1,0
2013-08-26 00:00:00.000000,Cameroon,Congo DR,0,1,African Nations Championship,Garoua,Cameroon,0,51,604,87,407,-36,197,L,2,1,0
2013-08-27 00:00:00.000000,Libya,Mali,1,0,Friendly,Aïn Draham,Tunisia,1,69,518,32,735,37,-217,W,0,0,0
2013-08-30 00:00:00.000000,Botswana,Uganda,1,3,Friendly,Gaborone,Botswana,0,101,339,77,468,24,-129,L,2,1,0
2013-08-30 00:00:00.000000,Congo DR,Cameroon,1,1,African Nations Championship,Lubumbashi,Congo DR,0,87,407,51,604,36,-197,D,1,1,0
2013-08-30 00:00:00.000000,Libya,Ghana,1,0,Friendly,Aïn Draham,Tunisia,1,69,518,24,830,45,-312,W,0,0,0
2013-08-31 00:00:00.000000,Angola,Mozambique,1,1,African Nations Championship,Benguela,Angola,0,98,364,108,314,-10,50,D,1,1,0
2013-08-31 00:00:00.000000,Nepal,Bangladesh,2,0,SAFF Cup,Kathmandu,Nepal,0,170,95,158,138,12,-43,W,0,1,0
2013-09-01 00:00:00.000000,India,Pakistan,1,0,SAFF Cup,Kathmandu,Nepal,1,145,177,167,114,-22,63,W,0,0,0
2013-09-02 00:00:00.000000,Afghanistan,Bhutan,3,0,SAFF Cup,Kathmandu,Nepal,1,139,214,207,0,-68,214,W,0,0,0
2013-09-02 00:00:00.000000,Maldives,Sri Lanka,10,0,SAFF Cup,Kathmandu,Nepal,1,153,150,170,95,-17,55,W,0,0,0
2013-09-03 00:00:00.000000,Bangladesh,India,1,1,SAFF Cup,Kathmandu,Nepal,1,158,138,145,177,13,-39,D,1,0,0
2013-09-03 00:00:00.000000,Botswana,Malawi,1,0,Friendly,Gaborone,Botswana,0,101,339,118,283,-17,56,W,0,1,0
2013-09-03 00:00:00.000000,Nepal,Pakistan,1,1,SAFF Cup,Kathmandu,Nepal,0,170,95,167,114,3,-19,D,1,1,0
2013-09-04 00:00:00.000000,Bhutan,Maldives,2,8,SAFF Cup,Kathmandu,Nepal,1,207,0,153,150,54,-150,L,2,0,0
2013-09-04 00:00:00.000000,Equatorial Guinea,Libya,1,1,Friendly,Malabo,Equatorial Guinea,0,99,348,69,518,30,-170,D,1,1,0
2013-09-04 00:00:00.000000,Sri Lanka,Afghanistan,1,3,SAFF Cup,Kathmandu,Nepal,1,170,95,139,214,31,-119,L,2,0,0
2013-09-05 00:00:00.000000,Bangladesh,Pakistan,1,2,SAFF Cup,Kathmandu,Nepal,1,158,138,167,114,-9,24,L,2,0,0
2013-09-05 00:00:00.000000,Nepal,India,2,1,SAFF Cup,Kathmandu,Nepal,0,170,95,145,177,25,-82,W,0,1,0
2013-09-05 00:00:00.000000,Qatar,Mauritius,3,0,Friendly,Doha,Qatar,0,111,305,174,82,-63,223,W,0,1,0
2013-09-05 00:00:00.000000,Saudi Arabia,New Zealand,0,1,OSN Cup,Riyadh,Saudi Arabia,0,107,316,57,582,50,-266,L,2,1,0
2013-09-05 00:00:00.000000,United Arab Emirates,Trinidad and Tobago,3,3,OSN Cup,Riyadh,Saudi Arabia,1,84,429,78,452,6,-23,D,1,0,0
2013-09-06 00:00:00.000000,Afghanistan,Maldives,0,0,SAFF Cup,Kathmandu,Nepal,1,139,214,153,150,-14,64,D,1,0,0
2013-09-06 00:00:00.000000,Chile,Venezuela,3,0,FIFA World Cup qualification,Santiago,Chile,0,21,871,39,688,-18,183,W,0,1,0
2013-09-06 00:00:00.000000,Colombia,Ecuador,1,0,FIFA World Cup qualification,Barranquilla,Colombia,0,3,1219,17,972,-14,247,W,0,1,0
2013-09-06 00:00:00.000000,Costa Rica,USA,3,1,FIFA World Cup qualification,San José,Costa Rica,0,42,651,19,960,23,-309,W,0,1,0
2013-09-06 00:00:00.000000,Czech Republic,Armenia,1,2,FIFA World Cup qualification,Prague,Czech Republic,0,26,797,66,534,-40,263,L,2,1,0
2013-09-06 00:00:00.000000,England,Moldova,4,0,FIFA World Cup qualification,London,England,0,14,994,123,256,-109,738,W,0,1,0
2013-09-06 00:00:00.000000,Estonia,Netherlands,2,2,FIFA World Cup qualification,Tallinn,Estonia,0,85,423,5,1165,80,-742,D,1,1,0
2013-09-06 00:00:00.000000,Finland,Spain,0,2,FIFA World Cup qualification,Helsinki,Finland,0,65,537,1,1484,64,-947,L,2,1,0
2013-09-06 00:00:00.000000,Georgia,France,0,0,FIFA World Cup qualification,Tbilisi,Georgia,0,97,369,23,838,74,-469,D,1,1,0
2013-09-06 00:00:00.000000,Germany,Austria,3,0,FIFA World Cup qualification,Munich,Germany,0,2,1257,55,595,-53,662,W,0,1,0
2013-09-06 00:00:00.000000,Ghana,Zambia,2,1,FIFA World Cup qualification,Kumasi,Ghana,0,24,830,60,550,-36,280,W,0,1,0
2013-09-06 00:00:00.000000,Italy,Bulgaria,1,0,FIFA World Cup qualification,Palermo,Italy,0,6,1142,53,596,-47,546,W,0,1,0
2013-09-06 00:00:00.000000,Japan,Guatemala,3,0,Friendly,Osaka,Japan,0,37,695,93,377,-56,318,W,0,1,0
2013-09-06 00:00:00.000000,Jordan,Uzbekistan,1,1,FIFA World Cup qualification,Amman,Jordan,0,71,495,59,566,12,-71,D,1,1,0
2013-09-06 00:00:00.000000,Kazakhstan,Faroe Islands,2,1,FIFA World Cup qualification,Astana,Kazakhstan,0,149,172,175,81,-26,91,W,0,1,0
2013-09-06 00:00:00.000000,Korea Republic,Haiti,4,1,Friendly,Incheon,Korea Republic,0,56,594,74,476,-18,118,W,0,1,0
2013-09-06 00:00:00.000000,Kuwait,Korea DPR,2,1,Friendly,Kuwait City,Kuwait,0,112,304,110,306,2,-2,W,0,1,0
2013-09-06 00:00:00.000000,Latvia,Lithuania,2,1,FIFA World Cup qualification,Riga,Latvia,0,119,280,106,321,13,-41,W,0,1,0
2013-09-06 00:00:00.000000,Lebanon,Syria,2,0,Friendly,Beirut,Lebanon,0,120,277,147,174,-27,103,W,0,1,0
2013-09-06 00:00:00.000000,Liechtenstein,Greece,0,1,FIFA World Cup qualification,Vaduz,Liechtenstein,0,148,173,11,1038,137,-865,L,2,1,0
2013-09-06 00:00:00.000000,Malta,Denmark,1,2,FIFA World Cup qualification,Attard,Malta,0,134,236,27,788,107,-552,L,2,1,0
2013-09-06 00:00:00.000000,Mexico,Honduras,1,2,FIFA World Cup qualification,Mexico City,Mexico,0,20,879,43,640,-23,239,L,2,1,0
2013-09-06 00:00:00.000000,Northern Ireland,Portugal,2,4,FIFA World Cup qualification,Belfast,Northern Ireland,0,109,307,7,1099,102,-792,L,2,1,0
2013-09-06 00:00:00.000000,Norway,Cyprus,2,0,FIFA World Cup qualification,Oslo,Norway,0,25,801,123,256,-98,545,W,0,1,0
2013-09-06 00:00:00.000000,Panama,Jamaica,0,0,FIFA World Cup qualification,Panama City,Panama,0,40,679,76,469,-36,210,D,1,1,0
2013-09-06 00:00:00.000000,Paraguay,Bolivia,4,0,FIFA World Cup qualification,Asunción,Paraguay,0,49,614,64,538,-15,76,W,0,1,0
2013-09-06 00:00:00.000000,Peru,Uruguay,1,2,FIFA World Cup qualification,Lima,Peru,0,22,855,12,998,10,-143,L,2,1,0
2013-09-06 00:00:00.000000,Poland,Montenegro,1,1,FIFA World Cup qualification,Warsaw,Poland,0,72,493,28,774,44,-281,D,1,1,0
2013-09-06 00:00:00.000000,Romania,Hungary,3,0,FIFA World Cup qualification,Bucharest,Romania,0,33,732,31,749,2,-17,W,0,1,0
2013-09-06 00:00:00.000000,Russia,Luxembourg,4,1,FIFA World Cup qualification,Kazan,Russia,0,16,979,140,210,-124,769,W,0,1,0
2013-09-06 00:00:00.000000,Scotland,Belgium,0,2,FIFA World Cup qualification,Glasgow,Scotland,0,50,610,10,1079,40,-469,L,2,1,0
2013-09-06 00:00:00.000000,Serbia,Croatia,1,1,FIFA World Cup qualification,Belgrade,Serbia,0,41,661,8,1098,33,-437,D,1,1,0
2013-09-06 00:00:00.000000,Slovenia,Albania,1,0,FIFA World Cup qualification,Ljubljana,Slovenia,0,45,634,38,689,7,-55,W,0,1,0
2013-09-06 00:00:00.000000,Sri Lanka,Bhutan,5,2,SAFF Cup,Kathmandu,Nepal,1,170,95,207,0,-37,95,W,0,0,0
2013-09-06 00:00:00.000000,Switzerland,Iceland,4,4,FIFA World Cup qualification,Berne,Switzerland,0,15,987,70,499,-55,488,D,1,1,0
2013-09-06 00:00:00.000000,Turkey,Andorra,5,0,FIFA World Cup qualification,Kayseri,Turkey,0,58,573,205,8,-147,565,W,0,1,0
2013-09-06 00:00:00.000000,Ukraine,San Marino,9,0,FIFA World Cup qualification,L'viv,Ukraine,0,28,774,207,0,-179,774,W,0,1,0
2013-09-07 00:00:00.000000,Angola,Liberia,4,1,FIFA World Cup qualification,Lubango,Angola,0,98,364,103,335,-5,29,W,0,1,0
2013-09-07 00:00:00.000000,Brazil,Australia,6,0,Friendly,Brasília,Brazil,0,9,1089,46,630,-37,459,W,0,1,0
2013-09-07 00:00:00.000000,Burkina Faso,Gabon,1,0,FIFA World Cup qualification,Ouagadougou,Burkina Faso,0,48,618,81,440,-33,178,W,0,1,0
2013-09-07 00:00:00.000000,Central African Republic,Ethiopia,1,2,FIFA World Cup qualification,Brazzaville,Congo,1,88,398,102,338,-14,60,L,2,0,0
2013-09-07 00:00:00.000000,Gambia,Tanzania,2,0,FIFA World Cup qualification,Bakau,Gambia,0,163,124,128,249,35,-125,W,0,1,0
2013-09-07 00:00:00.000000,Israel,Azerbaijan,1,1,FIFA World Cup qualification,Ramat-Gan,Israel,0,63,540,115,298,-52,242,D,1,1,0
2013-09-07 00:00:00.000000,Niger,Congo,2,2,FIFA World Cup qualification,Niamey,Niger,0,105,323,92,385,13,-62,D,1,1,0
2013-09-07 00:00:00.000000,Nigeria,Malawi,2,0,FIFA World Cup qualification,Calabar,Nigeria,0,35,700,118,283,-83,417,W,0,1,0
2013-09-07 00:00:00.000000,Senegal,Uganda,1,0,FIFA World Cup qualification,Marrakech,Morocco,1,78,452,77,468,1,-16,W,0,0,0
2013-09-07 00:00:00.000000,Sierra Leone,Equatorial Guinea,3,2,FIFA World Cup qualification,Freetown,Sierra Leone,0,80,443,99,348,-19,95,W,0,1,0
2013-09-07 00:00:00.000000,South Africa,Botswana,4,1,FIFA World Cup qualification,Durban,South Africa,0,67,530,101,339,-34,191,W,0,1,0
2013-09-08 00:00:00.000000,Benin,Rwanda,2,0,FIFA World Cup qualification,Porto-Novo,Benin,0,113,302,131,240,-18,62,W,0,1,0
2013-09-08 00:00:00.000000,Cameroon,Libya,1,0,FIFA World Cup qualification,Yaoundé,Cameroon,0,51,604,69,518,-18,86,W,0,1,0
2013-09-08 00:00:00.000000,Canada,Mauritania,0,0,Friendly,Oliva,Spain,1,91,386,151,159,-60,227,D,1,0,0
2013-09-08 00:00:00.000000,Kenya,Namibia,1,0,FIFA World Cup qualification,Nairobi,Kenya,0,129,243,131,240,-2,3,W,0,1,0
2013-09-08 00:00:00.000000,Nepal,Afghanistan,0,1,SAFF Cup,Kathmandu,Nepal,0,170,95,139,214,31,-119,L,2,1,0
2013-09-08 00:00:00.000000,Sudan,Lesotho,1,3,FIFA World Cup qualification,Omdurman,Sudan,0,135,228,160,135,-25,93,L,2,1,0
2013-09-08 00:00:00.000000,Togo,Congo DR,2,1,FIFA World Cup qualification,Lomé,Togo,0,82,436,87,407,-5,29,W,0,1,0
2013-09-08 00:00:00.000000,Zimbabwe,Mozambique,1,1,FIFA World Cup qualification,Harare,Zimbabwe,0,116,292,108,314,8,-22,D,1,1,0
2013-09-09 00:00:00.000000,Kuwait,Bahrain,2,1,Friendly,Kuwait City,Kuwait,0,112,304,117,286,-5,18,W,0,1,0
2013-09-09 00:00:00.000000,Maldives,India,0,1,SAFF Cup,Kathmandu,Nepal,1,153,150,145,177,8,-27,L,2,0,0
2013-09-09 00:00:00.000000,Qatar,Lebanon,1,1,Friendly,Doha,Qatar,0,111,305,120,277,-9,28,D,1,1,0
2013-09-09 00:00:00.000000,Saudi Arabia,Trinidad and Tobago,1,3,OSN Cup,Riyadh,Saudi Arabia,0,107,316,78,452,29,-136,L,2,1,0
2013-09-09 00:00:00.000000,United Arab Emirates,New Zealand,2,0,OSN Cup,Riyadh,Saudi Arabia,1,84,429,57,582,27,-153,W,0,0,0
2013-09-10 00:00:00.000000,Algeria,Mali,1,0,FIFA World Cup qualification,Blida,Algeria,0,34,730,32,735,2,-5,W,0,1,0
2013-09-10 00:00:00.000000,Andorra,Netherlands,0,2,FIFA World Cup qualification,Sant Julià de Lòria,Andorra,0,205,8,5,1165,200,-1157,L,2,1,0
2013-09-10 00:00:00.000000,Armenia,Denmark,0,1,FIFA World Cup qualification,Yerevan,Armenia,0,66,534,27,788,39,-254,L,2,1,0
2013-09-10 00:00:00.000000,Belarus,France,2,4,FIFA World Cup qualification,Homel,Belarus,0,73,482,23,838,50,-356,L,2,1,0
2013-09-10 00:00:00.000000,Bolivia,Ecuador,1,1,FIFA World Cup qualification,La Paz,Bolivia,0,64,538,17,972,47,-434,D,1,1,0
2013-09-10 00:00:00.000000,Brazil,Portugal,3,1,Friendly,Foxborough,USA,1,9,1089,7,1099,2,-10,W,0,0,0
2013-09-10 00:00:00.000000,Canada,Mauritania,0,1,Friendly,Oliva,Spain,1,91,386,151,159,-60,227,L,2,0,0
2013-09-10 00:00:00.000000,Cyprus,Slovenia,0,2,FIFA World Cup qualification,Nicosia,Cyprus,0,123,256,45,634,78,-378,L,2,1,0
2013-09-10 00:00:00.000000,Egypt,Guinea,4,2,FIFA World Cup qualification,el-Gouna,Egypt,0,61,544,68,526,-7,18,W,0,1,0
2013-09-10 00:00:00.000000,Faroe Islands,Germany,0,3,FIFA World Cup qualification,Tórshavn,Faroe Islands,0,175,81,2,1257,173,-1176,L,2,1,0
2013-09-10 00:00:00.000000,Georgia,Finland,0,1,FIFA World Cup qualification,Tbilisi,Georgia,0,97,369,65,537,32,-168,L,2,1,0
2013-09-10 00:00:00.000000,Greece,Latvia,1,0,FIFA World Cup qualification,Piraeus,Greece,0,11,1038,119,280,-108,758,W,0,1,0
2013-09-10 00:00:00.000000,Honduras,Panama,2,2,FIFA World Cup qualification,Tegucigalpa,Honduras,0,43,640,40,679,3,-39,D,1,1,0
2013-09-10 00:00:00.000000,Hong Kong,Singapore,1,0,Friendly,Kowloon,Hong Kong,0,144,180,155,142,-11,38,W,0,1,0
2013-09-10 00:00:00.000000,Hungary,Estonia,5,1,FIFA World Cup qualification,Budapest,Hungary,0,31,749,85,423,-54,326,W,0,1,0
2013-09-10 00:00:00.000000,Iceland,Albania,2,1,FIFA World Cup qualification,Reykjavík,Iceland,0,70,499,38,689,32,-190,W,0,1,0
2013-09-10 00:00:00.000000,Italy,Czech Republic,2,1,FIFA World Cup qualification,Turin,Italy,0,6,1142,26,797,-20,345,W,0,1,0
2013-09-10 00:00:00.000000,Jamaica,Costa Rica,1,1,FIFA World Cup qualification,Kingston,Jamaica,0,76,469,42,651,34,-182,D,1,1,0
2013-09-10 00:00:00.000000,Japan,Ghana,3,1,Friendly,Saitama,Japan,0,37,695,24,830,13,-135,W,0,1,0
2013-09-10 00:00:00.000000,Kazakhstan,Sweden,0,1,FIFA World Cup qualification,Astana,Kazakhstan,0,149,172,30,765,119,-593,L,2,1,0
2013-09-10 00:00:00.000000,Korea Republic,Croatia,1,2,Friendly,Jeonju,Korea Republic,0,56,594,8,1098,48,-504,L,2,1,0
2013-09-10 00:00:00.000000,Lithuania,Liechtenstein,2,0,FIFA World Cup qualification,Marijampolė,Lithuania,0,106,321,148,173,-42,148,W,0,1,0
2013-09-10 00:00:00.000000,Luxembourg,Northern Ireland,3,2,FIFA World Cup qualification,Luxembourg,Luxembourg,0,140,210,109,307,31,-97,W,0,1,0
2013-09-10 00:00:00.000000,Malta,Bulgaria,1,2,FIFA World Cup qualification,Attard,Malta,0,134,236,53,596,81,-360,L,2,1,0
2013-09-10 00:00:00.000000,Nigeria,Burkina Faso,4,1,Friendly,Kaduna,Nigeria,0,35,700,48,618,-13,82,W,0,1,0
2013-09-10 00:00:00.000000,Norway,Switzerland,0,2,FIFA World Cup qualification,Oslo,Norway,0,25,801,15,987,10,-186,L,2,1,0
2013-09-10 00:00:00.000000,Paraguay,Argentina,2,5,FIFA World Cup qualification,Asunción,Paraguay,0,49,614,4,1210,45,-596,L,2,1,0
2013-09-10 00:00:00.000000,Romania,Turkey,0,2,FIFA World Cup qualification,Bucharest,Romania,0,33,732,58,573,-25,159,L,2,1,0
2013-09-10 00:00:00.000000,Russia,Israel,3,1,FIFA World Cup qualification,St. Petersburg,Russia,0,16,979,63,540,-47,439,W,0,1,0
2013-09-10 00:00:00.000000,San Marino,Poland,1,5,FIFA World Cup qualification,Serravalle,San Marino,0,207,0,72,493,135,-493,L,2,1,0
2013-09-10 00:00:00.000000,South Africa,Zimbabwe,1,2,Friendly,Johannesburg,South Africa,0,67,530,116,292,-49,238,L,2,1,0
2013-09-10 00:00:00.000000,Spain,Chile,2,2,Friendly,Geneva,Switzerland,1,1,1484,21,871,-20,613,D,1,0,0
2013-09-10 00:00:00.000000,Ukraine,England,0,0,FIFA World Cup qualification,Kyïv,Ukraine,0,28,774,14,994,14,-220,D,1,1,0
2013-09-10 00:00:00.000000,Uruguay,Colombia,2,0,FIFA World Cup qualification,Montevideo,Uruguay,0,12,998,3,1219,9,-221,W,0,1,0
2013-09-10 00:00:00.000000,USA,Mexico,2,0,FIFA World Cup qualification,Columbus,USA,0,19,960,20,879,-1,81,W,0,1,0
2013-09-10 00:00:00.000000,Uzbekistan,Jordan,1,1,FIFA World Cup qualification,Tashkent,Uzbekistan,0,59,566,71,495,-12,71,D,1,1,0
2013-09-10 00:00:00.000000,Venezuela,Peru,3,2,FIFA World Cup qualification,Puerto la Cruz,Venezuela,0,39,688,22,855,17,-167,W,0,1,0
2013-09-10 00:00:00.000000,Wales,Serbia,0,3,FIFA World Cup qualification,Cardiff,Wales,0,46,630,41,661,5,-31,L,2,1,0
2013-09-30 00:00:00.000000,Botswana,Burkina Faso,1,0,Friendly,Gaborone,Botswana,0,104,326,50,607,54,-281,W,0,1,0
2013-09-30 00:00:00.000000,Egypt,Uganda,2,0,Friendly,Cairo,Egypt,0,49,611,81,457,-32,154,W,0,1,0
2013-10-06 00:00:00.000000,Iraq,Yemen,3,2,Friendly,Beirut,Lebanon,1,105,325,173,80,-68,245,W,0,0,0
2013-10-08 00:00:00.000000,Lebanon,Iraq,1,1,Friendly,Beirut,Lebanon,0,120,265,105,325,15,-60,D,1,1,0
2013-10-09 00:00:00.000000,Jordan,Kuwait,1,1,Friendly,Amman,Jordan,0,73,494,109,307,-36,187,D,1,1,0
2013-10-09 00:00:00.000000,Oman,Mauritania,0,0,Friendly,Muscat,Oman,0,96,382,150,168,-54,214,D,1,1,0
2013-10-09 00:00:00.000000,Qatar,Vietnam,1,2,Friendly,Doha,Qatar,0,108,309,153,144,-45,165,L,2,1,0
2013-10-10 00:00:00.000000,Singapore,Laos,1,0,Friendly,Singapore,Singapore,0,159,131,172,84,-13,47,W,0,1,0
2013-10-10 00:00:00.000000,Thailand,Bahrain,1,0,Friendly,Bangkok,Thailand,0,139,206,121,264,18,-58,W,0,1,0
2013-10-11 00:00:00.000000,Albania,Switzerland,1,2,FIFA World Cup qualification,Tirana,Albania,0,45,652,14,992,31,-340,L,2,1,0
2013-10-11 00:00:00.000000,Andorra,Romania,0,4,FIFA World Cup qualification,Sant Julià de Lòria,Andorra,0,200,16,31,739,169,-723,L,2,1,0
2013-10-11 00:00:00.000000,Argentina,Peru,3,1,FIFA World Cup qualification,Buenos Aires,Argentina,0,2,1263,35,732,-33,531,W,0,1,0
2013-10-11 00:00:00.000000,Armenia,Bulgaria,2,1,FIFA World Cup qualification,Yerevan,Armenia,0,54,592,64,549,-10,43,W,0,1,0
2013-10-11 00:00:00.000000,Azerbaijan,Northern Ireland,2,0,FIFA World Cup qualification,Baku,Azerbaijan,0,107,315,86,431,21,-116,W,0,1,0
2013-10-11 00:00:00.000000,Colombia,Chile,3,3,FIFA World Cup qualification,Barranquilla,Colombia,0,5,1180,16,967,-11,213,D,1,1,0
2013-10-11 00:00:00.000000,Croatia,Belgium,1,2,FIFA World Cup qualification,Zagreb,Croatia,0,10,1051,6,1159,4,-108,L,2,1,0
2013-10-11 00:00:00.000000,Denmark,Italy,2,2,FIFA World Cup qualification,Copenhagen,Denmark,0,23,825,4,1199,19,-374,D,1,1,0
2013-10-11 00:00:00.000000,Ecuador,Uruguay,1,0,FIFA World Cup qualification,Quito,Ecuador,0,20,851,7,1126,13,-275,W,0,1,0
2013-10-11 00:00:00.000000,England,Montenegro,4,1,FIFA World Cup qualification,London,England,0,17,947,27,766,-10,181,W,0,1,0
2013-10-11 00:00:00.000000,Estonia,Turkey,0,2,FIFA World Cup qualification,Tallinn,Estonia,0,88,405,48,613,40,-208,L,2,1,0
2013-10-11 00:00:00.000000,Faroe Islands,Kazakhstan,1,1,FIFA World Cup qualification,Tórshavn,Faroe Islands,0,182,52,132,227,50,-175,D,1,1,0
2013-10-11 00:00:00.000000,France,Australia,6,0,Friendly,Saint-Denis,France,0,25,812,52,603,-27,209,W,0,1,0
2013-10-11 00:00:00.000000,Greece,Slovakia,1,0,FIFA World Cup qualification,Piraeus,Greece,0,12,1016,60,562,-48,454,W,0,1,0
2013-10-11 00:00:00.000000,Honduras,Costa Rica,1,0,FIFA World Cup qualification,San Pedro Sula,Honduras,0,41,680,34,733,7,-53,W,0,1,0
2013-10-11 00:00:00.000000,Iceland,Cyprus,2,0,FIFA World Cup qualification,Reykjavík,Iceland,0,53,599,134,225,-81,374,W,0,1,0
2013-10-11 00:00:00.000000,Lithuania,Latvia,2,0,FIFA World Cup qualification,Vilnius,Lithuania,0,112,299,115,288,-3,11,W,0,1,0
2013-10-11 00:00:00.000000,Luxembourg,Russia,0,4,FIFA World Cup qualification,Luxembourg,Luxembourg,0,126,247,15,968,111,-721,L,2,1,0
2013-10-11 00:00:00.000000,Malta,Czech Republic,1,4,FIFA World Cup qualification,Attard,Malta,0,142,199,33,738,109,-539,L,2,1,0
2013-10-11 00:00:00.000000,Mexico,Panama,2,1,FIFA World Cup qualification,Mexico City,Mexico,0,21,837,36,727,-15,110,W,0,1,0
2013-10-11 00:00:00.000000,Moldova,San Marino,3,0,FIFA World Cup qualification,Chișinău,Moldova,0,129,237,207,0,-78,237,W,0,1,0
2013-10-11 00:00:00.000000,Morocco,South Africa,1,1,Friendly,Agadir,Morocco,0,74,492,68,528,6,-36,D,1,1,0
2013-10-11 00:00:00.000000,Netherlands,Hungary,8,1,FIFA World Cup qualification,Amsterdam,Netherlands,0,9,1058,30,744,-21,314,W,0,1,0
2013-10-11 00:00:00.000000,Portugal,Israel,1,1,FIFA World Cup qualification,Lisbon,Portugal,0,11,1029,69,522,-58,507,D,1,1,0
2013-10-11 00:00:00.000000,Serbia,Japan,2,0,Friendly,Novi Sad,Serbia,0,44,666,43,671,1,-5,W,0,1,0
2013-10-11 00:00:00.000000,Slovenia,Norway,3,0,FIFA World Cup qualification,Maribor,Slovenia,0,29,754,40,699,-11,55,W,0,1,0
2013-10-11 00:00:00.000000,Spain,Belarus,2,1,FIFA World Cup qualification,Palma de Mallorca,Spain,0,1,1514,80,458,-79,1056,W,0,1,0
2013-10-11 00:00:00.000000,Sweden,Austria,2,1,FIFA World Cup qualification,Solna,Sweden,0,22,836,46,639,-24,197,W,0,1,0
2013-10-11 00:00:00.000000,Ukraine,Poland,1,0,FIFA World Cup qualification,Kharkiv,Ukraine,0,26,799,65,539,-39,260,W,0,1,0
2013-10-11 00:00:00.000000,USA,Jamaica,2,0,FIFA World Cup qualification,Kansas City,USA,0,13,996,78,471,-65,525,W,0,1,0
2013-10-11 00:00:00.000000,Venezuela,Paraguay,1,1,FIFA World Cup qualification,San Cristóbal,Venezuela,0,37,707,42,673,-5,34,D,1,1,0
2013-10-12 00:00:00.000000,Burkina Faso,Algeria,3,2,FIFA World Cup qualification,Ouagadougou,Burkina Faso,0,50,607,28,762,22,-155,W,0,1,0
2013-10-12 00:00:00.000000,Korea Republic,Brazil,0,2,Friendly,Seoul,Korea Republic,0,58,574,8,1067,50,-493,L,2,1,0
2013-10-13 00:00:00.000000,Ethiopia,Nigeria,1,2,FIFA World Cup qualification,Addis Ababa,Ethiopia,0,93,386,37,707,56,-321,L,2,1,0
2013-10-13 00:00:00.000000,Qatar,Yemen,6,0,AFC Asian Cup qualification,Doha,Qatar,0,108,309,173,80,-65,229,W,0,1,0
2013-10-13 00:00:00.000000,Tunisia,Cameroon,0,0,FIFA World Cup qualification,Radès,Tunisia,0,56,580,61,558,-5,22,D,1,1,0
2013-10-15 00:00:00.000000,Australia,Canada,3,0,Friendly,London,England,1,52,603,106,324,-54,279,W,0,0,0
2013-10-15 00:00:00.000000,Azerbaijan,Russia,1,1,FIFA World Cup qualification,Baku,Azerbaijan,0,107,315,15,968,92,-653,D,1,1,0
2013-10-15 00:00:00.000000,Belarus,Japan,1,0,Friendly,Minsk,Belarus,0,80,458,43,671,37,-213,W,0,1,0
2013-10-15 00:00:00.000000,Belgium,Wales,1,1,FIFA World Cup qualification,Brussels,Belgium,0,6,1159,51,606,-45,553,D,1,1,0
2013-10-15 00:00:00.000000,Brazil,Zambia,2,0,Friendly,Beijing,China,1,8,1067,71,515,-63,552,W,0,0,0
2013-10-15 00:00:00.000000,Bulgaria,Czech Republic,0,1,FIFA World Cup qualification,Sofia,Bulgaria,0,64,549,33,738,31,-189,L,2,1,0
2013-10-15 00:00:00.000000,Chile,Ecuador,2,1,FIFA World Cup qualification,Santiago,Chile,0,16,967,20,851,-4,116,W,0,1,0
2013-10-15 00:00:00.000000,Costa Rica,Mexico,2,1,FIFA World Cup qualification,San José,Costa Rica,0,34,733,21,837,13,-104,W,0,1,0
2013-10-15 00:00:00.000000,Cyprus,Albania,0,0,FIFA World Cup qualification,Nicosia,Cyprus,0,134,225,45,652,89,-427,D,1,1,0
2013-10-15 00:00:00.000000,Denmark,Malta,6,0,FIFA World Cup qualification,Copenhagen,Denmark,0,23,825,142,199,-119,626,W,0,1,0
2013-10-15 00:00:00.000000,England,Poland,2,0,FIFA World Cup qualification,London,England,0,17,947,65,539,-48,408,W,0,1,0
2013-10-15 00:00:00.000000,Faroe Islands,Austria,0,3,FIFA World Cup qualification,Tórshavn,Faroe Islands,0,182,52,46,639,136,-587,L,2,1,0
2013-10-15 00:00:00.000000,France,Finland,3,0,FIFA World Cup qualification,Saint-Denis,France,0,25,812,55,591,-30,221,W,0,1,0
2013-10-15 00:00:00.000000,Ghana,Egypt,6,1,FIFA World Cup qualification,Kumasi,Ghana,0,24,815,49,611,-25,204,W,0,1,0
2013-10-15 00:00:00.000000,Greece,Liechtenstein,2,0,FIFA World Cup qualification,Piraeus,Greece,0,12,1016,156,142,-144,874,W,0,1,0
2013-10-15 00:00:00.000000,Hong Kong,United Arab Emirates,0,4,AFC Asian Cup qualification,So Kon Po,Hong Kong,0,148,174,82,456,66,-282,L,2,1,0
2013-10-15 00:00:00.000000,Hungary,Andorra,2,0,FIFA World Cup qualification,Budapest,Hungary,0,30,744,200,16,-170,728,W,0,1,0
2013-10-15 00:00:00.000000,Iran,Thailand,2,1,AFC Asian Cup qualification,Teheran,Iran,0,47,633,139,206,-92,427,W,0,1,0
2013-10-15 00:00:00.000000,Iraq,Saudi Arabia,0,2,AFC Asian Cup qualification,Amman,Jordan,1,105,325,109,307,-4,18,L,2,0,0
2013-10-15 00:00:00.000000,Israel,Northern Ireland,1,1,FIFA World Cup qualification,Ramat-Gan,Israel,0,69,522,86,431,-17,91,D,1,1,0
2013-10-15 00:00:00.000000,Italy,Armenia,2,2,FIFA World Cup qualification,Naples,Italy,0,4,1199,54,592,-50,607,D,1,1,0
2013-10-15 00:00:00.000000,Jamaica,Honduras,2,2,FIFA World Cup qualification,Kingston,Jamaica,0,78,471,41,680,37,-209,D,1,1,0
2013-10-15 00:00:00.000000,Jordan,Oman,0,0,AFC Asian Cup qualification,Amman,Jordan,0,73,494,96,382,-23,112,D,1,1,0
2013-10-15 00:00:00.000000,Korea Republic,Mali,3,1,Friendly,Cheonan,Korea Republic,0,58,574,39,704,19,-130,W,0,1,0
2013-10-15 00:00:00.000000,Latvia,Slovakia,2,2,FIFA World Cup qualification,Riga,Latvia,0,115,288,60,562,55,-274,D,1,1,0
2013-10-15 00:00:00.000000,Lebanon,Kuwait,1,1,AFC Asian Cup qualification,Beirut,Lebanon,0,120,265,109,307,11,-42,D,1,1,0
2013-10-15 00:00:00.000000,Malaysia,Bahrain,1,1,AFC Asian Cup qualification,Shah Alam,Malaysia,0,161,128,121,264,40,-136,D,1,1,0
2013-10-15 00:00:00.000000,Montenegro,Moldova,2,5,FIFA World Cup qualification,Podgorica,Montenegro,0,27,766,129,237,-102,529,L,2,1,0
2013-10-15 00:00:00.000000,Norway,Iceland,1,1,FIFA World Cup qualification,Oslo,Norway,0,40,699,53,599,-13,100,D,1,1,0
2013-10-15 00:00:00.000000,Panama,USA,2,3,FIFA World Cup qualification,Panama City,Panama,0,36,727,13,996,23,-269,L,2,1,0
2013-10-15 00:00:00.000000,Paraguay,Colombia,1,2,FIFA World Cup qualification,Asunción,Paraguay,0,42,673,5,1180,37,-507,L,2,1,0
2013-10-15 00:00:00.000000,Peru,Bolivia,1,1,FIFA World Cup qualification,Lima,Peru,0,35,732,62,555,-27,177,D,1,1,0
2013-10-15 00:00:00.000000,Philippines,Pakistan,3,1,Friendly,Bacolod,Philippines,0,141,200,170,102,-29,98,W,0,1,0
2013-10-15 00:00:00.000000,Portugal,Luxembourg,3,0,FIFA World Cup qualification,Coimbra,Portugal,0,11,1029,126,247,-115,782,W,0,1,0
2013-10-15 00:00:00.000000,Romania,Estonia,2,0,FIFA World Cup qualification,Bucharest,Romania,0,31,739,88,405,-57,334,W,0,1,0
2013-10-15 00:00:00.000000,San Marino,Ukraine,0,8,FIFA World Cup qualification,Serravalle,San Marino,0,207,0,26,799,181,-799,L,2,1,0
2013-10-15 00:00:00.000000,Scotland,Croatia,2,0,FIFA World Cup qualification,Glasgow,Scotland,0,63,551,10,1051,53,-500,W,0,1,0
2013-10-15 00:00:00.000000,Singapore,Syria,2,1,AFC Asian Cup qualification,Singapore,Singapore,0,159,131,143,192,16,-61,W,0,1,0
2013-10-15 00:00:00.000000,Spain,Georgia,2,0,FIFA World Cup qualification,Albacete,Spain,0,1,1514,97,364,-96,1150,W,0,1,0
2013-10-15 00:00:00.000000,Sweden,Germany,3,5,FIFA World Cup qualification,Solna,Sweden,0,22,836,3,1261,19,-425,L,2,1,0
2013-10-15 00:00:00.000000,Switzerland,Slovenia,1,0,FIFA World Cup qualification,Berne,Switzerland,0,14,992,29,754,-15,238,W,0,1,0
2013-10-15 00:00:00.000000,Trinidad and Tobago,New Zealand,0,0,Friendly,Port of Spain,Trinidad and Tobago,0,85,432,67,529,18,-97,D,1,1,0
2013-10-15 00:00:00.000000,Turkey,Netherlands,0,2,FIFA World Cup qualification,Istanbul,Turkey,0,48,613,9,1058,39,-445,L,2,1,0
2013-10-15 00:00:00.000000,Uruguay,Argentina,3,2,FIFA World Cup qualification,Montevideo,Uruguay,0,7,1126,2,1263,5,-137,W,0,1,0
2013-10-15 00:00:00.000000,Uzbekistan,Vietnam,3,1,AFC Asian Cup qualification,Tashkent,Uzbekistan,0,57,579,153,144,-96,435,W,0,1,0
2013-10-28 00:00:00.000000,Jordan,Nigeria,1,0,Friendly,Amman,Jordan,0,70,502,33,724,37,-222,W,0,1,0
2013-11-06 00:00:00.000000,Jordan,Zambia,1,0,Friendly,al-Wakrah,Qatar,1,70,502,67,513,3,-11,W,0,0,0
2013-11-08 00:00:00.000000,Kuwait,Malaysia,3,0,Friendly,Kuwait City,Kuwait,0,109,307,160,137,-51,170,W,0,1,0
2013-11-09 00:00:00.000000,Bahrain,Lebanon,1,0,Friendly,Riffa,Bahrain,0,123,266,121,267,2,-1,W,0,1,0
2013-11-09 00:00:00.000000,United Arab Emirates,Philippines,4,0,Friendly,Abu Dhabi,United Arab Emirates,0,71,496,137,213,-66,283,W,0,1,0
2013-11-13 00:00:00.000000,Jordan,Uruguay,0,5,FIFA World Cup qualification,Amman,Jordan,0,70,502,6,1164,64,-662,L,2,1,0
2013-11-14 00:00:00.000000,Belgium,Colombia,0,2,Friendly,Brussels,Belgium,0,5,1175,4,1178,1,-3,L,2,1,0
2013-11-14 00:00:00.000000,Curaçao,Aruba,2,0,ABCS Tournament,Willemstad,Curaçao,0,170,88,173,82,-3,6,W,0,1,0
2013-11-14 00:00:00.000000,Egypt,Zambia,2,0,Friendly,Cairo,Egypt,0,51,610,67,513,-16,97,W,0,1,0
2013-11-15 00:00:00.000000,Argentina,Ecuador,0,0,Friendly,East Rutherford,USA,1,3,1266,22,862,-19,404,D,1,0,0
2013-11-15 00:00:00.000000,Bahrain,Malaysia,1,0,AFC Asian Cup qualification,Riffa,Bahrain,0,123,266,160,137,-37,129,W,0,1,0
2013-11-15 00:00:00.000000,Belarus,Albania,0,0,Friendly,Antalya,Turkey,1,83,441,58,563,25,-122,D,1,0,0
2013-11-15 00:00:00.000000,Czech Republic,Canada,2,0,Friendly,Olomouc,Czech Republic,0,27,783,111,296,-84,487,W,0,1,0
2013-11-15 00:00:00.000000,Denmark,Norway,2,1,Friendly,Herning,Denmark,0,26,824,47,632,-21,192,W,0,1,0
2013-11-15 00:00:00.000000,England,Chile,0,2,Friendly,London,England,0,10,1080,12,1051,-2,29,L,2,1,0
2013-11-15 00:00:00.000000,Estonia,Azerbaijan,2,1,Friendly,Tallinn,Estonia,0,99,351,88,407,11,-56,W,0,1,0
2013-11-15 00:00:00.000000,Greece,Romania,3,1,FIFA World Cup qualification,Piraeus,Greece,0,15,983,29,767,-14,216,W,0,1,0
2013-11-15 00:00:00.000000,Iceland,Croatia,0,0,FIFA World Cup qualification,Reykjavík,Iceland,0,46,633,18,901,28,-268,D,1,1,0
2013-11-15 00:00:00.000000,India,Philippines,1,1,Friendly,Siliguri,India,0,154,151,137,213,17,-62,D,1,1,0
2013-11-15 00:00:00.000000,Italy,Germany,1,1,Friendly,Milan,Italy,0,8,1136,2,1311,6,-175,D,1,1,0
2013-11-15 00:00:00.000000,Jamaica,Trinidad and Tobago,0,1,Friendly,Montego Bay,Jamaica,0,82,456,81,457,1,-1,L,2,1,0
2013-11-15 00:00:00.000000,Korea Republic,Switzerland,2,1,Friendly,Seoul,Korea Republic,0,56,569,7,1138,49,-569,W,0,1,0
2013-11-15 00:00:00.000000,Kuwait,Lebanon,0,0,AFC Asian Cup qualification,Kuwait City,Kuwait,0,109,307,121,267,-12,40,D,1,1,0
2013-11-15 00:00:00.000000,Libya,Niger,1,1,Friendly,Sousse,Tunisia,1,61,540,110,306,-49,234,D,1,0,0
2013-11-15 00:00:00.000000,Poland,Slovakia,0,2,Friendly,Wrocław,Poland,0,69,503,65,528,4,-25,L,2,1,0
2013-11-15 00:00:00.000000,Portugal,Sweden,1,0,FIFA World Cup qualification,Lisbon,Portugal,0,14,1036,25,850,-11,186,W,0,1,0
2013-11-15 00:00:00.000000,Russia,Serbia,1,1,Friendly,Dubai,United Arab Emirates,1,19,874,28,778,-9,96,D,1,0,0
2013-11-15 00:00:00.000000,Saudi Arabia,Iraq,2,1,AFC Asian Cup qualification,Dammam,Saudi Arabia,0,101,338,103,323,-2,15,W,0,1,0
2013-11-15 00:00:00.000000,Scotland,USA,0,0,Friendly,Glasgow,Scotland,0,35,715,13,1040,22,-325,D,1,1,0
2013-11-15 00:00:00.000000,Swaziland,South Africa,0,3,Friendly,Lobamba,Swaziland,0,183,49,61,540,122,-491,L,2,1,0
2013-11-15 00:00:00.000000,Syria,Singapore,4,0,AFC Asian Cup qualification,Teheran,Iran,1,141,183,155,149,-14,34,W,0,0,0
2013-11-15 00:00:00.000000,Thailand,Iran,0,3,AFC Asian Cup qualification,Bangkok,Thailand,0,143,181,49,613,94,-432,L,2,1,0
2013-11-15 00:00:00.000000,Turkey,Northern Ireland,1,0,Friendly,Adana,Turkey,0,40,670,90,399,-50,271,W,0,1,0
2013-11-15 00:00:00.000000,Ukraine,France,2,0,FIFA World Cup qualification,Kyïv,Ukraine,0,20,871,21,870,-1,1,W,0,1,0
2013-11-15 00:00:00.000000,United Arab Emirates,Hong Kong,4,0,AFC Asian Cup qualification,Abu Dhabi,United Arab Emirates,0,71,496,148,171,-77,325,W,0,1,0
2013-11-15 00:00:00.000000,Vietnam,Uzbekistan,0,3,AFC Asian Cup qualification,Hanoi,Vietnam,0,151,159,55,582,96,-423,L,2,1,0
2013-11-15 00:00:00.000000,Yemen,Qatar,1,4,AFC Asian Cup qualification,al-Ain,United Arab Emirates,1,177,72,105,313,72,-241,L,2,0,0
2013-11-16 00:00:00.000000,Curaçao,Suriname,1,3,ABCS Tournament,Willemstad,Curaçao,0,170,88,131,237,39,-149,L,2,1,0
2013-11-16 00:00:00.000000,Equatorial Guinea,Spain,1,2,Friendly,Malabo,Equatorial Guinea,0,119,273,1,1513,118,-1240,L,2,1,0
2013-11-16 00:00:00.000000,Honduras,Brazil,0,5,Friendly,Miami Gardens,USA,1,34,720,11,1078,23,-358,L,2,0,0
2013-11-16 00:00:00.000000,Netherlands,Japan,2,2,Friendly,Genk,Belgium,1,8,1136,44,634,-36,502,D,1,0,0
2013-11-16 00:00:00.000000,Nigeria,Ethiopia,2,0,FIFA World Cup qualification,Calabar,Nigeria,0,33,724,95,376,-62,348,W,0,1,0
2013-11-16 00:00:00.000000,Uganda,Rwanda,0,0,Friendly,Kampala,Uganda,0,85,431,129,242,-44,189,D,1,1,0
2013-11-16 00:00:00.000000,Wales,Finland,1,1,Friendly,Cardiff,Wales,0,44,634,63,538,-19,96,D,1,1,0
2013-11-17 00:00:00.000000,Cameroon,Tunisia,4,1,FIFA World Cup qualification,Yaoundé,Cameroon,0,59,554,47,632,12,-78,W,0,1,0
2013-11-17 00:00:00.000000,Luxembourg,Montenegro,1,4,Friendly,Luxembourg,Luxembourg,0,127,247,54,584,73,-337,L,2,1,0
2013-11-18 00:00:00.000000,Italy,Nigeria,2,2,Friendly,London,England,1,8,1136,33,724,-25,412,D,1,0,0
2013-11-18 00:00:00.000000,Moldova,Lithuania,1,1,Friendly,Chișinău,Moldova,0,96,369,103,323,-7,46,D,1,1,0
2013-11-19 00:00:00.000000,Algeria,Burkina Faso,1,0,FIFA World Cup qualification,Blida,Algeria,0,32,741,52,598,-20,143,W,0,1,0
2013-11-19 00:00:00.000000,Australia,Costa Rica,1,0,Friendly,Sydney,Australia,0,57,564,31,744,26,-180,W,0,1,0
2013-11-19 00:00:00.000000,Austria,USA,1,0,Friendly,Vienna,Austria,0,53,596,13,1040,40,-444,W,0,1,0
2013-11-19 00:00:00.000000,Bahrain,Yemen,2,0,AFC Asian Cup qualification,Riffa,Bahrain,0,123,266,177,72,-54,194,W,0,1,0
2013-11-19 00:00:00.000000,Belgium,Japan,2,3,Friendly,Brussels,Belgium,0,5,1175,44,634,-39,541,L,2,1,0
2013-11-19 00:00:00.000000,Brazil,Chile,2,1,Friendly,Toronto,Canada,1,11,1078,12,1051,-1,27,W,0,0,0
2013-11-19 00:00:00.000000,Cambodia,Guam,0,2,Friendly,Phnom Penh,Cambodia,0,198,20,171,86,27,-66,L,2,1,0
2013-11-19 00:00:00.000000,Croatia,Iceland,2,0,FIFA World Cup qualification,Zagreb,Croatia,0,18,901,46,633,-28,268,W,0,1,0
2013-11-19 00:00:00.000000,Egypt,Ghana,2,1,FIFA World Cup qualification,Cairo,Egypt,0,51,610,23,860,28,-250,W,0,1,0
2013-11-19 00:00:00.000000,England,Germany,0,1,Friendly,London,England,0,10,1080,2,1311,8,-231,L,2,1,0
2013-11-19 00:00:00.000000,France,Ukraine,3,0,FIFA World Cup qualification,Saint-Denis,France,0,21,870,20,871,1,-1,W,0,1,0
2013-11-19 00:00:00.000000,Honduras,Ecuador,2,2,Friendly,Houston,USA,1,34,720,22,862,12,-142,D,1,0,0
2013-11-19 00:00:00.000000,Hong Kong,Uzbekistan,0,2,AFC Asian Cup qualification,So Kon Po,Hong Kong,0,148,171,55,582,93,-411,L,2,1,0
2013-11-19 00:00:00.000000,India,Nepal,2,0,Friendly,Siliguri,India,0,154,151,165,119,-11,32,W,0,1,0
2013-11-19 00:00:00.000000,Indonesia,Iraq,0,2,AFC Asian Cup qualification,Jakarta,Indonesia,0,162,120,103,323,59,-203,L,2,1,0
2013-11-19 00:00:00.000000,Kuwait,Thailand,3,1,AFC Asian Cup qualification,Kuwait City,Kuwait,0,109,307,143,181,-34,126,W,0,1,0
2013-11-19 00:00:00.000000,Lebanon,Iran,1,4,AFC Asian Cup qualification,Beirut,Lebanon,0,121,267,49,613,72,-346,L,2,1,0
2013-11-19 00:00:00.000000,Liechtenstein,Estonia,0,3,Friendly,Vaduz,Liechtenstein,0,158,141,99,351,59,-210,L,2,1,0
2013-11-19 00:00:00.000000,Malaysia,Qatar,0,1,AFC Asian Cup qualification,Shah Alam,Malaysia,0,160,137,105,313,55,-176,L,2,1,0
2013-11-19 00:00:00.000000,Malta,Faroe Islands,3,2,Friendly,Attard,Malta,0,140,192,175,81,-35,111,W,0,1,0
2013-11-19 00:00:00.000000,Namibia,Mozambique,0,0,Friendly,Windhoek,Namibia,0,128,246,115,282,13,-36,D,1,1,0
2013-11-19 00:00:00.000000,Netherlands,Colombia,0,0,Friendly,Amsterdam,Netherlands,0,8,1136,4,1178,4,-42,D,1,1,0
2013-11-19 00:00:00.000000,Norway,Scotland,0,1,Friendly,Molde,Norway,0,47,632,35,715,12,-83,L,2,1,0
2013-11-19 00:00:00.000000,Romania,Greece,1,1,FIFA World Cup qualification,Bucharest,Romania,0,29,767,15,983,14,-216,D,1,1,0
2013-11-19 00:00:00.000000,Russia,Korea Republic,2,1,Friendly,Dubai,United Arab Emirates,1,19,874,56,569,-37,305,W,0,0,0
2013-11-19 00:00:00.000000,Slovenia,Canada,1,0,Friendly,Celje,Slovenia,0,30,752,111,296,-81,456,W,0,1,0
2013-11-19 00:00:00.000000,South Africa,Spain,1,0,Friendly,Johannesburg,South Africa,0,61,540,1,1513,60,-973,W,0,1,0
2013-11-19 00:00:00.000000,Sweden,Portugal,2,3,FIFA World Cup qualification,Solna,Sweden,0,25,850,14,1036,11,-186,L,2,1,0
2013-11-19 00:00:00.000000,Syria,Oman,0,1,AFC Asian Cup qualification,Teheran,Iran,1,141,183,92,381,49,-198,L,2,0,0
2013-11-19 00:00:00.000000,Tanzania,Zimbabwe,0,0,Friendly,Dar es Salaam,Tanzania,0,129,242,102,328,27,-86,D,1,1,0
2013-11-19 00:00:00.000000,Trinidad and Tobago,Jamaica,2,0,Friendly,Port of Spain,Trinidad and Tobago,0,81,457,82,456,-1,1,W,0,1,0
2013-11-19 00:00:00.000000,Turkey,Belarus,2,1,Friendly,Mersin,Turkey,0,40,670,83,441,-43,229,W,0,1,0
2013-11-19 00:00:00.000000,United Arab Emirates,Vietnam,5,0,AFC Asian Cup qualification,Abu Dhabi,United Arab Emirates,0,71,496,151,159,-80,337,W,0,1,0
2013-11-20 00:00:00.000000,New Zealand,Mexico,2,4,FIFA World Cup qualification,Wellington,New Zealand,0,79,470,24,854,55,-384,L,2,1,0
2013-11-20 00:00:00.000000,Uruguay,Jordan,0,0,FIFA World Cup qualification,Montevideo,Uruguay,0,6,1164,70,502,-64,662,D,1,1,0
2013-11-24 00:00:00.000000,Singapore,Cambodia,1,0,Friendly,Hougang,Singapore,0,155,149,198,20,-43,129,W,0,1,0
2013-11-28 00:00:00.000000,Burundi,Somalia,2,0,CECAFA Cup,Machakos,Kenya,1,112,293,204,6,-92,287,W,0,0,0
2013-11-28 00:00:00.000000,Tanzania,Zambia,1,1,CECAFA Cup,Machakos,Kenya,1,124,243,72,505,52,-262,D,1,0,0
2013-11-29 00:00:00.000000,Seychelles,Maldives,2,1,Friendly,Victoria,Seychelles,0,200,15,149,147,51,-132,W,0,1,0
2013-11-29 00:00:00.000000,Sudan,Eritrea,3,0,CECAFA Cup,Machakos,Kenya,1,130,218,199,16,-69,202,W,0,0,0
2013-11-29 00:00:00.000000,Uganda,Rwanda,1,0,CECAFA Cup,Nairobi,Kenya,1,86,417,127,229,-41,188,W,0,0,0
2013-11-30 00:00:00.000000,Dominica,St. Lucia,0,1,Friendly,Roseau,Dominica,0,175,67,161,129,14,-62,L,2,1,0
2013-11-30 00:00:00.000000,Kenya,South Sudan,3,1,CECAFA Cup,Nairobi,Kenya,0,117,281,201,10,-84,271,W,0,1,0
2013-12-01 00:00:00.000000,Dominica,St. Lucia,1,0,Friendly,Roseau,Dominica,0,175,67,161,129,14,-62,W,0,1,0
2013-12-01 00:00:00.000000,Somalia,Tanzania,0,1,CECAFA Cup,Nairobi,Kenya,1,204,6,124,243,80,-237,L,2,0,0
2013-12-01 00:00:00.000000,Zambia,Burundi,1,0,CECAFA Cup,Nairobi,Kenya,1,72,505,112,293,-40,212,W,0,0,0
2013-12-02 00:00:00.000000,Eritrea,Uganda,0,3,CECAFA Cup,Machakos,Kenya,1,199,16,86,417,113,-401,L,2,0,0
2013-12-02 00:00:00.000000,Sudan,Rwanda,1,0,CECAFA Cup,Machakos,Kenya,1,130,218,127,229,3,-11,W,0,0,0
2013-12-03 00:00:00.000000,South Sudan,Ethiopia,0,2,CECAFA Cup,Nakuru,Kenya,1,201,10,93,376,108,-366,L,2,0,0
2013-12-04 00:00:00.000000,Somalia,Zambia,0,4,CECAFA Cup,Nakuru,Kenya,1,204,6,72,505,132,-499,L,2,0,0
2013-12-04 00:00:00.000000,Tanzania,Burundi,1,0,CECAFA Cup,Nakuru,Kenya,1,124,243,112,293,12,-50,W,0,0,0
2013-12-05 00:00:00.000000,Rwanda,Eritrea,1,0,CECAFA Cup,Nakuru,Kenya,1,127,229,199,16,-72,213,W,0,0,0
2013-12-05 00:00:00.000000,Uganda,Sudan,1,0,CECAFA Cup,Nakuru,Kenya,1,86,417,130,218,-44,199,W,0,0,0
2013-12-07 00:00:00.000000,Kenya,Rwanda,1,0,CECAFA Cup,Mombasa,Kenya,0,117,281,127,229,-10,52,W,0,1,0
2013-12-07 00:00:00.000000,Uganda,Tanzania,2,2,CECAFA Cup,Mombasa,Kenya,1,86,417,124,243,-38,174,D,1,0,0
2013-12-08 00:00:00.000000,Ethiopia,Sudan,0,2,CECAFA Cup,Mombasa,Kenya,1,93,376,130,218,-37,158,L,2,0,0
2013-12-08 00:00:00.000000,Zambia,Burundi,4,3,CECAFA Cup,Mombasa,Kenya,1,72,505,112,293,-40,212,W,0,0,0
2013-12-10 00:00:00.000000,Kenya,Tanzania,1,0,CECAFA Cup,Nairobi,Kenya,0,117,281,124,243,-7,38,W,0,1,0
2013-12-10 00:00:00.000000,Zambia,Sudan,1,2,CECAFA Cup,Mombasa,Kenya,1,72,505,130,218,-58,287,L,2,0,0
2013-12-12 00:00:00.000000,Kenya,Sudan,2,0,CECAFA Cup,Nairobi,Kenya,0,117,281,130,218,-13,63,W,0,1,0
2013-12-12 00:00:00.000000,Tanzania,Zambia,1,1,CECAFA Cup,Nairobi,Kenya,1,124,243,72,505,52,-262,D,1,0,0
2013-12-14 00:00:00.000000,Libya,Mali,1,0,Friendly,el-Jadida,Morocco,1,63,544,42,684,21,-140,W,0,0,0
2013-12-21 00:00:00.000000,Qatar,Bahrain,1,1,Friendly,Doha,Qatar,0,103,325,110,292,-7,33,D,1,1,0
2013-12-25 00:00:00.000000,Oman,Bahrain,0,0,WAFF Championship,Doha,Qatar,1,85,408,110,292,-25,116,D,1,0,0
2013-12-25 00:00:00.000000,Qatar,Palestine,1,0,WAFF Championship,Doha,Qatar,0,103,325,137,192,-34,133,W,0,1,0
2013-12-26 00:00:00.000000,Jordan,Lebanon,0,0,WAFF Championship,Doha,Qatar,1,65,536,121,249,-56,287,D,1,0,0
2013-12-28 00:00:00.000000,Bahrain,Iraq,0,0,WAFF Championship,Doha,Qatar,1,110,292,110,292,0,0,D,1,0,0
2013-12-28 00:00:00.000000,Palestine,Saudi Arabia,0,0,WAFF Championship,Doha,Qatar,1,137,192,87,391,50,-199,D,1,0,0
2013-12-29 00:00:00.000000,Lebanon,Kuwait,0,2,WAFF Championship,Doha,Qatar,1,121,249,105,315,16,-66,L,2,0,0
2013-12-31 00:00:00.000000,Iraq,Oman,0,0,WAFF Championship,Doha,Qatar,1,110,292,85,408,25,-116,D,1,0,0
2013-12-31 00:00:00.000000,Qatar,Saudi Arabia,4,1,WAFF Championship,Doha,Qatar,0,103,325,87,391,16,-66,W,0,1,0
2014-01-01 00:00:00.000000,Kuwait,Jordan,1,2,WAFF Championship,Doha,Qatar,1,105,315,65,536,40,-221,L,2,0,0
2014-01-04 00:00:00.000000,Bahrain,Jordan,0,1,WAFF Championship,Doha,Qatar,1,110,292,65,536,45,-244,L,2,0,0
2014-01-04 00:00:00.000000,Namibia,Ghana,0,1,Friendly,Windhoek,Namibia,0,125,237,24,849,101,-612,L,2,1,0
2014-01-04 00:00:00.000000,Nigeria,Ethiopia,2,1,Friendly,Abuja,Nigeria,0,37,710,93,374,-56,336,W,0,1,0
2014-01-04 00:00:00.000000,Qatar,Kuwait,3,0,WAFF Championship,Doha,Qatar,0,103,325,105,315,-2,10,W,0,1,0
2014-01-07 00:00:00.000000,Bahrain,Kuwait,0,0,WAFF Championship,Doha,Qatar,1,110,292,105,315,5,-23,D,1,0,0
2014-01-07 00:00:00.000000,Qatar,Jordan,2,0,WAFF Championship,Doha,Qatar,0,103,325,65,536,38,-211,W,0,1,0
2014-01-07 00:00:00.000000,Zimbabwe,Gabon,2,0,Friendly,Johannesburg,South Africa,1,107,299,77,453,30,-154,W,0,0,0
2014-01-11 00:00:00.000000,Mali,Nigeria,2,1,African Nations Championship,Cape Town,South Africa,1,45,664,37,710,8,-46,W,0,0,0
2014-01-11 00:00:00.000000,South Africa,Mozambique,3,1,African Nations Championship,Cape Town,South Africa,0,62,554,118,264,-56,290,W,0,1,0
2014-01-12 00:00:00.000000,Uganda,Burkina Faso,2,1,African Nations Championship,Cape Town,South Africa,1,86,402,53,591,33,-189,W,0,0,0
2014-01-12 00:00:00.000000,Zimbabwe,Morocco,0,0,African Nations Championship,Cape Town,South Africa,1,107,299,73,490,34,-191,D,1,0,0
2014-01-13 00:00:00.000000,Ghana,Congo,1,0,African Nations Championship,Bloemfontein,South Africa,1,24,849,84,421,-60,428,W,0,0,0
2014-01-13 00:00:00.000000,Libya,Ethiopia,2,0,African Nations Championship,Bloemfontein,South Africa,1,59,558,93,374,-34,184,W,0,0,0
2014-01-14 00:00:00.000000,Congo DR,Mauritania,1,0,African Nations Championship,Polokwane,South Africa,1,82,427,142,180,-60,247,W,0,0,0
2014-01-14 00:00:00.000000,Gabon,Burundi,0,0,African Nations Championship,Polokwane,South Africa,1,77,453,124,239,-47,214,D,1,0,0
2014-01-16 00:00:00.000000,Burkina Faso,Morocco,1,1,African Nations Championship,Cape Town,South Africa,1,58,566,74,486,-16,80,D,1,0,0
2014-01-16 00:00:00.000000,Zimbabwe,Uganda,0,0,African Nations Championship,Cape Town,South Africa,1,105,312,87,413,18,-101,D,1,0,0
2014-01-17 00:00:00.000000,Ethiopia,Congo,0,1,African Nations Championship,Bloemfontein,South Africa,1,95,361,85,421,10,-60,L,2,0,0
2014-01-17 00:00:00.000000,Ghana,Libya,1,1,African Nations Championship,Bloemfontein,South Africa,1,24,851,62,552,-38,299,D,1,0,0
2014-01-17 00:00:00.000000,Moldova,Sweden,1,2,Friendly,Abu Dhabi,United Arab Emirates,1,96,359,26,793,70,-434,L,2,0,0
2014-01-18 00:00:00.000000,Burundi,Mauritania,3,2,African Nations Championship,Polokwane,South Africa,1,124,230,145,161,-21,69,W,0,0,0
2014-01-18 00:00:00.000000,Congo DR,Gabon,0,1,African Nations Championship,Polokwane,South Africa,1,81,439,85,421,-4,18,L,2,0,0
2014-01-18 00:00:00.000000,Norway,Poland,0,3,Friendly,Abu Dhabi,United Arab Emirates,1,59,558,77,461,-18,97,L,2,0,0
2014-01-19 00:00:00.000000,Mozambique,Mali,1,2,African Nations Championship,Cape Town,South Africa,1,120,256,40,703,80,-447,L,2,0,0
2014-01-19 00:00:00.000000,South Africa,Nigeria,1,3,African Nations Championship,Cape Town,South Africa,0,54,576,41,701,13,-125,L,2,1,0
2014-01-20 00:00:00.000000,Burkina Faso,Zimbabwe,0,1,African Nations Championship,Cape Town,South Africa,1,58,566,105,312,-47,254,L,2,0,0
2014-01-20 00:00:00.000000,Moldova,Poland,0,1,Friendly,Abu Dhabi,United Arab Emirates,1,96,359,77,461,19,-102,L,2,0,0
2014-01-20 00:00:00.000000,Morocco,Uganda,3,1,African Nations Championship,Cape Town,South Africa,1,74,486,87,413,-13,73,W,0,0,0
2014-01-21 00:00:00.000000,Congo,Libya,2,2,African Nations Championship,Polokwane,South Africa,1,85,421,62,552,23,-131,D,1,0,0
2014-01-21 00:00:00.000000,Ethiopia,Ghana,0,1,African Nations Championship,Bloemfontein,South Africa,1,95,361,24,851,71,-490,L,2,0,0
2014-01-21 00:00:00.000000,Iceland,Sweden,0,2,Friendly,Abu Dhabi,United Arab Emirates,1,49,624,26,793,23,-169,L,2,0,0
2014-01-22 00:00:00.000000,Burundi,Congo DR,1,2,African Nations Championship,Polokwane,South Africa,1,124,230,81,439,43,-209,L,2,0,0
2014-01-22 00:00:00.000000,Chile,Costa Rica,4,0,Friendly,Coquimbo,Chile,0,15,1005,32,743,-17,262,W,0,1,0
2014-01-22 00:00:00.000000,Mauritania,Gabon,2,4,African Nations Championship,Bloemfontein,South Africa,1,145,161,85,421,60,-260,L,2,0,0
2014-01-24 00:00:00.000000,Oman,Finland,0,0,Friendly,Nizwa,Oman,0,79,440,66,539,13,-99,D,1,1,0
2014-01-25 00:00:00.000000,Costa Rica,Korea Republic,0,1,Friendly,Los Angeles,USA,1,32,743,53,581,-21,162,L,2,0,0
2014-01-25 00:00:00.000000,Mali,Zimbabwe,1,2,African Nations Championship,Cape Town,South Africa,1,40,703,105,312,-65,391,L,2,0,0
2014-01-25 00:00:00.000000,Morocco,Nigeria,3,4,African Nations Championship,Cape Town,South Africa,1,74,486,41,701,33,-215,L,2,0,0
2014-01-26 00:00:00.000000,Gabon,Libya,1,1,African Nations Championship,Polokwane,South Africa,1,85,421,62,552,23,-131,D,1,0,0
2014-01-26 00:00:00.000000,Ghana,Congo DR,1,0,African Nations Championship,Bloemfontein,South Africa,1,24,851,81,439,-57,412,W,0,0,0
2014-01-29 00:00:00.000000,Mexico,Korea Republic,4,0,Friendly,San Antonio,USA,1,21,892,53,581,-32,311,W,0,0,0
2014-01-29 00:00:00.000000,Nigeria,Ghana,0,0,African Nations Championship,Bloemfontein,South Africa,1,41,701,24,851,17,-150,D,1,0,0
2014-01-29 00:00:00.000000,Zimbabwe,Libya,0,0,African Nations Championship,Bloemfontein,South Africa,1,105,312,62,552,43,-240,D,1,0,0
2014-01-31 00:00:00.000000,Oman,Jordan,0,0,AFC Asian Cup qualification,Muscat,Oman,0,79,440,72,504,7,-64,D,1,1,0
2014-02-01 00:00:00.000000,Libya,Ghana,0,0,African Nations Championship,Cape Town,South Africa,1,62,552,24,851,38,-299,D,1,0,0
2014-02-01 00:00:00.000000,USA,Korea Republic,2,0,Friendly,Carson,USA,0,14,1019,53,581,-39,438,W,0,1,0
2014-02-01 00:00:00.000000,Zimbabwe,Nigeria,0,1,African Nations Championship,Cape Town,South Africa,1,105,312,41,701,64,-389,L,2,0,0
2014-02-04 00:00:00.000000,Singapore,Jordan,1,3,AFC Asian Cup qualification,Singapore,Singapore,0,149,152,72,504,77,-352,L,2,1,0
2014-02-19 00:00:00.000000,Lebanon,Pakistan,3,1,Friendly,Beirut,Lebanon,0,121,243,165,107,-44,136,W,0,1,0
2014-02-21 00:00:00.000000,Iraq,Korea DPR,2,0,Friendly,Dubai,United Arab Emirates,1,114,269,136,191,-22,78,W,0,0,0
2014-03-01 00:00:00.000000,Malaysia,Philippines,0,0,Friendly,Selayang,Malaysia,0,150,152,127,219,23,-67,D,1,1,0
2014-03-03 00:00:00.000000,Iran,Kuwait,3,2,AFC Asian Cup qualification,Karaj,Iran,0,38,729,109,299,-71,430,W,0,1,0
2014-03-05 00:00:00.000000,Albania,Malta,2,0,Friendly,Durrës,Albania,0,55,571,131,199,-76,372,W,0,1,0
2014-03-05 00:00:00.000000,Algeria,Slovenia,2,0,Friendly,Blida,Algeria,0,26,819,27,799,-1,20,W,0,1,0
2014-03-05 00:00:00.000000,Andorra,Moldova,0,3,Friendly,Sant Julià de Lòria,Andorra,0,198,17,107,305,91,-288,L,2,1,0
2014-03-05 00:00:00.000000,Australia,Ecuador,3,4,Friendly,London,England,1,53,576,24,831,29,-255,L,2,0,0
2014-03-05 00:00:00.000000,Austria,Uruguay,1,1,Friendly,Klagenfurt,Austria,0,43,678,7,1157,36,-479,D,1,1,0
2014-03-05 00:00:00.000000,Botswana,South Sudan,3,0,Friendly,Gaborone,Botswana,0,94,360,202,10,-108,350,W,0,1,0
2014-03-05 00:00:00.000000,Bulgaria,Belarus,2,1,Friendly,Sofia,Bulgaria,0,72,486,82,423,-10,63,W,0,1,0
2014-03-05 00:00:00.000000,Burkina Faso,Comoros,1,1,Friendly,Martigues,France,1,62,554,198,17,-136,537,D,1,0,0
2014-03-05 00:00:00.000000,Burundi,Rwanda,1,1,Friendly,Bujumbura,Burundi,0,124,234,134,195,-10,39,D,1,1,0
2014-03-05 00:00:00.000000,Colombia,Tunisia,1,1,Friendly,Barcelona,Spain,1,5,1211,45,656,-40,555,D,1,0,0
2014-03-05 00:00:00.000000,Cyprus,Northern Ireland,0,0,Friendly,Nicosia,Cyprus,0,122,240,85,397,37,-157,D,1,1,0
2014-03-05 00:00:00.000000,Czech Republic,Norway,2,2,Friendly,Prague,Czech Republic,0,31,760,60,557,-29,203,D,1,1,0
2014-03-05 00:00:00.000000,England,Denmark,1,0,Friendly,London,England,0,15,1032,20,907,-5,125,W,0,1,0
2014-03-05 00:00:00.000000,France,Netherlands,2,0,Friendly,Saint-Denis,France,0,18,917,10,1122,8,-205,W,0,1,0
2014-03-05 00:00:00.000000,Georgia,Liechtenstein,2,0,Friendly,Tbilisi,Georgia,0,103,325,150,152,-47,173,W,0,1,0
2014-03-05 00:00:00.000000,Germany,Chile,1,0,Friendly,Stuttgart,Germany,0,2,1314,14,1038,-12,276,W,0,1,0
2014-03-05 00:00:00.000000,Greece,Korea Republic,0,2,Friendly,Piraeus,Greece,0,12,1084,61,556,-49,528,L,2,1,0
2014-03-05 00:00:00.000000,Hungary,Finland,1,2,Friendly,Győr,Hungary,0,44,673,65,540,-21,133,L,2,1,0
2014-03-05 00:00:00.000000,India,Bangladesh,2,2,Friendly,Margao,India,0,154,149,164,116,-10,33,D,1,1,0
2014-03-05 00:00:00.000000,Iran,Guinea,1,2,Friendly,Teheran,Iran,0,38,729,62,554,-24,175,L,2,1,0
2014-03-05 00:00:00.000000,Israel,Slovakia,1,3,Friendly,Netanya,Israel,0,56,570,54,574,2,-4,L,2,1,0
2014-03-05 00:00:00.000000,Japan,New Zealand,4,2,Friendly,Tokyo,Japan,0,50,601,89,378,-39,223,W,0,1,0
2014-03-05 00:00:00.000000,Jordan,Syria,2,1,AFC Asian Cup qualification,Amman,Jordan,0,69,514,133,196,-64,318,W,0,1,0
2014-03-05 00:00:00.000000,Kazakhstan,Lithuania,1,1,Friendly,Antalya,Turkey,1,128,214,102,326,26,-112,D,1,0,0
2014-03-05 00:00:00.000000,Malawi,Zimbabwe,1,4,Friendly,Blantyre,Malawi,0,115,268,100,330,15,-62,L,2,1,0
2014-03-05 00:00:00.000000,Mali,Senegal,1,1,Friendly,Saint-Leu-la-Forêt,France,1,59,561,66,529,-7,32,D,1,0,0
2014-03-05 00:00:00.000000,Mauritania,Niger,1,1,Friendly,Nouakchott,Mauritania,0,159,127,104,316,55,-189,D,1,1,0
2014-03-05 00:00:00.000000,Montenegro,Ghana,1,0,Friendly,Podgorica,Montenegro,0,52,594,37,733,15,-139,W,0,1,0
2014-03-05 00:00:00.000000,Morocco,Gabon,1,1,Friendly,Marrakech,Morocco,0,74,454,87,386,-13,68,D,1,1,0
2014-03-05 00:00:00.000000,Mozambique,Angola,1,1,Friendly,Maputo,Mozambique,0,118,251,95,356,23,-105,D,1,1,0
2014-03-05 00:00:00.000000,Namibia,Tanzania,1,1,Friendly,Windhoek,Namibia,0,124,234,116,254,8,-20,D,1,1,0
2014-03-05 00:00:00.000000,Oman,Singapore,3,1,AFC Asian Cup qualification,Muscat,Oman,0,80,426,150,152,-70,274,W,0,1,0
2014-03-05 00:00:00.000000,Philippines,Azerbaijan,0,1,Friendly,Dubai,United Arab Emirates,1,127,219,93,372,34,-153,L,2,0,0
2014-03-05 00:00:00.000000,Poland,Scotland,0,1,Friendly,Warsaw,Poland,0,70,494,34,742,36,-248,L,2,1,0
2014-03-05 00:00:00.000000,Portugal,Cameroon,5,1,Friendly,Leiria,Portugal,0,4,1219,46,626,-42,593,W,0,1,0
2014-03-05 00:00:00.000000,Qatar,Bahrain,0,0,AFC Asian Cup qualification,Doha,Qatar,0,99,331,106,308,-7,23,D,1,1,0
2014-03-05 00:00:00.000000,Romania,Argentina,0,0,Friendly,Bucharest,Romania,0,33,746,3,1255,30,-509,D,1,1,0
2014-03-05 00:00:00.000000,Russia,Armenia,2,0,Friendly,Krasnodar,Russia,0,22,862,30,771,-8,91,W,0,1,0
2014-03-05 00:00:00.000000,Saudi Arabia,Indonesia,1,0,AFC Asian Cup qualification,Dammam,Saudi Arabia,0,75,450,158,135,-83,315,W,0,1,0
2014-03-05 00:00:00.000000,South Africa,Brazil,0,5,Friendly,Johannesburg,South Africa,0,64,550,9,1125,55,-575,L,2,1,0
2014-03-05 00:00:00.000000,Spain,Italy,1,0,Friendly,Madrid,Spain,0,1,1506,8,1135,-7,371,W,0,1,0
2014-03-05 00:00:00.000000,St. Lucia,Jamaica,0,5,Friendly,Castries,St. Lucia,0,148,155,80,426,68,-271,L,2,1,0
2014-03-05 00:00:00.000000,Switzerland,Croatia,2,2,Friendly,St. Gallen,Switzerland,0,6,1159,16,966,-10,193,D,1,1,0
2014-03-05 00:00:00.000000,Thailand,Lebanon,2,5,AFC Asian Cup qualification,Bangkok,Thailand,0,147,158,121,243,26,-85,L,2,1,0
2014-03-05 00:00:00.000000,Turkey,Sweden,2,1,Friendly,Ankara,Turkey,0,42,703,25,821,17,-118,W,0,1,0
2014-03-05 00:00:00.000000,Ukraine,USA,2,0,Friendly,Larnaca,Cyprus,1,18,917,13,1044,5,-127,W,0,0,0
2014-03-05 00:00:00.000000,Uzbekistan,United Arab Emirates,1,1,AFC Asian Cup qualification,Tashkent,Uzbekistan,0,57,569,58,565,-1,4,D,1,1,0
2014-03-05 00:00:00.000000,Vietnam,Hong Kong,3,1,AFC Asian Cup qualification,Hanoi,Vietnam,0,143,172,144,170,-1,2,W,0,1,0
2014-03-05 00:00:00.000000,Wales,Iceland,3,1,Friendly,Cardiff,Wales,0,51,598,48,613,3,-15,W,0,1,0
2014-03-05 00:00:00.000000,Yemen,Malaysia,1,2,AFC Asian Cup qualification,al-Ain,United Arab Emirates,1,186,39,150,152,36,-113,L,2,0,0
2014-03-05 00:00:00.000000,Zambia,Uganda,2,1,Friendly,Ndola,Zambia,0,75,450,84,400,-9,50,W,0,1,0
2014-03-07 00:00:00.000000,Lesotho,Swaziland,0,1,Friendly,Maseru,Lesotho,0,139,182,184,40,-45,142,L,2,1,0
2014-03-09 00:00:00.000000,Lesotho,Swaziland,0,0,Friendly,Maseru,Lesotho,0,139,182,184,40,-45,142,D,1,1,0
2014-03-25 00:00:00.000000,Yemen,Nepal,2,0,Friendly,Doha,Qatar,1,185,40,160,102,25,-62,W,0,0,0
2014-03-26 00:00:00.000000,Andorra,Indonesia,0,1,Friendly,Alzira,Spain,1,199,15,154,128,45,-113,L,2,0,0
2014-03-27 00:00:00.000000,Aruba,Guam,2,2,Friendly,Oranjestad,Aruba,0,162,87,173,68,-11,19,D,1,1,0
2014-03-29 00:00:00.000000,Cuba,Indonesia,1,0,Friendly,Alzira,Spain,1,93,362,154,128,-61,234,W,0,0,0
2014-03-30 00:00:00.000000,Aruba,Guam,2,0,Friendly,Oranjestad,Aruba,0,162,87,173,68,-11,19,W,0,1,0
2014-04-12 00:00:00.000000,Mauritania,Mauritius,1,0,African Cup of Nations qualification,Nouakchott,Mauritania,0,152,127,176,67,-24,60,W,0,1,0
2014-04-15 00:00:00.000000,Yemen,Chad,0,0,Friendly,Doha,Qatar,1,180,60,169,80,11,-20,D,1,0,0
2014-04-20 00:00:00.000000,Mauritius,Mauritania,0,2,African Cup of Nations qualification,Curepipe,Mauritius,0,176,67,152,127,24,-60,L,2,1,0
2014-04-26 00:00:00.000000,Tanzania,Burundi,0,3,Friendly,Dar es Salaam,Tanzania,0,122,226,125,215,-3,11,L,2,1,0
2014-04-27 00:00:00.000000,Philippines,Malaysia,0,0,Friendly,Cebu,Philippines,0,143,152,142,153,1,-1,D,1,1,0
2014-05-02 00:00:00.000000,Grenada,St. Lucia,0,1,Windward Islands Tournament,Roseau,Dominica,1,134,184,141,155,-7,29,L,2,0,0
2014-05-04 00:00:00.000000,Dominica,Grenada,3,5,Windward Islands Tournament,Roseau,Dominica,0,160,103,134,184,26,-81,L,2,1,0
2014-05-13 00:00:00.000000,Germany,Poland,0,0,Friendly,Hamburg,Germany,0,2,1340,72,479,-70,861,D,1,1,0
2014-05-14 00:00:00.000000,Kuwait,Afghanistan,3,2,Friendly,Kuwait City,Kuwait,0,108,283,128,204,-20,79,W,0,1,0
2014-05-17 00:00:00.000000,Malawi,Chad,2,0,African Cup of Nations qualification,Blantyre,Malawi,0,122,227,165,88,-43,139,W,0,1,0
2014-05-17 00:00:00.000000,Mauritania,Equatorial Guinea,1,0,African Cup of Nations qualification,Nouakchott,Mauritania,0,139,165,113,261,26,-96,W,0,1,0
2014-05-17 00:00:00.000000,Namibia,Congo,1,0,African Cup of Nations qualification,Windhoek,Namibia,0,120,233,92,367,28,-134,W,0,1,0
2014-05-17 00:00:00.000000,Netherlands,Ecuador,1,1,Friendly,Amsterdam,Netherlands,0,15,967,28,794,-13,173,D,1,1,0
2014-05-18 00:00:00.000000,Belarus,Iran,0,0,Friendly,Kapfenberg,Austria,1,83,404,37,715,46,-311,D,1,0,0
2014-05-18 00:00:00.000000,Burundi,Botswana,0,0,African Cup of Nations qualification,Bujumbura,Burundi,0,125,215,91,369,34,-154,D,1,1,0
2014-05-18 00:00:00.000000,Central African Republic,Guinea-Bissau,0,0,African Cup of Nations qualification,Brazzaville,Congo,1,106,284,184,43,-78,241,D,1,0,0
2014-05-18 00:00:00.000000,Liberia,Lesotho,1,0,African Cup of Nations qualification,Monrovia,Liberia,0,119,234,141,159,-22,75,W,0,1,0
2014-05-18 00:00:00.000000,Libya,Rwanda,0,0,African Cup of Nations qualification,Radès,Tunisia,1,62,522,131,197,-69,325,D,1,0,0
2014-05-18 00:00:00.000000,Tanzania,Zimbabwe,1,0,African Cup of Nations qualification,Dar es Salaam,Tanzania,0,122,227,98,327,24,-100,W,0,1,0
2014-05-20 00:00:00.000000,Philippines,Afghanistan,0,0,AFC Challenge Cup,Addu City,Maldives,1,140,161,128,204,12,-43,D,1,0,0
2014-05-20 00:00:00.000000,Turkmenistan,Laos,5,1,AFC Challenge Cup,Addu City,Maldives,1,156,119,173,73,-17,46,W,0,0,0
2014-05-21 00:00:00.000000,Burkina Faso,Senegal,1,1,Friendly,Ouagadougou,Burkina Faso,0,61,528,63,511,-2,17,D,1,1,0
2014-05-21 00:00:00.000000,Finland,Czech Republic,2,2,Friendly,Helsinki,Finland,0,52,578,36,731,16,-153,D,1,1,0
2014-05-21 00:00:00.000000,Liechtenstein,Belarus,1,5,Friendly,Vaduz,Liechtenstein,0,150,139,83,404,67,-265,L,2,1,0
2014-05-22 00:00:00.000000,Afghanistan,Turkmenistan,3,1,AFC Challenge Cup,Addu City,Maldives,1,128,204,156,119,-28,85,W,0,0,0
2014-05-22 00:00:00.000000,Hungary,Denmark,2,2,Friendly,Debrecen,Hungary,0,45,623,23,819,22,-196,D,1,1,0
2014-05-22 00:00:00.000000,Laos,Philippines,0,2,AFC Challenge Cup,Addu City,Maldives,1,173,73,140,161,33,-88,L,2,0,0
2014-05-22 00:00:00.000000,Ukraine,Niger,2,1,Friendly,Kyïv,Ukraine,0,17,913,102,315,-85,598,W,0,1,0
2014-05-23 00:00:00.000000,Bulgaria,Canada,1,1,Friendly,Ritzing,Austria,1,73,460,110,272,-37,188,D,1,0,0
2014-05-23 00:00:00.000000,Maldives,Palestine,0,0,AFC Challenge Cup,Malé,Maldives,0,153,124,165,88,-12,36,D,1,1,0
2014-05-23 00:00:00.000000,Slovakia,Montenegro,2,0,Friendly,Senec,Slovakia,0,46,616,54,555,-8,61,W,0,1,0
2014-05-24 00:00:00.000000,Afghanistan,Laos,0,0,AFC Challenge Cup,Addu City,Maldives,1,128,204,173,73,-45,131,D,1,0,0
2014-05-24 00:00:00.000000,Moldova,Saudi Arabia,4,0,Friendly,Jerez de la Frontera,Spain,1,99,325,75,455,24,-130,W,0,0,0
2014-05-24 00:00:00.000000,Turkmenistan,Philippines,0,2,AFC Challenge Cup,Malé,Maldives,1,156,119,140,161,16,-42,L,2,0,0
2014-05-25 00:00:00.000000,Mali,Guinea,1,2,Friendly,Colombes,France,1,59,545,51,580,8,-35,L,2,0,0
2014-05-25 00:00:00.000000,Thailand,Kuwait,1,1,Friendly,Bangkok,Thailand,0,143,156,108,283,35,-127,D,1,1,0
2014-05-26 00:00:00.000000,Australia,South Africa,1,1,Friendly,Sydney,Australia,0,59,545,65,507,-6,38,D,1,1,0
2014-05-26 00:00:00.000000,Belgium,Luxembourg,5,1,Friendly,Genk,Belgium,0,12,1039,112,266,-100,773,W,0,1,0
2014-05-26 00:00:00.000000,Jamaica,Serbia,1,2,Friendly,Harrison,USA,1,81,420,30,759,51,-339,L,2,0,0
2014-05-26 00:00:00.000000,Montenegro,Iran,0,0,Friendly,Hartberg,Austria,1,54,555,37,715,17,-160,D,1,0,0
2014-05-26 00:00:00.000000,Russia,Slovakia,1,0,Friendly,St. Petersburg,Russia,0,18,903,46,616,-28,287,W,0,1,0
2014-05-27 00:00:00.000000,Armenia,United Arab Emirates,4,3,Friendly,Carouge,Switzerland,1,33,750,67,499,-34,251,W,0,0,0
2014-05-27 00:00:00.000000,France,Norway,4,0,Friendly,Saint-Denis,France,0,16,935,55,551,-39,384,W,0,1,0
2014-05-27 00:00:00.000000,Japan,Cyprus,1,0,Friendly,Saitama,Japan,0,47,613,130,201,-83,412,W,0,1,0
2014-05-27 00:00:00.000000,Maldives,Philippines,2,3,AFC Challenge Cup,Malé,Maldives,0,153,124,140,161,13,-37,L,2,1,0
2014-05-27 00:00:00.000000,Moldova,Canada,1,1,Friendly,Mauer,Austria,1,99,325,110,272,-11,53,D,1,0,0
2014-05-27 00:00:00.000000,Palestine,Afghanistan,2,0,AFC Challenge Cup,Malé,Maldives,1,165,88,128,204,37,-116,W,0,0,0
2014-05-27 00:00:00.000000,Tanzania,Malawi,1,0,Friendly,Dar es Salaam,Tanzania,0,122,227,122,227,0,0,W,0,1,0
2014-05-27 00:00:00.000000,Uzbekistan,Oman,0,1,Friendly,Olmaliq,Uzbekistan,0,53,577,82,418,-29,159,L,2,1,0
2014-05-28 00:00:00.000000,Angola,Morocco,2,0,Friendly,Faro,Portugal,1,94,347,76,454,18,-107,W,0,0,0
2014-05-28 00:00:00.000000,Denmark,Sweden,1,0,Friendly,Copenhagen,Denmark,0,23,819,25,795,-2,24,W,0,1,0
2014-05-28 00:00:00.000000,Korea Republic,Tunisia,0,1,Friendly,Seoul,Korea Republic,0,55,551,49,597,6,-46,L,2,1,0
2014-05-28 00:00:00.000000,Nigeria,Scotland,2,2,Friendly,London,England,1,44,631,22,825,22,-194,D,1,0,0
2014-05-29 00:00:00.000000,Cameroon,Paraguay,1,2,Friendly,Kufstein,Austria,1,50,583,55,551,-5,32,L,2,0,0
2014-05-29 00:00:00.000000,Finland,Lithuania,0,1,Baltic Cup,Ventspils,Latvia,1,52,578,104,293,-52,285,L,2,0,0
2014-05-29 00:00:00.000000,Georgia,Saudi Arabia,2,0,Friendly,Jerez de la Frontera,Spain,1,103,303,75,455,28,-152,W,0,0,0
2014-05-29 00:00:00.000000,Latvia,Estonia,0,0,Baltic Cup,Liepāja,Latvia,0,109,273,93,366,16,-93,D,1,1,0
2014-05-29 00:00:00.000000,Maldives,Afghanistan,1,1,AFC Challenge Cup,Malé,Maldives,0,153,124,128,204,25,-80,D,1,1,0
2014-05-29 00:00:00.000000,Uzbekistan,Oman,0,1,Friendly,Tashkent,Uzbekistan,0,53,577,82,418,-29,159,L,2,1,0
2014-05-30 00:00:00.000000,Angola,Iran,1,1,Friendly,Hartberg,Austria,1,94,347,37,715,57,-368,D,1,0,0
2014-05-30 00:00:00.000000,Aruba,Turks and Caicos Islands,1,0,CFU Caribbean Cup qualification,Oranjestad,Aruba,0,155,122,207,0,-52,122,W,0,1,0
2014-05-30 00:00:00.000000,Austria,Iceland,1,1,Friendly,Innsbruck,Austria,0,40,673,58,546,-18,127,D,1,1,0
2014-05-30 00:00:00.000000,Comoros,Kenya,1,1,African Cup of Nations qualification,Mitsamiouli,Comoros,0,184,43,106,284,78,-241,D,1,1,0
2014-05-30 00:00:00.000000,England,Peru,3,0,Friendly,London,England,0,11,1043,42,665,-31,378,W,0,1,0
2014-05-30 00:00:00.000000,New Zealand,South Africa,0,0,Friendly,Auckland,New Zealand,0,111,271,65,507,46,-236,D,1,1,0
2014-05-30 00:00:00.000000,Palestine,Philippines,1,0,AFC Challenge Cup,Malé,Maldives,1,165,88,140,161,25,-73,W,0,0,0
2014-05-30 00:00:00.000000,South Sudan,Mozambique,0,0,African Cup of Nations qualification,Khartoum,Sudan,1,201,10,114,251,87,-241,D,1,0,0
2014-05-30 00:00:00.000000,Spain,Bolivia,2,0,Friendly,Seville,Spain,0,1,1460,68,497,-67,963,W,0,1,0
2014-05-30 00:00:00.000000,Switzerland,Jamaica,1,0,Friendly,Lucerne,Switzerland,0,8,1161,81,420,-73,741,W,0,1,0
2014-05-30 00:00:00.000000,Uruguay,Northern Ireland,1,0,Friendly,Montevideo,Uruguay,0,6,1181,84,400,-78,781,W,0,1,0
2014-05-31 00:00:00.000000,Albania,Romania,0,1,Friendly,Yverdon-les-Bains,Switzerland,1,70,486,32,756,38,-270,L,2,0,0
2014-05-31 00:00:00.000000,Armenia,Algeria,1,3,Friendly,Sion,Switzerland,1,33,750,25,795,8,-45,L,2,0,0
2014-05-31 00:00:00.000000,Chad,Malawi,3,1,African Cup of Nations qualification,N'Djamena,Chad,0,165,88,122,227,43,-139,W,0,1,0
2014-05-31 00:00:00.000000,Colombia,Senegal,2,2,Friendly,Buenos Aires,Argentina,1,5,1186,63,511,-58,675,D,1,0,0
2014-05-31 00:00:00.000000,Croatia,Mali,2,1,Friendly,Osijek,Croatia,0,20,871,59,545,-39,326,W,0,1,0
2014-05-31 00:00:00.000000,Finland,Estonia,2,0,Baltic Cup,Ventspils,Latvia,1,52,578,93,366,-41,212,W,0,0,0
2014-05-31 00:00:00.000000,Guinea-Bissau,Central African Republic,3,1,African Cup of Nations qualification,Bissau,Guinea-Bissau,0,184,43,106,284,78,-241,W,0,1,0
2014-05-31 00:00:00.000000,Latvia,Lithuania,1,0,Baltic Cup,Liepāja,Latvia,0,109,273,104,293,5,-20,W,0,1,0
2014-05-31 00:00:00.000000,Mexico,Ecuador,3,1,Friendly,Arlington,USA,1,19,877,28,794,-9,83,W,0,0,0
2014-05-31 00:00:00.000000,Netherlands,Ghana,1,0,Friendly,Rotterdam,Netherlands,0,15,967,38,713,-23,254,W,0,1,0
2014-05-31 00:00:00.000000,Norway,Russia,1,1,Friendly,Oslo,Norway,0,55,551,18,903,37,-352,D,1,1,0
2014-05-31 00:00:00.000000,Portugal,Greece,0,0,Friendly,Oeiras,Portugal,0,3,1245,10,1082,-7,163,D,1,1,0
2014-05-31 00:00:00.000000,Rwanda,Libya,3,0,African Cup of Nations qualification,Kigali,Rwanda,0,131,197,62,522,69,-325,W,0,1,0
2014-05-31 00:00:00.000000,Sierra Leone,Swaziland,1,0,African Cup of Nations qualification,Freetown,Sierra Leone,0,71,484,178,64,-107,420,W,0,1,0
2014-05-31 00:00:00.000000,Uganda,Madagascar,1,0,African Cup of Nations qualification,Kampala,Uganda,0,86,395,189,32,-103,363,W,0,1,0
2014-06-01 00:00:00.000000,Aruba,British Virgin Islands,7,0,CFU Caribbean Cup qualification,Oranjestad,Aruba,0,155,122,197,18,-42,104,W,0,1,0
2014-06-01 00:00:00.000000,Botswana,Burundi,1,0,African Cup of Nations qualification,Lobatse,Botswana,0,91,369,125,215,-34,154,W,0,1,0
2014-06-01 00:00:00.000000,Congo,Namibia,3,0,African Cup of Nations qualification,Pointe-Noire,Congo,0,92,367,120,233,-28,134,W,0,1,0
2014-06-01 00:00:00.000000,Equatorial Guinea,Mauritania,3,0,African Cup of Nations qualification,Malabo,Equatorial Guinea,0,113,261,139,165,-26,96,W,0,1,0
2014-06-01 00:00:00.000000,France,Paraguay,1,1,Friendly,Nice,France,0,16,935,55,551,-39,384,D,1,1,0
2014-06-01 00:00:00.000000,Germany,Cameroon,2,2,Friendly,Mönchengladbach,Germany,0,2,1340,50,583,-48,757,D,1,1,0
2014-06-01 00:00:00.000000,Honduras,Israel,2,4,Friendly,Houston,USA,1,30,759,78,450,-48,309,L,2,0,0
2014-06-01 00:00:00.000000,Lesotho,Liberia,2,0,African Cup of Nations qualification,Maseru,Lesotho,0,141,159,119,234,22,-75,W,0,1,0
2014-06-01 00:00:00.000000,Sweden,Belgium,0,2,Friendly,Solna,Sweden,0,25,795,12,1039,13,-244,L,2,1,0
2014-06-01 00:00:00.000000,USA,Turkey,2,1,Friendly,Harrison,USA,0,14,1015,39,711,-25,304,W,0,1,0
2014-06-01 00:00:00.000000,Zimbabwe,Tanzania,2,2,African Cup of Nations qualification,Harare,Zimbabwe,0,98,327,122,227,-24,100,D,1,1,0
2014-06-02 00:00:00.000000,Costa Rica,Japan,1,3,Friendly,Tampa,USA,1,34,748,47,613,-13,135,L,2,0,0
2014-06-03 00:00:00.000000,Brazil,Panama,4,0,Friendly,Goiânia,Brazil,0,4,1210,35,739,-31,471,W,0,1,0
2014-06-03 00:00:00.000000,British Virgin Islands,Turks and Caicos Islands,0,2,CFU Caribbean Cup qualification,Oranjestad,Aruba,1,197,18,207,0,-10,18,L,2,0,0
2014-06-03 00:00:00.000000,Czech Republic,Austria,1,2,Friendly,Olomouc,Czech Republic,0,36,731,40,673,-4,58,L,2,1,0
2014-06-03 00:00:00.000000,Georgia,United Arab Emirates,0,1,Friendly,Meyrin,Switzerland,1,103,303,67,499,36,-196,L,2,0,0
2014-06-03 00:00:00.000000,Greece,Nigeria,0,0,Friendly,Chester,USA,1,10,1082,44,631,-34,451,D,1,0,0
2014-06-03 00:00:00.000000,Switzerland,Peru,2,0,Friendly,Lucerne,Switzerland,0,8,1161,42,665,-34,496,W,0,1,0
2014-06-06 00:00:00.000000,Bolivia,Greece,1,2,Friendly,Harrison,USA,1,67,483,12,1064,55,-581,L,2,0,0
2014-06-06 00:00:00.000000,Brazil,Serbia,1,0,Friendly,São Paulo,Brazil,0,3,1242,30,745,-27,497,W,0,1,0
2014-06-06 00:00:00.000000,Colombia,Jordan,3,0,Friendly,Buenos Aires,Argentina,1,8,1137,63,510,-55,627,W,0,0,0
2014-06-06 00:00:00.000000,Croatia,Australia,1,0,Friendly,Salvador,Brazil,1,18,903,62,526,-44,377,W,0,0,0
2014-06-06 00:00:00.000000,Germany,Armenia,6,1,Friendly,Mainz,Germany,0,2,1300,38,682,-36,618,W,0,1,0
2014-06-06 00:00:00.000000,Japan,Zambia,4,3,Friendly,Tampa,USA,1,46,626,76,441,-30,185,W,0,0,0
2014-06-06 00:00:00.000000,Mexico,Portugal,0,1,Friendly,Foxborough,USA,1,20,882,4,1189,16,-307,L,2,0,0
2014-06-06 00:00:00.000000,Poland,Lithuania,2,1,Friendly,Gdańsk,Poland,0,69,474,106,319,-37,155,W,0,1,0
2014-06-06 00:00:00.000000,Russia,Morocco,2,0,Friendly,Moscow,Russia,0,19,893,77,439,-58,454,W,0,1,0
2014-06-07 00:00:00.000000,Argentina,Slovenia,2,0,Friendly,La Plata,Argentina,0,5,1175,25,800,-20,375,W,0,1,0
2014-06-07 00:00:00.000000,Belgium,Tunisia,1,0,Friendly,Brussels,Belgium,0,11,1074,48,612,-37,462,W,0,1,0
2014-06-07 00:00:00.000000,Cameroon,Moldova,1,0,Friendly,Yaoundé,Cameroon,0,56,558,101,334,-45,224,W,0,1,0
2014-06-07 00:00:00.000000,El Salvador,Spain,0,2,Friendly,Landover,USA,1,68,481,1,1485,67,-1004,L,2,0,0
2014-06-07 00:00:00.000000,Estonia,Tajikistan,2,1,Friendly,Tallinn,Estonia,0,98,343,126,229,-28,114,W,0,1,0
2014-06-07 00:00:00.000000,Honduras,England,0,0,Friendly,Miami Gardens,USA,1,33,731,10,1090,23,-359,D,1,0,0
2014-06-07 00:00:00.000000,Hungary,Kazakhstan,3,0,Friendly,Budapest,Hungary,0,47,624,124,241,-77,383,W,0,1,0
2014-06-07 00:00:00.000000,USA,Nigeria,2,1,Friendly,Jacksonville,USA,0,13,1035,44,640,-31,395,W,0,1,0
2014-06-08 00:00:00.000000,France,Jamaica,8,0,Friendly,Villeneuve-d'Ascq,France,0,17,913,81,411,-64,502,W,0,1,0
2014-06-08 00:00:00.000000,Iran,Trinidad and Tobago,2,0,Friendly,São Paulo,Brazil,1,43,641,71,470,-28,171,W,0,0,0
2014-06-08 00:00:00.000000,San Marino,Albania,0,3,Friendly,Serravalle,San Marino,0,207,0,66,495,141,-495,L,2,1,0
2014-06-09 00:00:00.000000,Ghana,Korea Republic,4,0,Friendly,Miami Gardens,USA,1,37,704,57,547,-20,157,W,0,0,0
2014-06-12 00:00:00.000000,Brazil,Croatia,3,1,FIFA World Cup,São Paulo,Brazil,0,3,1242,18,903,-15,339,W,0,1,0
2014-06-13 00:00:00.000000,Chile,Australia,3,1,FIFA World Cup,Cuiabá,Brazil,1,14,1026,62,526,-48,500,W,0,0,0
2014-06-13 00:00:00.000000,Mexico,Cameroon,1,0,FIFA World Cup,Natal,Brazil,1,20,882,56,558,-36,324,W,0,0,0
2014-06-13 00:00:00.000000,Spain,Netherlands,1,5,FIFA World Cup,Salvador,Brazil,1,1,1485,15,981,-14,504,L,2,0,0
2014-06-14 00:00:00.000000,Colombia,Greece,3,0,FIFA World Cup,Belo Horizonte,Brazil,1,8,1137,12,1064,-4,73,W,0,0,0
2014-06-14 00:00:00.000000,England,Italy,1,2,FIFA World Cup,Manaus,Brazil,1,10,1090,9,1104,1,-14,L,2,0,0
2014-06-14 00:00:00.000000,Uruguay,Costa Rica,1,3,FIFA World Cup,Fortaleza,Brazil,1,7,1147,28,762,-21,385,L,2,0,0
2014-06-15 00:00:00.000000,France,Honduras,3,0,FIFA World Cup,Porto Alegre,Brazil,1,17,913,33,731,-16,182,W,0,0,0
2014-06-15 00:00:00.000000,Switzerland,Ecuador,2,1,FIFA World Cup,Brasília,Brazil,1,6,1149,26,791,-20,358,W,0,0,0
2014-06-16 00:00:00.000000,Germany,Portugal,4,0,FIFA World Cup,Salvador,Brazil,1,2,1300,4,1189,-2,111,W,0,0,0
2014-06-16 00:00:00.000000,Ghana,USA,1,2,FIFA World Cup,Natal,Brazil,1,37,704,13,1035,24,-331,L,2,0,0
2014-06-16 00:00:00.000000,Iran,Nigeria,0,0,FIFA World Cup,Curitiba,Brazil,1,43,641,44,640,-1,1,D,1,0,0
2014-06-17 00:00:00.000000,Belgium,Algeria,2,1,FIFA World Cup,Belo Horizonte,Brazil,1,11,1074,22,858,-11,216,W,0,0,0
2014-06-17 00:00:00.000000,Brazil,Mexico,0,0,FIFA World Cup,Fortaleza,Brazil,0,3,1242,20,882,-17,360,D,1,1,0
2014-06-17 00:00:00.000000,Russia,Korea Republic,1,1,FIFA World Cup,Cuiabá,Brazil,1,19,893,57,547,-38,346,D,1,0,0
2014-06-18 00:00:00.000000,Australia,Netherlands,2,3,FIFA World Cup,Curitiba,Brazil,1,62,526,15,981,47,-455,L,2,0,0
2014-06-18 00:00:00.000000,Cameroon,Croatia,0,4,FIFA World Cup,Manaus,Brazil,1,56,558,18,903,38,-345,L,2,0,0
2014-06-18 00:00:00.000000,Spain,Chile,0,2,FIFA World Cup,Rio de Janeiro,Brazil,1,1,1485,14,1026,-13,459,L,2,0,0
2014-06-19 00:00:00.000000,Japan,Greece,0,0,FIFA World Cup,Natal,Brazil,1,46,626,12,1064,34,-438,D,1,0,0
2014-06-19 00:00:00.000000,Uruguay,England,2,1,FIFA World Cup,São Paulo,Brazil,1,7,1147,10,1090,-3,57,W,0,0,0
2014-06-20 00:00:00.000000,Honduras,Ecuador,1,2,FIFA World Cup,Curitiba,Brazil,1,33,731,26,791,7,-60,L,2,0,0
2014-06-20 00:00:00.000000,Italy,Costa Rica,0,1,FIFA World Cup,Recife,Brazil,1,9,1104,28,762,-19,342,L,2,0,0
2014-06-20 00:00:00.000000,Switzerland,France,2,5,FIFA World Cup,Salvador,Brazil,1,6,1149,17,913,-11,236,L,2,0,0
2014-06-21 00:00:00.000000,Argentina,Iran,1,0,FIFA World Cup,Belo Horizonte,Brazil,1,5,1175,43,641,-38,534,W,0,0,0
2014-06-21 00:00:00.000000,Germany,Ghana,2,2,FIFA World Cup,Fortaleza,Brazil,1,2,1300,37,704,-35,596,D,1,0,0
2014-06-21 00:00:00.000000,Indonesia,Pakistan,4,0,Friendly,Surabaya,Indonesia,0,157,135,164,102,-7,33,W,0,1,0
2014-06-22 00:00:00.000000,Belgium,Russia,1,0,FIFA World Cup,Rio de Janeiro,Brazil,1,11,1074,19,893,-8,181,W,0,0,0
2014-06-22 00:00:00.000000,Korea Republic,Algeria,2,4,FIFA World Cup,Porto Alegre,Brazil,1,57,547,22,858,35,-311,L,2,0,0
2014-06-22 00:00:00.000000,USA,Portugal,2,2,FIFA World Cup,Manaus,Brazil,1,13,1035,4,1189,9,-154,D,1,0,0
2014-06-23 00:00:00.000000,Australia,Spain,0,3,FIFA World Cup,Curitiba,Brazil,1,62,526,1,1485,61,-959,L,2,0,0
2014-06-23 00:00:00.000000,Brazil,Cameroon,4,1,FIFA World Cup,Brasília,Brazil,0,3,1242,56,558,-53,684,W,0,1,0
2014-06-23 00:00:00.000000,Croatia,Mexico,1,3,FIFA World Cup,Recife,Brazil,1,18,903,20,882,-2,21,L,2,0,0
2014-06-23 00:00:00.000000,Netherlands,Chile,2,0,FIFA World Cup,São Paulo,Brazil,1,15,981,14,1026,1,-45,W,0,0,0
2014-06-24 00:00:00.000000,Costa Rica,England,0,0,FIFA World Cup,Belo Horizonte,Brazil,1,28,762,10,1090,18,-328,D,1,0,0
2014-06-24 00:00:00.000000,Italy,Uruguay,0,1,FIFA World Cup,Natal,Brazil,1,9,1104,7,1147,2,-43,L,2,0,0
2014-06-24 00:00:00.000000,Japan,Colombia,1,4,FIFA World Cup,Cuiabá,Brazil,1,46,626,8,1137,38,-511,L,2,0,0
2014-06-25 00:00:00.000000,Ecuador,France,0,0,FIFA World Cup,Rio de Janeiro,Brazil,1,26,791,17,913,9,-122,D,1,0,0
2014-06-25 00:00:00.000000,Honduras,Switzerland,0,3,FIFA World Cup,Manaus,Brazil,1,33,731,6,1149,27,-418,L,2,0,0
2014-06-25 00:00:00.000000,Indonesia,Nepal,2,0,Friendly,Malang,Indonesia,0,157,135,164,102,-7,33,W,0,1,0
2014-06-25 00:00:00.000000,Nigeria,Argentina,2,3,FIFA World Cup,Porto Alegre,Brazil,1,44,640,5,1175,39,-535,L,2,0,0
2014-06-26 00:00:00.000000,Algeria,Russia,1,1,FIFA World Cup,Curitiba,Brazil,1,22,858,19,893,3,-35,D,1,0,0
2014-06-26 00:00:00.000000,Korea Republic,Belgium,0,1,FIFA World Cup,São Paulo,Brazil,1,57,547,11,1074,46,-527,L,2,0,0
2014-06-26 00:00:00.000000,Portugal,Ghana,2,1,FIFA World Cup,Brasília,Brazil,1,4,1189,37,704,-33,485,W,0,0,0
2014-06-26 00:00:00.000000,USA,Germany,0,1,FIFA World Cup,Recife,Brazil,1,13,1035,2,1300,11,-265,L,2,0,0
2014-06-28 00:00:00.000000,Brazil,Chile,1,1,FIFA World Cup,Belo Horizonte,Brazil,0,3,1242,14,1026,-11,216,D,1,1,0
2014-06-28 00:00:00.000000,Colombia,Uruguay,2,0,FIFA World Cup,Rio de Janeiro,Brazil,1,8,1137,7,1147,1,-10,W,0,0,0
2014-06-29 00:00:00.000000,Costa Rica,Greece,1,1,FIFA World Cup,Recife,Brazil,1,28,762,12,1064,16,-302,D,1,0,0
2014-06-29 00:00:00.000000,Netherlands,Mexico,2,1,FIFA World Cup,Fortaleza,Brazil,1,15,981,20,882,-5,99,W,0,0,0
2014-06-30 00:00:00.000000,France,Nigeria,2,0,FIFA World Cup,Brasília,Brazil,1,17,913,44,640,-27,273,W,0,0,0
2014-06-30 00:00:00.000000,Germany,Algeria,2,1,FIFA World Cup,Porto Alegre,Brazil,1,2,1300,22,858,-20,442,W,0,0,0
2014-07-01 00:00:00.000000,Argentina,Switzerland,1,0,FIFA World Cup,São Paulo,Brazil,1,5,1175,6,1149,-1,26,W,0,0,0
2014-07-01 00:00:00.000000,Belgium,USA,2,1,FIFA World Cup,Salvador,Brazil,1,11,1074,13,1035,-2,39,W,0,0,0
2014-07-04 00:00:00.000000,Brazil,Colombia,2,1,FIFA World Cup,Fortaleza,Brazil,0,3,1242,8,1137,-5,105,W,0,1,0
2014-07-04 00:00:00.000000,France,Germany,0,1,FIFA World Cup,Rio de Janeiro,Brazil,1,17,913,2,1300,15,-387,L,2,0,0
2014-07-05 00:00:00.000000,Argentina,Belgium,1,0,FIFA World Cup,Brasília,Brazil,1,5,1175,11,1074,-6,101,W,0,0,0
2014-07-05 00:00:00.000000,Netherlands,Costa Rica,0,0,FIFA World Cup,Salvador,Brazil,1,15,981,28,762,-13,219,D,1,0,0
2014-07-06 00:00:00.000000,Malawi,Mozambique,1,1,Friendly,Lilongwe,Malawi,0,122,247,118,269,4,-22,D,1,1,0
2014-07-08 00:00:00.000000,Brazil,Germany,1,7,FIFA World Cup,Belo Horizonte,Brazil,0,3,1242,2,1300,1,-58,L,2,1,0
2014-07-09 00:00:00.000000,Netherlands,Argentina,0,0,FIFA World Cup,São Paulo,Brazil,1,15,981,5,1175,10,-194,D,1,0,0
2014-07-11 00:00:00.000000,Uganda,Seychelles,1,0,Friendly,Kampala,Uganda,0,86,390,181,66,-95,324,W,0,1,0
2014-07-12 00:00:00.000000,Brazil,Netherlands,0,3,FIFA World Cup,Brasília,Brazil,0,3,1242,15,981,-12,261,L,2,1,0
2014-07-12 00:00:00.000000,Rwanda,Gabon,1,0,Friendly,Kigali,Rwanda,0,116,271,89,382,27,-111,W,0,1,0
2014-07-13 00:00:00.000000,Germany,Argentina,1,0,FIFA World Cup,Rio de Janeiro,Brazil,1,2,1300,5,1175,-3,125,W,0,0,0
2014-07-14 00:00:00.000000,Botswana,Lesotho,2,0,Friendly,Gaborone,Botswana,0,92,375,139,194,-47,181,W,0,1,0
2014-07-14 00:00:00.000000,Qatar,Indonesia,2,2,Friendly,al-Wakrah,Qatar,0,100,339,157,135,-57,204,D,1,1,0
2014-07-15 00:00:00.000000,Kenya,Burundi,0,0,Friendly,Nairobi,Kenya,0,108,296,128,221,-20,75,D,1,1,0
2014-07-15 00:00:00.000000,Uganda,Malawi,0,0,Friendly,Kampala,Uganda,0,86,390,122,247,-36,143,D,1,1,0
2014-07-19 00:00:00.000000,Botswana,Guinea-Bissau,2,0,African Cup of Nations qualification,Gaborone,Botswana,0,99,332,136,199,-37,133,W,0,1,0
2014-07-19 00:00:00.000000,Sierra Leone,Seychelles,2,0,African Cup of Nations qualification,Freetown,Sierra Leone,0,64,469,182,64,-118,405,W,0,1,0
2014-07-19 00:00:00.000000,Uganda,Mauritania,2,0,African Cup of Nations qualification,Kampala,Uganda,0,87,358,133,208,-46,150,W,0,1,0
2014-07-20 00:00:00.000000,Benin,Malawi,1,0,African Cup of Nations qualification,Cotonou,Benin,0,91,354,121,234,-30,120,W,0,1,0
2014-07-20 00:00:00.000000,Congo,Rwanda,2,0,African Cup of Nations qualification,Pointe-Noire,Congo,0,82,375,109,276,-27,99,W,0,1,0
2014-07-20 00:00:00.000000,Lesotho,Kenya,1,0,African Cup of Nations qualification,Maseru,Lesotho,0,131,213,95,339,36,-126,W,0,1,0
2014-07-20 00:00:00.000000,Tanzania,Mozambique,2,2,African Cup of Nations qualification,Dar es Salaam,Tanzania,0,106,287,114,257,-8,30,D,1,1,0
2014-07-21 00:00:00.000000,Guam,Macau,0,0,EAFF Championship,Dededo,Guam,0,174,79,204,7,-30,72,D,1,1,0
2014-07-23 00:00:00.000000,Guam,Mongolia,2,0,EAFF Championship,Dededo,Guam,0,174,79,189,29,-15,50,W,0,1,0
2014-07-25 00:00:00.000000,Macau,Mongolia,3,2,EAFF Championship,Dededo,Guam,1,204,7,189,29,15,-22,W,0,0,0
2014-07-27 00:00:00.000000,Gabon,Rwanda,0,1,Friendly,Libreville,Gabon,0,93,344,109,276,-16,68,L,2,1,0
2014-08-02 00:00:00.000000,Guinea-Bissau,Botswana,1,1,African Cup of Nations qualification,Bissau,Guinea-Bissau,0,136,199,99,332,37,-133,D,1,1,0
2014-08-02 00:00:00.000000,Malawi,Benin,1,0,African Cup of Nations qualification,Blantyre,Malawi,0,121,234,91,354,30,-120,W,0,1,0
2014-08-02 00:00:00.000000,Rwanda,Congo,2,0,African Cup of Nations qualification,Kigali,Rwanda,0,109,276,82,375,27,-99,W,0,1,0
2014-08-03 00:00:00.000000,Kenya,Lesotho,0,0,African Cup of Nations qualification,Nairobi,Kenya,0,95,339,131,213,-36,126,D,1,1,0
2014-08-03 00:00:00.000000,Mauritania,Uganda,0,1,African Cup of Nations qualification,Nouakchott,Mauritania,0,133,208,87,358,46,-150,L,2,1,0
2014-08-03 00:00:00.000000,Mozambique,Tanzania,2,1,African Cup of Nations qualification,Maputo,Mozambique,0,114,257,106,287,8,-30,W,0,1,0
2014-08-08 00:00:00.000000,Tajikistan,Malaysia,4,1,Friendly,Dushanbe,Tajikistan,0,124,232,151,144,-27,88,W,0,1,0
2014-08-12 00:00:00.000000,Kazakhstan,Tajikistan,2,1,Friendly,Almaty,Kazakhstan,0,127,220,124,232,3,-12,W,0,1,0
2014-08-14 00:00:00.000000,Guatemala,Nicaragua,3,0,Friendly,Antigua Guatemala,Guatemala,0,134,203,175,78,-41,125,W,0,1,0
2014-08-20 00:00:00.000000,Azerbaijan,Uzbekistan,0,0,Friendly,Baku,Azerbaijan,0,73,413,51,528,22,-115,D,1,1,0
2014-08-20 00:00:00.000000,Panama,Cuba,4,0,Friendly,Panama City,Panama,0,63,474,124,233,-61,241,W,0,1,0
2014-08-23 00:00:00.000000,Guatemala,Cuba,1,0,Friendly,Guatemala,Guatemala,0,134,203,124,233,10,-30,W,0,1,0
2014-08-26 00:00:00.000000,Seychelles,Sri Lanka,1,2,Friendly,Victoria,Seychelles,0,180,68,178,71,2,-3,L,2,1,0
2014-08-27 00:00:00.000000,Norway,United Arab Emirates,0,0,Friendly,Stavanger,Norway,0,53,512,65,464,-12,48,D,1,1,0
2014-08-28 00:00:00.000000,Seychelles,Sri Lanka,3,0,Friendly,Victoria,Seychelles,0,180,68,178,71,2,-3,W,0,1,0
2014-08-30 00:00:00.000000,Egypt,Kenya,1,0,Friendly,Aswan,Egypt,0,38,645,104,305,-66,340,W,0,1,0
2014-08-30 00:00:00.000000,El Salvador,Dominican Republic,2,0,Friendly,San Salvador,El Salvador,0,127,223,126,230,1,-7,W,0,1,0
2014-08-31 00:00:00.000000,Zambia,Sudan,3,1,Friendly,Lusaka,Zambia,0,84,375,115,263,-31,112,W,0,1,0
2014-09-02 00:00:00.000000,Niger,Uganda,2,0,Friendly,Niamey,Niger,0,118,261,81,381,37,-120,W,0,1,0
2014-09-03 00:00:00.000000,Costa Rica,Nicaragua,3,0,UNCAF Cup,Washington,USA,1,15,1023,175,78,-160,945,W,0,0,0
2014-09-03 00:00:00.000000,Czech Republic,USA,0,1,Friendly,Prague,Czech Republic,0,35,650,18,937,17,-287,L,2,1,0
2014-09-03 00:00:00.000000,Denmark,Turkey,1,2,Friendly,Odense,Denmark,0,26,818,32,711,-6,107,L,2,1,0
2014-09-03 00:00:00.000000,England,Norway,1,0,Friendly,London,England,0,20,915,53,512,-33,403,W,0,1,0
2014-09-03 00:00:00.000000,Germany,Argentina,2,4,Friendly,Düsseldorf,Germany,0,1,1736,2,1604,-1,132,L,2,1,0
2014-09-03 00:00:00.000000,Guyana,Dominica,0,0,CFU Caribbean Cup qualification,Basseterre,St. Kitts and Nevis,1,153,136,168,93,-15,43,D,1,0,0
2014-09-03 00:00:00.000000,Latvia,Armenia,2,0,Friendly,Riga,Latvia,0,100,324,36,648,64,-324,W,0,1,0
2014-09-03 00:00:00.000000,Lithuania,United Arab Emirates,1,1,Friendly,Matrei in Osttirol,Austria,1,103,306,65,464,38,-158,D,1,0,0
2014-09-03 00:00:00.000000,Morocco,Qatar,0,0,Friendly,Rabat,Morocco,0,81,381,92,348,-11,33,D,1,1,0
2014-09-03 00:00:00.000000,Puerto Rico,Curaçao,2,2,CFU Caribbean Cup qualification,Bayamón,Puerto Rico,0,155,134,182,63,-27,71,D,1,1,0
2014-09-03 00:00:00.000000,Russia,Azerbaijan,4,0,Friendly,Khimki,Russia,0,23,899,73,413,-50,486,W,0,1,0
2014-09-03 00:00:00.000000,Ukraine,Moldova,1,0,Friendly,Kyïv,Ukraine,0,22,901,99,325,-77,576,W,0,1,0
2014-09-04 00:00:00.000000,Belarus,Tajikistan,6,1,Friendly,Barysaw,Belarus,0,88,363,120,252,-32,111,W,0,1,0
2014-09-04 00:00:00.000000,Belgium,Australia,2,0,Friendly,Liège,Belgium,0,5,1407,79,391,-74,1016,W,0,1,0
2014-09-04 00:00:00.000000,Croatia,Cyprus,2,0,Friendly,Pula,Croatia,0,16,964,140,184,-124,780,W,0,1,0
2014-09-04 00:00:00.000000,France,Spain,1,0,Friendly,Saint-Denis,France,0,10,1212,7,1241,3,-29,W,0,1,0
2014-09-04 00:00:00.000000,Iraq,Peru,0,2,Friendly,Dubai,United Arab Emirates,1,91,357,52,522,39,-165,L,2,0,0
2014-09-04 00:00:00.000000,Italy,Netherlands,2,0,Friendly,Bari,Italy,0,14,1069,3,1507,11,-438,W,0,1,0
2014-09-04 00:00:00.000000,Slovakia,Malta,1,0,Friendly,Žilina,Slovakia,0,45,584,150,143,-105,441,W,0,1,0
2014-09-04 00:00:00.000000,Sweden,Estonia,2,0,Friendly,Solna,Sweden,0,29,724,93,344,-64,380,W,0,1,0
2014-09-04 00:00:00.000000,Uzbekistan,Jordan,2,0,Friendly,Tashkent,Uzbekistan,0,51,528,56,500,-5,28,W,0,1,0
2014-09-05 00:00:00.000000,Curaçao,Grenada,2,1,CFU Caribbean Cup qualification,Bayamón,Puerto Rico,1,182,63,142,182,40,-119,W,0,0,0
2014-09-05 00:00:00.000000,Guinea,Togo,2,1,African Cup of Nations qualification,Casablanca,Morocco,1,64,471,87,365,-23,106,W,0,0,0
2014-09-05 00:00:00.000000,Japan,Uruguay,0,2,Friendly,Sapporo,Japan,0,44,593,6,1316,38,-723,L,2,1,0
2014-09-05 00:00:00.000000,Korea Republic,Venezuela,3,1,Friendly,Bucheon,Korea Republic,0,57,499,29,724,28,-225,W,0,1,0
2014-09-05 00:00:00.000000,Senegal,Egypt,2,0,African Cup of Nations qualification,Dakar,Senegal,0,59,491,38,645,21,-154,W,0,1,0
2014-09-05 00:00:00.000000,St. Kitts and Nevis,Dominica,5,0,CFU Caribbean Cup qualification,Basseterre,St. Kitts and Nevis,0,159,124,168,93,-9,31,W,0,1,0
2014-09-05 00:00:00.000000,St. Lucia,Guyana,2,0,CFU Caribbean Cup qualification,Basseterre,St. Kitts and Nevis,1,138,195,153,136,-15,59,W,0,0,0
2014-09-05 00:00:00.000000,St. Vincent and the Grenadines,Anguilla,4,0,CFU Caribbean Cup qualification,St. John's,Antigua and Barbuda,1,134,203,207,1,-73,202,W,0,0,0
2014-09-05 00:00:00.000000,Sudan,South Africa,0,3,African Cup of Nations qualification,Omdurman,Sudan,0,115,263,69,438,46,-175,L,2,1,0
2014-09-06 00:00:00.000000,Burkina Faso,Lesotho,2,0,African Cup of Nations qualification,Ouagadougou,Burkina Faso,0,58,493,105,302,-47,191,W,0,1,0
2014-09-06 00:00:00.000000,Congo DR,Cameroon,0,2,African Cup of Nations qualification,Lubumbashi,Congo DR,0,93,344,54,507,39,-163,L,2,1,0
2014-09-06 00:00:00.000000,Ethiopia,Algeria,1,2,African Cup of Nations qualification,Addis Abeba,Ethiopia,0,112,275,24,880,88,-605,L,2,1,0
2014-09-06 00:00:00.000000,Gabon,Angola,1,0,African Cup of Nations qualification,Libreville,Gabon,0,102,311,75,408,27,-97,W,0,1,0
2014-09-06 00:00:00.000000,Ghana,Uganda,1,1,African Cup of Nations qualification,Kumasi,Ghana,0,36,648,81,381,-45,267,D,1,1,0
2014-09-06 00:00:00.000000,Mexico,Chile,0,0,Friendly,Santa Clara,USA,1,17,942,12,1100,5,-158,D,1,0,0
2014-09-06 00:00:00.000000,Nigeria,Congo,2,3,African Cup of Nations qualification,Calabar,Nigeria,0,33,673,78,395,-45,278,L,2,1,0
2014-09-06 00:00:00.000000,Singapore,Papua New Guinea,2,1,Friendly,Hougang,Singapore,0,152,140,200,14,-48,126,W,0,1,0
2014-09-06 00:00:00.000000,Tunisia,Botswana,2,1,African Cup of Nations qualification,Monastir,Tunisia,0,42,617,86,371,-44,246,W,0,1,0
2014-09-06 00:00:00.000000,Vietnam,Hong Kong,3,1,Friendly,Hải Phòng,Vietnam,0,139,192,161,118,-22,74,W,0,1,0
2014-09-06 00:00:00.000000,Zambia,Mozambique,0,0,African Cup of Nations qualification,Ndola,Zambia,0,84,375,107,289,-23,86,D,1,1,0
2014-09-07 00:00:00.000000,Burundi,Tanzania,2,0,Friendly,Bujumbura,Burundi,0,129,217,110,285,19,-68,W,0,1,0
2014-09-07 00:00:00.000000,Costa Rica,Panama,2,2,UNCAF Cup,Dallas,USA,1,15,1023,63,474,-48,549,D,1,0,0
2014-09-07 00:00:00.000000,Denmark,Armenia,2,1,UEFA Euro qualification,Copenhagen,Denmark,0,26,818,36,648,-10,170,W,0,1,0
2014-09-07 00:00:00.000000,Dominica,St. Lucia,1,2,CFU Caribbean Cup qualification,Basseterre,St. Kitts and Nevis,1,168,93,138,195,30,-102,L,2,0,0
2014-09-07 00:00:00.000000,Faroe Islands,Finland,1,3,UEFA Euro qualification,Tórshavn,Faroe Islands,0,183,61,55,502,128,-441,L,2,1,0
2014-09-07 00:00:00.000000,Germany,Scotland,2,1,UEFA Euro qualification,Dortmund,Germany,0,1,1736,28,738,-27,998,W,0,1,0
2014-09-07 00:00:00.000000,Greece,Romania,0,1,UEFA Euro qualification,Piraeus,Greece,0,13,1092,27,740,-14,352,L,2,1,0
2014-09-07 00:00:00.000000,Hungary,Northern Ireland,1,2,UEFA Euro qualification,Budapest,Hungary,0,34,656,95,341,-61,315,L,2,1,0
2014-09-07 00:00:00.000000,Mali,Malawi,2,0,African Cup of Nations qualification,Bamako,Mali,0,60,488,106,295,-46,193,W,0,1,0
2014-09-07 00:00:00.000000,Morocco,Libya,3,0,Friendly,Marrakech,Morocco,0,81,381,62,475,19,-94,W,0,1,0
2014-09-07 00:00:00.000000,Paraguay,United Arab Emirates,0,0,Friendly,Villach,Austria,1,47,564,65,464,-18,100,D,1,0,0
2014-09-07 00:00:00.000000,Portugal,Albania,0,1,UEFA Euro qualification,Aveiro,Portugal,0,11,1152,70,437,-59,715,L,2,1,0
2014-09-07 00:00:00.000000,Puerto Rico,Grenada,2,2,CFU Caribbean Cup qualification,Bayamón,Puerto Rico,0,155,134,142,182,13,-48,D,1,1,0
2014-09-07 00:00:00.000000,Serbia,France,1,1,Friendly,Belgrade,Serbia,0,31,723,10,1212,21,-489,D,1,1,0
2014-09-08 00:00:00.000000,Australia,Saudi Arabia,3,2,Friendly,London,England,1,79,391,83,377,-4,14,W,0,0,0
2014-09-08 00:00:00.000000,Austria,Sweden,1,1,UEFA Euro qualification,Vienna,Austria,0,40,624,29,724,11,-100,D,1,1,0
2014-09-08 00:00:00.000000,Estonia,Slovenia,1,0,UEFA Euro qualification,Tallinn,Estonia,0,93,344,39,643,54,-299,W,0,1,0
2014-09-08 00:00:00.000000,Korea Republic,Uruguay,0,1,Friendly,Goyang,Korea Republic,0,57,499,6,1316,51,-817,L,2,1,0
2014-09-08 00:00:00.000000,Luxembourg,Belarus,1,1,UEFA Euro qualification,Luxembourg,Luxembourg,0,109,288,88,363,21,-75,D,1,1,0
2014-09-08 00:00:00.000000,Montenegro,Moldova,2,0,UEFA Euro qualification,Podgorica,Montenegro,0,49,553,99,325,-50,228,W,0,1,0
2014-09-08 00:00:00.000000,Russia,Liechtenstein,4,0,UEFA Euro qualification,Khimki,Russia,0,23,899,167,94,-144,805,W,0,1,0
2014-09-08 00:00:00.000000,San Marino,Lithuania,0,2,UEFA Euro qualification,Serravalle,San Marino,0,208,0,103,306,105,-306,L,2,1,0
2014-09-08 00:00:00.000000,Switzerland,England,0,2,UEFA Euro qualification,Basel,Switzerland,0,9,1218,20,915,-11,303,L,2,1,0
2014-09-08 00:00:00.000000,Ukraine,Slovakia,0,1,UEFA Euro qualification,Kyïv,Ukraine,0,22,901,45,584,-23,317,L,2,1,0
2014-09-08 00:00:00.000000,Uzbekistan,New Zealand,3,1,Friendly,Tashkent,Uzbekistan,0,51,528,98,330,-47,198,W,0,1,0
2014-09-09 00:00:00.000000,Andorra,Wales,1,2,UEFA Euro qualification,Sant Julià de Lòria,Andorra,0,199,16,41,623,158,-607,L,2,1,0
2014-09-09 00:00:00.000000,Azerbaijan,Bulgaria,1,2,UEFA Euro qualification,Baku,Azerbaijan,0,73,413,72,429,1,-16,L,2,1,0
2014-09-09 00:00:00.000000,Croatia,Malta,2,0,UEFA Euro qualification,Zagreb,Croatia,0,16,964,150,143,-134,821,W,0,1,0
2014-09-09 00:00:00.000000,Czech Republic,Netherlands,2,1,UEFA Euro qualification,Prague,Czech Republic,0,35,650,3,1507,32,-857,W,0,1,0
2014-09-09 00:00:00.000000,Haiti,Chile,0,1,Friendly,Fort Lauderdale,USA,1,117,262,12,1100,105,-838,L,2,0,0
2014-09-09 00:00:00.000000,Iceland,Turkey,3,0,UEFA Euro qualification,Reykjavík,Iceland,0,46,573,32,711,14,-138,W,0,1,0
2014-09-09 00:00:00.000000,Indonesia,Yemen,0,0,Friendly,Yogyakarta,Indonesia,0,153,136,184,59,-31,77,D,1,1,0
2014-09-09 00:00:00.000000,Japan,Venezuela,2,2,Friendly,Yokohama,Japan,0,44,593,29,724,15,-131,D,1,1,0
2014-09-09 00:00:00.000000,Kazakhstan,Latvia,0,0,UEFA Euro qualification,Astana,Kazakhstan,0,131,213,100,324,31,-111,D,1,1,0
2014-09-09 00:00:00.000000,Kuwait,Bahrain,0,1,Friendly,al-Farwaniyah,Kuwait,0,111,280,107,289,4,-9,L,2,1,0
2014-09-09 00:00:00.000000,Mexico,Bolivia,1,0,Friendly,Commerce City,USA,1,17,942,71,434,-54,508,W,0,0,0
2014-09-09 00:00:00.000000,Norway,Italy,0,2,UEFA Euro qualification,Oslo,Norway,0,53,512,14,1069,39,-557,L,2,1,0
2014-09-09 00:00:00.000000,Qatar,Peru,0,2,Friendly,Doha,Qatar,0,92,348,52,522,40,-174,L,2,1,0
2014-09-09 00:00:00.000000,Singapore,Hong Kong,0,0,Friendly,Hougang,Singapore,0,152,140,161,118,-9,22,D,1,1,0
2014-09-10 00:00:00.000000,Algeria,Mali,1,0,African Cup of Nations qualification,Blida,Algeria,0,24,880,60,488,-36,392,W,0,1,0
2014-09-10 00:00:00.000000,Angola,Burkina Faso,0,3,African Cup of Nations qualification,Luanda,Angola,0,75,408,58,493,17,-85,L,2,1,0
2014-09-10 00:00:00.000000,Botswana,Senegal,0,2,African Cup of Nations qualification,Gaborone,Botswana,0,86,371,59,491,27,-120,L,2,1,0
2014-09-10 00:00:00.000000,Congo,Sudan,2,0,African Cup of Nations qualification,Pointe-Noire,Congo,0,78,395,115,263,-37,132,W,0,1,0
2014-09-10 00:00:00.000000,Congo DR,Sierra Leone,2,0,African Cup of Nations qualification,Lubumbashi,Congo DR,0,93,344,50,533,43,-189,W,0,1,0
2014-09-10 00:00:00.000000,Egypt,Tunisia,0,1,African Cup of Nations qualification,Cairo,Egypt,0,38,645,42,617,-4,28,L,2,1,0
2014-09-10 00:00:00.000000,Lesotho,Gabon,1,1,African Cup of Nations qualification,Maseru,Lesotho,0,105,302,102,311,3,-9,D,1,1,0
2014-09-10 00:00:00.000000,Malawi,Ethiopia,3,2,African Cup of Nations qualification,Blantyre,Malawi,0,106,295,112,275,-6,20,W,0,1,0
2014-09-10 00:00:00.000000,Mozambique,Niger,1,1,African Cup of Nations qualification,Maputo,Mozambique,0,107,289,118,261,-11,28,D,1,1,0
2014-09-10 00:00:00.000000,South Africa,Nigeria,0,0,African Cup of Nations qualification,Cape Town,South Africa,0,69,438,33,673,36,-235,D,1,1,0
2014-09-10 00:00:00.000000,Togo,Ghana,2,3,African Cup of Nations qualification,Lomé,Togo,0,87,365,36,648,51,-283,L,2,1,0
2014-09-10 00:00:00.000000,Uganda,Guinea,2,0,African Cup of Nations qualification,Kampala,Uganda,0,81,381,64,471,17,-90,W,0,1,0
2014-09-14 00:00:00.000000,Indonesia,Malaysia,2,0,Friendly,Sidoarjo,Indonesia,0,153,136,155,134,-2,2,W,0,1,0
2014-09-20 00:00:00.000000,Malaysia,Cambodia,4,1,Friendly,Shah Alam,Malaysia,0,154,134,199,13,-45,121,W,0,1,0
2014-09-25 00:00:00.000000,Indonesia,Cambodia,1,0,Friendly,Malang,Indonesia,0,156,130,199,13,-43,117,W,0,1,0
2014-09-30 00:00:00.000000,Botswana,Zimbabwe,1,0,Friendly,Gaborone,Botswana,0,91,356,92,353,-1,3,W,0,1,0
2014-10-06 00:00:00.000000,India,Palestine,2,3,Friendly,Siliguri,India,0,158,116,102,311,56,-195,L,2,1,0
2014-10-06 00:00:00.000000,Qatar,Uzbekistan,3,0,Friendly,Doha,Qatar,0,96,342,58,530,38,-188,W,0,1,0
2014-10-08 00:00:00.000000,Antigua and Barbuda,St. Lucia,2,1,CFU Caribbean Cup qualification,Couva,Trinidad and Tobago,1,80,411,123,256,-43,155,W,0,0,0
2014-10-08 00:00:00.000000,St. Kitts and Nevis,Barbados,2,3,CFU Caribbean Cup qualification,Port-au-Prince,Haiti,1,117,276,161,112,-44,164,L,2,0,0
2014-10-08 00:00:00.000000,Trinidad and Tobago,Dominican Republic,6,1,CFU Caribbean Cup qualification,Couva,Trinidad and Tobago,0,86,374,107,295,-21,79,W,0,1,0
2014-10-09 00:00:00.000000,Belarus,Ukraine,0,2,UEFA Euro qualification,Barysaw,Belarus,0,89,364,24,855,65,-491,L,2,1,0
2014-10-09 00:00:00.000000,England,San Marino,5,0,UEFA Euro qualification,London,England,0,18,935,208,0,-190,935,W,0,1,0
2014-10-09 00:00:00.000000,Liechtenstein,Montenegro,0,0,UEFA Euro qualification,Vaduz,Liechtenstein,0,172,81,43,591,129,-510,D,1,1,0
2014-10-09 00:00:00.000000,Lithuania,Estonia,1,0,UEFA Euro qualification,Vilnius,Lithuania,0,103,309,81,403,22,-94,W,0,1,0
2014-10-09 00:00:00.000000,Moldova,Austria,1,2,UEFA Euro qualification,Chișinău,Moldova,0,105,302,39,622,66,-320,L,2,1,0
2014-10-09 00:00:00.000000,Morocco,Central African Republic,4,0,Friendly,Marrakech,Morocco,0,87,371,137,209,-50,162,W,0,1,0
2014-10-09 00:00:00.000000,Qatar,Lebanon,5,0,Friendly,Doha,Qatar,0,96,342,121,264,-25,78,W,0,1,0
2014-10-09 00:00:00.000000,Slovakia,Spain,2,1,UEFA Euro qualification,Žilina,Slovakia,0,40,616,8,1228,32,-612,W,0,1,0
2014-10-09 00:00:00.000000,Slovenia,Switzerland,1,0,UEFA Euro qualification,Maribor,Slovenia,0,53,555,10,1175,43,-620,W,0,1,0
2014-10-09 00:00:00.000000,Sweden,Russia,1,1,UEFA Euro qualification,Solna,Sweden,0,32,662,23,875,9,-213,D,1,1,0
2014-10-10 00:00:00.000000,Belgium,Andorra,6,0,UEFA Euro qualification,Brussels,Belgium,0,5,1444,203,9,-198,1435,W,0,1,0
2014-10-10 00:00:00.000000,Botswana,Egypt,0,2,African Cup of Nations qualification,Gaborone,Botswana,0,91,356,61,513,30,-157,L,2,1,0
2014-10-10 00:00:00.000000,Bulgaria,Croatia,0,1,UEFA Euro qualification,Sofia,Bulgaria,0,46,570,19,928,27,-358,L,2,1,0
2014-10-10 00:00:00.000000,Cyprus,Israel,1,2,UEFA Euro qualification,Nicosia,Cyprus,0,85,388,64,498,21,-110,L,2,1,0
2014-10-10 00:00:00.000000,Hong Kong,Singapore,2,1,Friendly,Kowloon,Hong Kong,0,164,102,149,163,15,-61,W,0,1,0
2014-10-10 00:00:00.000000,Italy,Azerbaijan,2,1,UEFA Euro qualification,Palermo,Italy,0,13,1068,95,344,-82,724,W,0,1,0
2014-10-10 00:00:00.000000,Japan,Jamaica,1,0,Friendly,Niigata,Japan,0,48,557,100,321,-52,236,W,0,1,0
2014-10-10 00:00:00.000000,Jordan,Kuwait,0,1,Friendly,Amman,Jordan,0,69,450,124,250,-55,200,L,2,1,0
2014-10-10 00:00:00.000000,Korea Republic,Paraguay,2,0,Friendly,Cheonan,Korea Republic,0,63,501,60,514,3,-13,W,0,1,0
2014-10-10 00:00:00.000000,Latvia,Iceland,0,3,UEFA Euro qualification,Riga,Latvia,0,99,333,34,646,65,-313,L,2,1,0
2014-10-10 00:00:00.000000,Lesotho,Angola,0,0,African Cup of Nations qualification,Maseru,Lesotho,0,115,277,101,312,14,-35,D,1,1,0
2014-10-10 00:00:00.000000,Malta,Norway,0,3,UEFA Euro qualification,Attard,Malta,0,155,133,76,421,79,-288,L,2,1,0
2014-10-10 00:00:00.000000,Netherlands,Kazakhstan,3,1,UEFA Euro qualification,Amsterdam,Netherlands,0,4,1456,127,239,-123,1217,W,0,1,0
2014-10-10 00:00:00.000000,Oman,Costa Rica,3,4,Friendly,Muscat,Oman,0,76,421,15,988,61,-567,L,2,1,0
2014-10-10 00:00:00.000000,Saudi Arabia,Uruguay,1,1,Friendly,Jeddah,Saudi Arabia,0,82,402,7,1243,75,-841,D,1,1,0
2014-10-10 00:00:00.000000,Senegal,Tunisia,0,0,African Cup of Nations qualification,Dakar,Senegal,0,36,645,31,701,5,-56,D,1,1,0
2014-10-10 00:00:00.000000,St. Vincent and the Grenadines,Curaçao,1,0,CFU Caribbean Cup qualification,Les Abymes,Guadeloupe,1,106,301,148,164,-42,137,W,0,0,0
2014-10-10 00:00:00.000000,Trinidad and Tobago,St. Lucia,2,0,CFU Caribbean Cup qualification,Couva,Trinidad and Tobago,0,86,374,123,256,-37,118,W,0,1,0
2014-10-10 00:00:00.000000,Turkey,Czech Republic,1,2,UEFA Euro qualification,Istanbul,Turkey,0,38,637,28,812,10,-175,L,2,1,0
2014-10-10 00:00:00.000000,United Arab Emirates,Australia,0,0,Friendly,Abu Dhabi,United Arab Emirates,0,73,430,84,390,-11,40,D,1,1,0
2014-10-10 00:00:00.000000,Uzbekistan,Bahrain,0,0,Friendly,Dubai,United Arab Emirates,1,58,530,104,305,-46,225,D,1,0,0
2014-10-10 00:00:00.000000,Yemen,Iraq,1,1,Friendly,Manama,Bahrain,1,184,58,90,357,94,-299,D,1,0,0
2014-10-11 00:00:00.000000,Albania,Denmark,1,1,UEFA Euro qualification,Elbasan,Albania,0,45,571,27,833,18,-262,D,1,1,0
2014-10-11 00:00:00.000000,Argentina,Brazil,0,2,Friendly,Beijing,China,1,2,1631,6,1291,-4,340,L,2,0,0
2014-10-11 00:00:00.000000,Armenia,Serbia,1,1,UEFA Euro qualification,Yerevan,Armenia,0,52,556,34,646,18,-90,D,1,1,0
2014-10-11 00:00:00.000000,Cameroon,Sierra Leone,0,0,African Cup of Nations qualification,Yaoundé,Cameroon,0,42,601,75,424,-33,177,D,1,1,0
2014-10-11 00:00:00.000000,Congo,South Africa,0,2,African Cup of Nations qualification,Pointe-Noire,Congo,0,48,557,67,458,-19,99,L,2,1,0
2014-10-11 00:00:00.000000,Ethiopia,Mali,0,2,African Cup of Nations qualification,Addis Ababa,Ethiopia,0,132,222,59,526,73,-304,L,2,1,0
2014-10-11 00:00:00.000000,Finland,Greece,1,1,UEFA Euro qualification,Helsinki,Finland,0,65,491,14,1052,51,-561,D,1,1,0
2014-10-11 00:00:00.000000,France,Portugal,2,1,Friendly,Saint-Denis,France,0,9,1202,11,1150,-2,52,W,0,1,0
2014-10-11 00:00:00.000000,Gabon,Burkina Faso,2,0,African Cup of Nations qualification,Libreville,Gabon,0,83,392,48,557,35,-165,W,0,1,0
2014-10-11 00:00:00.000000,Guinea,Ghana,1,1,African Cup of Nations qualification,Casablanca,Morocco,1,48,557,33,661,15,-104,D,1,0,0
2014-10-11 00:00:00.000000,Malawi,Algeria,0,2,African Cup of Nations qualification,Blantyre,Malawi,0,98,340,20,926,78,-586,L,2,1,0
2014-10-11 00:00:00.000000,Niger,Zambia,0,0,African Cup of Nations qualification,Niamey,Niger,0,107,295,88,365,19,-70,D,1,1,0
2014-10-11 00:00:00.000000,Northern Ireland,Faroe Islands,2,0,UEFA Euro qualification,Belfast,Northern Ireland,0,71,435,179,67,-108,368,W,0,1,0
2014-10-11 00:00:00.000000,Poland,Germany,2,0,UEFA Euro qualification,Warsaw,Poland,0,70,436,1,1765,69,-1329,W,0,1,0
2014-10-11 00:00:00.000000,Romania,Hungary,1,1,UEFA Euro qualification,Bucharest,Romania,0,26,837,54,548,-28,289,D,1,1,0
2014-10-11 00:00:00.000000,Scotland,Georgia,1,0,UEFA Euro qualification,Glasgow,Scotland,0,29,714,110,290,-81,424,W,0,1,0
2014-10-11 00:00:00.000000,Sudan,Nigeria,1,0,African Cup of Nations qualification,Khartoum,Sudan,0,133,221,37,642,96,-421,W,0,1,0
2014-10-11 00:00:00.000000,Uganda,Togo,0,1,African Cup of Nations qualification,Kampala,Uganda,0,79,418,125,245,-46,173,L,2,1,0
2014-10-12 00:00:00.000000,Austria,Montenegro,1,0,UEFA Euro qualification,Vienna,Austria,0,39,622,43,591,-4,31,W,0,1,0
2014-10-12 00:00:00.000000,Belarus,Slovakia,1,3,UEFA Euro qualification,Barysaw,Belarus,0,89,364,40,616,49,-252,L,2,1,0
2014-10-12 00:00:00.000000,Estonia,England,0,1,UEFA Euro qualification,Tallinn,Estonia,0,81,403,18,935,63,-532,L,2,1,0
2014-10-12 00:00:00.000000,Haiti,St. Kitts and Nevis,0,0,CFU Caribbean Cup qualification,Port-au-Prince,Haiti,0,119,266,117,276,2,-10,D,1,1,0
2014-10-12 00:00:00.000000,Laos,Cambodia,3,2,AFF Championship,Vientiane,Laos,0,169,84,199,13,-30,71,W,0,1,0
2014-10-12 00:00:00.000000,Lithuania,Slovenia,0,2,UEFA Euro qualification,Vilnius,Lithuania,0,103,309,53,555,50,-246,L,2,1,0
2014-10-12 00:00:00.000000,Luxembourg,Spain,0,4,UEFA Euro qualification,Luxembourg,Luxembourg,0,127,239,8,1228,119,-989,L,2,1,0
2014-10-12 00:00:00.000000,Mexico,Panama,1,0,Friendly,Querétaro,Mexico,0,16,963,55,540,-39,423,W,0,1,0
2014-10-12 00:00:00.000000,Pakistan,Palestine,0,2,Friendly,Lahore,Pakistan,0,175,77,102,311,73,-234,L,2,1,0
2014-10-12 00:00:00.000000,Philippines,Papua New Guinea,5,0,Friendly,Manila,Philippines,0,134,218,199,13,-65,205,W,0,1,0
2014-10-12 00:00:00.000000,Russia,Moldova,1,1,UEFA Euro qualification,Moscow,Russia,0,23,875,105,302,-82,573,D,1,1,0
2014-10-12 00:00:00.000000,St. Lucia,Dominican Republic,2,3,CFU Caribbean Cup qualification,Couva,Trinidad and Tobago,1,123,256,107,295,16,-39,L,2,0,0
2014-10-12 00:00:00.000000,Sweden,Liechtenstein,2,0,UEFA Euro qualification,Solna,Sweden,0,32,662,172,81,-140,581,W,0,1,0
2014-10-12 00:00:00.000000,Tanzania,Benin,4,1,Friendly,Dar es Salaam,Tanzania,0,115,277,78,420,37,-143,W,0,1,0
2014-10-12 00:00:00.000000,Trinidad and Tobago,Antigua and Barbuda,1,0,CFU Caribbean Cup qualification,Couva,Trinidad and Tobago,0,86,374,80,411,6,-37,W,0,1,0
2014-10-13 00:00:00.000000,Andorra,Israel,1,4,UEFA Euro qualification,Sant Julià de Lòria,Andorra,0,203,9,64,498,139,-489,L,2,1,0
2014-10-13 00:00:00.000000,Croatia,Azerbaijan,6,0,UEFA Euro qualification,Osijek,Croatia,0,19,928,95,344,-76,584,W,0,1,0
2014-10-13 00:00:00.000000,Iceland,Netherlands,2,0,UEFA Euro qualification,Reykjavík,Iceland,0,34,646,4,1456,30,-810,W,0,1,0
2014-10-13 00:00:00.000000,Jordan,Kuwait,1,1,Friendly,Amman,Jordan,0,69,450,124,250,-55,200,D,1,1,0
2014-10-13 00:00:00.000000,Kazakhstan,Czech Republic,2,4,UEFA Euro qualification,Astana,Kazakhstan,0,127,239,28,812,99,-573,L,2,1,0
2014-10-13 00:00:00.000000,Latvia,Turkey,1,1,UEFA Euro qualification,Riga,Latvia,0,99,333,38,637,61,-304,D,1,1,0
2014-10-13 00:00:00.000000,Malta,Italy,0,1,UEFA Euro qualification,Attard,Malta,0,155,133,13,1068,142,-935,L,2,1,0
2014-10-13 00:00:00.000000,Morocco,Kenya,3,0,Friendly,Marrakech,Morocco,0,87,371,111,288,-24,83,W,0,1,0
2014-10-13 00:00:00.000000,Norway,Bulgaria,2,1,UEFA Euro qualification,Oslo,Norway,0,76,421,46,570,30,-149,W,0,1,0
2014-10-13 00:00:00.000000,Oman,Uruguay,0,3,Friendly,Muscat,Oman,0,76,421,7,1243,69,-822,L,2,1,0
2014-10-13 00:00:00.000000,Wales,Cyprus,2,1,UEFA Euro qualification,Cardiff,Wales,0,29,714,85,388,-56,326,W,0,1,0
2014-10-14 00:00:00.000000,Armenia,France,0,3,Friendly,Yerevan,Armenia,0,52,556,9,1202,43,-646,L,2,1,0
2014-10-14 00:00:00.000000,Bahrain,Iraq,0,0,Friendly,Riffa,Bahrain,0,104,305,90,357,14,-52,D,1,1,0
2014-10-14 00:00:00.000000,Denmark,Portugal,0,1,UEFA Euro qualification,Copenhagen,Denmark,0,27,833,11,1150,16,-317,L,2,1,0
2014-10-14 00:00:00.000000,Faroe Islands,Hungary,0,1,UEFA Euro qualification,Tórshavn,Faroe Islands,0,179,67,54,548,125,-481,L,2,1,0
2014-10-14 00:00:00.000000,Finland,Romania,0,2,UEFA Euro qualification,Helsinki,Finland,0,65,491,26,837,39,-346,L,2,1,0
2014-10-14 00:00:00.000000,Greece,Northern Ireland,0,2,UEFA Euro qualification,Piraeus,Greece,0,14,1052,71,435,-57,617,L,2,1,0
2014-10-14 00:00:00.000000,Hong Kong,Argentina,0,7,Friendly,So Kon Po,Hong Kong,0,164,102,2,1631,162,-1529,L,2,1,0
2014-10-14 00:00:00.000000,Japan,Brazil,0,4,Friendly,Kallang,Singapore,1,48,557,6,1291,42,-734,L,2,0,0
2014-10-14 00:00:00.000000,Korea Republic,Costa Rica,1,3,Friendly,Seoul,Korea Republic,0,63,501,15,988,48,-487,L,2,1,0
2014-10-14 00:00:00.000000,Macau,Singapore,2,2,Friendly,Taipa,Macau,0,186,41,149,163,37,-122,D,1,1,0
2014-10-14 00:00:00.000000,Poland,Scotland,2,2,UEFA Euro qualification,Warsaw,Poland,0,70,436,29,714,41,-278,D,1,1,0
2014-10-14 00:00:00.000000,Qatar,Australia,1,0,Friendly,Doha,Qatar,0,96,342,84,390,12,-48,W,0,1,0
2014-10-14 00:00:00.000000,San Marino,Switzerland,0,4,UEFA Euro qualification,Serravalle,San Marino,0,208,0,10,1175,198,-1175,L,2,1,0
2014-10-14 00:00:00.000000,Saudi Arabia,Lebanon,1,1,Friendly,Jeddah,Saudi Arabia,0,82,402,121,264,-39,138,D,1,1,0
2014-10-14 00:00:00.000000,Serbia,Albania,0,3,UEFA Euro qualification,Belgrade,Serbia,0,34,646,45,571,-11,75,L,2,1,0
2014-10-14 00:00:00.000000,United Arab Emirates,Uzbekistan,0,4,Friendly,Dubai,United Arab Emirates,0,73,430,58,530,15,-100,L,2,1,0
2014-10-14 00:00:00.000000,USA,Honduras,1,1,Friendly,Boca Raton,USA,0,17,936,56,535,-39,401,D,1,1,0
2014-10-15 00:00:00.000000,Algeria,Malawi,3,0,African Cup of Nations qualification,Blida,Algeria,0,20,926,98,340,-78,586,W,0,1,0
2014-10-15 00:00:00.000000,Angola,Lesotho,4,0,African Cup of Nations qualification,Luanda,Angola,0,101,312,115,277,-14,35,W,0,1,0
2014-10-15 00:00:00.000000,Burkina Faso,Gabon,1,1,African Cup of Nations qualification,Ouagadougou,Burkina Faso,0,48,557,83,392,-35,165,D,1,1,0
2014-10-15 00:00:00.000000,Cameroon,Sierra Leone,2,0,African Cup of Nations qualification,Yaoundé,Cameroon,0,42,601,75,424,-33,177,W,0,1,0
2014-10-15 00:00:00.000000,Egypt,Botswana,2,0,African Cup of Nations qualification,Cairo,Egypt,0,61,513,91,356,-30,157,W,0,1,0
2014-10-15 00:00:00.000000,Ghana,Guinea,3,1,African Cup of Nations qualification,Accra,Ghana,0,33,661,48,557,-15,104,W,0,1,0
2014-10-15 00:00:00.000000,Mali,Ethiopia,2,3,African Cup of Nations qualification,Bamako,Mali,0,59,526,132,222,-73,304,L,2,1,0
2014-10-15 00:00:00.000000,Nigeria,Sudan,3,1,African Cup of Nations qualification,Abuja,Nigeria,0,37,642,133,221,-96,421,W,0,1,0
2014-10-15 00:00:00.000000,South Africa,Congo,0,0,African Cup of Nations qualification,Polokwane,South Africa,0,67,458,48,557,19,-99,D,1,1,0
2014-10-15 00:00:00.000000,Swaziland,Zimbabwe,0,2,Friendly,Lobamba,Swaziland,0,160,114,92,353,68,-239,L,2,1,0
2014-10-15 00:00:00.000000,Togo,Uganda,1,0,African Cup of Nations qualification,Lomé,Togo,0,125,245,79,418,46,-173,W,0,1,0
2014-10-15 00:00:00.000000,Tunisia,Senegal,1,0,African Cup of Nations qualification,Monastir,Tunisia,0,31,701,36,645,-5,56,W,0,1,0
2014-10-15 00:00:00.000000,Zambia,Niger,3,0,African Cup of Nations qualification,Ndola,Zambia,0,88,365,107,295,-19,70,W,0,1,0
2014-10-24 00:00:00.000000,Bangladesh,Sri Lanka,1,1,Friendly,Jessore,Bangladesh,0,176,68,174,76,2,-8,D,1,1,0
2014-10-27 00:00:00.000000,Bangladesh,Sri Lanka,1,0,Friendly,Rajshahi,Bangladesh,0,176,68,174,76,2,-8,W,0,1,0
2014-10-31 00:00:00.000000,Korea DPR,Kuwait,0,1,Friendly,Dubai,United Arab Emirates,1,148,168,120,261,28,-93,L,2,0,0
2014-10-31 00:00:00.000000,Philippines,Nepal,3,0,Friendly,Doha,Qatar,1,129,229,179,61,-50,168,W,0,0,0
2014-11-02 00:00:00.000000,Bahrain,Korea DPR,2,2,Friendly,Riffa,Bahrain,0,104,308,148,168,-44,140,D,1,1,0
2014-11-04 00:00:00.000000,Kuwait,Yemen,1,1,Friendly,Abu Dhabi,United Arab Emirates,1,120,261,178,62,-58,199,D,1,0,0
2014-11-06 00:00:00.000000,Qatar,Korea DPR,3,1,Friendly,Doha,Qatar,0,88,369,148,168,-60,201,W,0,1,0
2014-11-06 00:00:00.000000,Saudi Arabia,Palestine,2,0,Friendly,Dammam,Saudi Arabia,0,97,341,108,297,-11,44,W,0,1,0
2014-11-06 00:00:00.000000,United Arab Emirates,Lebanon,3,2,Friendly,al-Hasa,Saudi Arabia,1,79,413,124,246,-45,167,W,0,0,0
2014-11-07 00:00:00.000000,Bahrain,Singapore,2,0,Friendly,Riffa,Bahrain,0,104,308,161,115,-57,193,W,0,1,0
2014-11-07 00:00:00.000000,Oman,Yemen,2,0,Friendly,Muscat,Oman,0,83,391,178,62,-95,329,W,0,1,0
2014-11-09 00:00:00.000000,Thailand,Philippines,3,0,Friendly,Nakhon Ratchasima,Thailand,0,165,102,129,229,36,-127,W,0,1,0
2014-11-09 00:00:00.000000,Uganda,Ethiopia,3,0,Friendly,Kampala,Uganda,0,84,389,111,289,-27,100,W,0,1,0
2014-11-09 00:00:00.000000,Vietnam,Palestine,1,3,Friendly,Hanoi,Vietnam,0,136,208,108,297,28,-89,L,2,1,0
2014-11-11 00:00:00.000000,Curaçao,Trinidad and Tobago,2,3,CFU Caribbean Cup,Montego Bay,Jamaica,1,147,171,49,598,98,-427,L,2,0,0
2014-11-12 00:00:00.000000,Argentina,Croatia,2,1,Friendly,London,England,1,2,1565,14,1002,-12,563,W,0,0,0
2014-11-12 00:00:00.000000,Belgium,Iceland,3,1,Friendly,Brussels,Belgium,0,4,1388,28,816,-24,572,W,0,1,0
2014-11-12 00:00:00.000000,Haiti,Antigua and Barbuda,2,2,CFU Caribbean Cup,Montego Bay,Jamaica,1,93,360,70,478,23,-118,D,1,0,0
2014-11-12 00:00:00.000000,Netherlands,Mexico,2,3,Friendly,Amsterdam,Netherlands,0,5,1375,17,954,-12,421,L,2,1,0
2014-11-12 00:00:00.000000,Norway,Estonia,0,1,Friendly,Oslo,Norway,0,68,481,88,369,-20,112,L,2,1,0
2014-11-12 00:00:00.000000,Turkey,Brazil,0,4,Friendly,Istanbul,Turkey,0,46,614,6,1307,40,-693,L,2,1,0
2014-11-13 00:00:00.000000,Curaçao,Cuba,2,3,CFU Caribbean Cup,Montego Bay,Jamaica,1,147,171,112,286,35,-115,L,2,0,0
2014-11-13 00:00:00.000000,Korea DPR,Hong Kong,2,1,EAFF Championship,Taipei,Taiwan,1,148,168,163,109,-15,59,W,0,0,0
2014-11-13 00:00:00.000000,Morocco,Benin,6,1,Friendly,Agadir,Morocco,0,88,369,86,375,2,-6,W,0,1,0
2014-11-13 00:00:00.000000,Saudi Arabia,Qatar,1,1,Gulf Cup,Riyadh,Saudi Arabia,0,97,341,88,369,9,-28,D,1,1,0
2014-11-13 00:00:00.000000,Singapore,Laos,2,0,Friendly,Yishun,Singapore,0,161,115,154,141,7,-26,W,0,1,0
2014-11-13 00:00:00.000000,Uruguay,Costa Rica,3,3,Friendly,Montevideo,Uruguay,0,8,1184,16,974,-8,210,D,1,1,0
2014-11-13 00:00:00.000000,Yemen,Bahrain,0,0,Gulf Cup,Riyadh,Saudi Arabia,1,178,62,104,308,74,-246,D,1,0,0
2014-11-14 00:00:00.000000,Botswana,Tunisia,0,0,African Cup of Nations qualification,Gaborone,Botswana,0,102,323,31,780,71,-457,D,1,1,0
2014-11-14 00:00:00.000000,France,Albania,1,1,Friendly,Rennes,France,0,7,1191,48,604,-41,587,D,1,1,0
2014-11-14 00:00:00.000000,Georgia,Poland,0,4,UEFA Euro qualification,Tbilisi,Georgia,0,117,271,44,621,73,-350,L,2,1,0
2014-11-14 00:00:00.000000,Greece,Faroe Islands,0,1,UEFA Euro qualification,Piraeus,Greece,0,18,946,187,42,-169,904,L,2,1,0
2014-11-14 00:00:00.000000,Hungary,Finland,1,0,UEFA Euro qualification,Budapest,Hungary,0,50,561,63,510,-13,51,W,0,1,0
2014-11-14 00:00:00.000000,Iraq,Kuwait,0,1,Gulf Cup,Riyadh,Saudi Arabia,1,81,393,120,261,-39,132,L,2,0,0
2014-11-14 00:00:00.000000,Japan,Honduras,6,0,Friendly,Toyota,Japan,0,52,559,69,480,-17,79,W,0,1,0
2014-11-14 00:00:00.000000,Jordan,Korea Republic,0,1,Friendly,Amman,Jordan,0,74,434,66,496,8,-62,L,2,1,0
2014-11-14 00:00:00.000000,Paraguay,Peru,2,1,Friendly,Luque,Paraguay,0,76,423,54,558,22,-135,W,0,1,0
2014-11-14 00:00:00.000000,Philippines,Cambodia,3,0,Friendly,Manila,Philippines,0,129,229,185,46,-56,183,W,0,1,0
2014-11-14 00:00:00.000000,Portugal,Armenia,1,0,UEFA Euro qualification,Faro,Portugal,0,9,1175,75,432,-66,743,W,0,1,0
2014-11-14 00:00:00.000000,Romania,Northern Ireland,2,0,UEFA Euro qualification,Bucharest,Romania,0,21,876,43,625,-22,251,W,0,1,0
2014-11-14 00:00:00.000000,Serbia,Denmark,1,3,UEFA Euro qualification,Belgrade,Serbia,0,46,614,32,763,14,-149,L,2,1,0
2014-11-14 00:00:00.000000,United Arab Emirates,Oman,0,0,Gulf Cup,Riyadh,Saudi Arabia,1,79,413,83,391,-4,22,D,1,0,0
2014-11-14 00:00:00.000000,USA,Colombia,1,2,Friendly,London,England,1,23,862,3,1420,20,-558,L,2,0,0
2014-11-15 00:00:00.000000,Algeria,Ethiopia,3,1,African Cup of Nations qualification,Blida,Algeria,0,15,989,111,289,-96,700,W,0,1,0
2014-11-15 00:00:00.000000,Angola,Gabon,0,0,African Cup of Nations qualification,Luanda,Angola,0,87,373,67,487,20,-114,D,1,1,0
2014-11-15 00:00:00.000000,Austria,Russia,1,0,UEFA Euro qualification,Vienna,Austria,0,29,810,30,792,-1,18,W,0,1,0
2014-11-15 00:00:00.000000,Cameroon,Congo DR,1,0,African Cup of Nations qualification,Yaoundé,Cameroon,0,40,637,60,521,-20,116,W,0,1,0
2014-11-15 00:00:00.000000,Congo,Nigeria,0,2,African Cup of Nations qualification,Pointe-Noire,Congo,0,62,512,42,632,20,-120,L,2,1,0
2014-11-15 00:00:00.000000,Egypt,Senegal,0,1,African Cup of Nations qualification,Cairo,Egypt,0,38,658,41,635,-3,23,L,2,1,0
2014-11-15 00:00:00.000000,England,Slovenia,3,1,UEFA Euro qualification,London,England,0,20,919,36,683,-16,236,W,0,1,0
2014-11-15 00:00:00.000000,Indonesia,Syria,0,2,Friendly,Jakarta,Indonesia,0,157,129,151,154,6,-25,L,2,1,0
2014-11-15 00:00:00.000000,Lesotho,Burkina Faso,0,1,African Cup of Nations qualification,Maseru,Lesotho,0,118,266,71,469,47,-203,L,2,1,0
2014-11-15 00:00:00.000000,Luxembourg,Ukraine,0,3,UEFA Euro qualification,Luxembourg,Iceland,1,126,233,19,920,107,-687,L,2,0,0
2014-11-15 00:00:00.000000,Malawi,Mali,2,0,African Cup of Nations qualification,Blantyre,Malawi,0,109,292,58,533,51,-241,W,0,1,0
2014-11-15 00:00:00.000000,Moldova,Liechtenstein,0,1,UEFA Euro qualification,Chișinău,Moldova,0,119,262,155,136,-36,126,L,2,1,0
2014-11-15 00:00:00.000000,Montenegro,Sweden,1,1,UEFA Euro qualification,Podgorica,Montenegro,0,64,504,39,646,25,-142,D,1,1,0
2014-11-15 00:00:00.000000,Mozambique,Zambia,0,1,African Cup of Nations qualification,Maputo,Mozambique,0,97,341,78,418,19,-77,L,2,1,0
2014-11-15 00:00:00.000000,San Marino,Estonia,0,0,UEFA Euro qualification,Serravalle,San Marino,0,208,0,88,369,120,-369,D,1,1,0
2014-11-15 00:00:00.000000,South Africa,Sudan,2,1,African Cup of Nations qualification,Nelspruit,South Africa,0,57,542,107,298,-50,244,W,0,1,0
2014-11-15 00:00:00.000000,Spain,Belarus,3,0,UEFA Euro qualification,Huelva,Spain,0,10,1119,106,301,-96,818,W,0,1,0
2014-11-15 00:00:00.000000,Switzerland,Lithuania,4,0,UEFA Euro qualification,St. Gallen,Switzerland,0,12,1063,92,364,-80,699,W,0,1,0
2014-11-15 00:00:00.000000,Togo,Guinea,1,4,African Cup of Nations qualification,Lomé,Togo,0,52,559,55,552,-3,7,L,2,1,0
2014-11-15 00:00:00.000000,Uganda,Ghana,1,0,African Cup of Nations qualification,Kampala,Uganda,0,84,389,35,685,49,-296,W,0,1,0
2014-11-16 00:00:00.000000,Azerbaijan,Norway,0,1,UEFA Euro qualification,Baku,Azerbaijan,0,126,233,68,481,58,-248,L,2,1,0
2014-11-16 00:00:00.000000,Belgium,Wales,0,0,UEFA Euro qualification,Brussels,Belgium,0,4,1388,34,715,-30,673,D,1,1,0
2014-11-16 00:00:00.000000,Bulgaria,Malta,1,1,UEFA Euro qualification,Sofia,Bulgaria,0,59,532,157,129,-98,403,D,1,1,0
2014-11-16 00:00:00.000000,Cyprus,Andorra,5,0,UEFA Euro qualification,Nicosia,Cyprus,0,96,348,202,9,-106,339,W,0,1,0
2014-11-16 00:00:00.000000,Czech Republic,Iceland,2,1,UEFA Euro qualification,Plzeň,Czech Republic,0,22,870,28,816,-6,54,W,0,1,0
2014-11-16 00:00:00.000000,Guam,Korea DPR,1,5,EAFF Championship,Taipei,Taiwan,1,162,111,148,168,14,-57,L,2,0,0
2014-11-16 00:00:00.000000,Italy,Croatia,1,1,UEFA Euro qualification,Milan,Italy,0,11,1064,14,1002,-3,62,D,1,1,0
2014-11-16 00:00:00.000000,Morocco,Zimbabwe,2,1,Friendly,Agadir,Morocco,0,88,369,101,330,-13,39,W,0,1,0
2014-11-16 00:00:00.000000,Netherlands,Latvia,6,0,UEFA Euro qualification,Amsterdam,Netherlands,0,5,1375,99,340,-94,1035,W,0,1,0
2014-11-16 00:00:00.000000,Saudi Arabia,Bahrain,3,0,Gulf Cup,Riyadh,Saudi Arabia,0,97,341,104,308,-7,33,W,0,1,0
2014-11-16 00:00:00.000000,Swaziland,Tanzania,1,1,Friendly,Lobamba,Swaziland,0,164,103,110,291,54,-188,D,1,1,0
2014-11-16 00:00:00.000000,Turkey,Kazakhstan,3,1,UEFA Euro qualification,Istanbul,Turkey,0,46,614,132,218,-86,396,W,0,1,0
2014-11-16 00:00:00.000000,Vietnam,Malaysia,3,1,Friendly,Hanoi,Vietnam,0,136,208,156,134,-20,74,W,0,1,0
2014-11-16 00:00:00.000000,Yemen,Qatar,0,0,Gulf Cup,Riyadh,Saudi Arabia,1,178,62,88,369,90,-307,D,1,0,0
2014-11-17 00:00:00.000000,Iraq,Oman,1,1,Gulf Cup,Riyadh,Saudi Arabia,1,81,393,83,391,-2,2,D,1,0,0
2014-11-17 00:00:00.000000,Singapore,Cambodia,4,2,Friendly,Yishun,Singapore,0,161,115,185,46,-24,69,W,0,1,0
2014-11-17 00:00:00.000000,United Arab Emirates,Kuwait,2,2,Gulf Cup,Riyadh,Saudi Arabia,1,79,413,120,261,-41,152,D,1,0,0
2014-11-18 00:00:00.000000,Austria,Brazil,1,2,Friendly,Vienna,Austria,0,29,810,6,1307,23,-497,L,2,1,0
2014-11-18 00:00:00.000000,Belarus,Mexico,3,2,Friendly,Barysaw,Belarus,0,106,301,17,954,89,-653,W,0,1,0
2014-11-18 00:00:00.000000,Bolivia,Venezuela,3,2,Friendly,La Paz,Bolivia,0,103,310,85,388,18,-78,W,0,1,0
2014-11-18 00:00:00.000000,Chile,Uruguay,1,2,Friendly,Santiago,Chile,0,13,1060,8,1184,5,-124,L,2,1,0
2014-11-18 00:00:00.000000,Cuba,Haiti,1,2,CFU Caribbean Cup,Montego Bay,Jamaica,1,112,286,93,360,19,-74,L,2,0,0
2014-11-18 00:00:00.000000,Estonia,Jordan,1,0,Friendly,Tallinn,Estonia,0,88,369,74,434,14,-65,W,0,1,0
2014-11-18 00:00:00.000000,France,Sweden,1,0,Friendly,Marseille,France,0,7,1191,39,646,-32,545,W,0,1,0
2014-11-18 00:00:00.000000,Greece,Serbia,0,2,Friendly,Perivólia,Greece,0,18,946,46,614,-28,332,L,2,1,0
2014-11-18 00:00:00.000000,Hungary,Russia,1,2,Friendly,Budapest,Hungary,0,50,561,30,792,20,-231,L,2,1,0
2014-11-18 00:00:00.000000,Iran,Korea Republic,1,0,Friendly,Teheran,Iran,0,51,560,66,496,-15,64,W,0,1,0
2014-11-18 00:00:00.000000,Italy,Albania,1,0,Friendly,Genoa,Italy,0,11,1064,48,604,-37,460,W,0,1,0
2014-11-18 00:00:00.000000,Jamaica,Trinidad and Tobago,0,0,CFU Caribbean Cup,Montego Bay,Jamaica,0,113,284,49,598,64,-314,D,1,1,0
2014-11-18 00:00:00.000000,Japan,Australia,2,1,Friendly,Osaka,Japan,0,52,559,94,359,-42,200,W,0,1,0
2014-11-18 00:00:00.000000,Nicaragua,El Salvador,0,2,Friendly,Managua,Nicaragua,0,168,90,82,392,86,-302,L,2,1,0
2014-11-18 00:00:00.000000,Panama,Canada,0,0,Friendly,Panama City,Panama,0,56,546,122,251,-66,295,D,1,1,0
2014-11-18 00:00:00.000000,Peru,Paraguay,2,1,Friendly,Lima,Peru,0,54,558,76,423,-22,135,W,0,1,0
2014-11-18 00:00:00.000000,Portugal,Argentina,1,0,Friendly,Manchester,England,1,9,1175,2,1565,7,-390,W,0,0,0
2014-11-18 00:00:00.000000,Romania,Denmark,2,0,Friendly,Bucharest,Romania,0,21,876,32,763,-11,113,W,0,1,0
2014-11-18 00:00:00.000000,Scotland,England,1,3,Friendly,Glasgow,Scotland,0,37,674,20,919,17,-245,L,2,1,0
2014-11-18 00:00:00.000000,Slovakia,Finland,2,1,Friendly,Žilina,Slovakia,0,24,861,63,510,-39,351,W,0,1,0
2014-11-18 00:00:00.000000,Slovenia,Colombia,0,1,Friendly,Ljubljana,Slovenia,0,36,683,3,1420,33,-737,L,2,1,0
2014-11-18 00:00:00.000000,Spain,Germany,0,1,Friendly,Vigo,Spain,0,10,1119,1,1669,9,-550,L,2,1,0
2014-11-18 00:00:00.000000,Thailand,New Zealand,2,0,Friendly,Nakhon Ratchasima,Thailand,0,165,102,131,225,34,-123,W,0,1,0
2014-11-18 00:00:00.000000,Ukraine,Lithuania,0,0,Friendly,Kyïv,Ukraine,0,19,920,92,364,-73,556,D,1,1,0
2014-11-19 00:00:00.000000,Bahrain,Qatar,0,0,Gulf Cup,Riyadh,Saudi Arabia,1,104,308,88,369,16,-61,D,1,0,0
2014-11-19 00:00:00.000000,Burkina Faso,Angola,1,1,African Cup of Nations qualification,Ouagadougou,Burkina Faso,0,71,469,87,373,-16,96,D,1,1,0
2014-11-19 00:00:00.000000,Congo DR,Sierra Leone,3,1,African Cup of Nations qualification,Kinshasa,Congo DR,0,60,521,77,421,-17,100,W,0,1,0
2014-11-19 00:00:00.000000,Ethiopia,Malawi,0,0,African Cup of Nations qualification,Addis Ababa,Ethiopia,0,111,289,109,292,2,-3,D,1,1,0
2014-11-19 00:00:00.000000,Gabon,Lesotho,4,2,African Cup of Nations qualification,Libreville,Gabon,0,67,487,118,266,-51,221,W,0,1,0
2014-11-19 00:00:00.000000,Ghana,Togo,3,1,African Cup of Nations qualification,Tamale,Ghana,0,35,685,52,559,-17,126,W,0,1,0
2014-11-19 00:00:00.000000,Guam,Hong Kong,0,0,EAFF Championship,Taipei,Taiwan,1,162,111,163,109,-1,2,D,1,0,0
2014-11-19 00:00:00.000000,Guinea,Uganda,2,0,African Cup of Nations qualification,Casablanca,Morocco,1,55,552,84,389,-29,163,W,0,0,0
2014-11-19 00:00:00.000000,Mali,Algeria,2,0,African Cup of Nations qualification,Bamako,Mali,0,58,533,15,989,43,-456,W,0,1,0
2014-11-19 00:00:00.000000,Niger,Mozambique,1,1,African Cup of Nations qualification,Niamey,Niger,0,121,258,97,341,24,-83,D,1,1,0
2014-11-19 00:00:00.000000,Nigeria,South Africa,2,2,African Cup of Nations qualification,Uyo,Nigeria,0,42,632,57,542,-15,90,D,1,1,0
2014-11-19 00:00:00.000000,Saudi Arabia,Yemen,1,0,Gulf Cup,Riyadh,Saudi Arabia,0,97,341,178,62,-81,279,W,0,1,0
2014-11-19 00:00:00.000000,Senegal,Botswana,3,0,African Cup of Nations qualification,Dakar,Senegal,0,41,635,102,323,-61,312,W,0,1,0
2014-11-19 00:00:00.000000,Sudan,Congo,0,1,African Cup of Nations qualification,Khartoum,Sudan,0,107,298,62,512,45,-214,L,2,1,0
2014-11-19 00:00:00.000000,Tunisia,Egypt,2,1,African Cup of Nations qualification,Monastir,Tunisia,0,31,780,38,658,-7,122,W,0,1,0
2014-11-20 00:00:00.000000,Kuwait,Oman,0,5,Gulf Cup,Riyadh,Saudi Arabia,1,120,261,83,391,37,-130,L,2,0,0
2014-11-20 00:00:00.000000,United Arab Emirates,Iraq,2,0,Gulf Cup,Riyadh,Saudi Arabia,1,79,413,81,393,-2,20,W,0,0,0
2014-11-22 00:00:00.000000,Philippines,Laos,4,1,AFF Championship,Hanoi,Vietnam,1,129,229,154,141,-25,88,W,0,0,0
2014-11-22 00:00:00.000000,Vietnam,Indonesia,2,2,AFF Championship,Hanoi,Vietnam,0,136,208,157,129,-21,79,D,1,1,0
2014-11-23 00:00:00.000000,Oman,Qatar,1,3,Gulf Cup,Riyadh,Saudi Arabia,1,83,391,88,369,-5,22,L,2,0,0
2014-11-23 00:00:00.000000,Saudi Arabia,United Arab Emirates,3,2,Gulf Cup,Riyadh,Saudi Arabia,0,97,341,79,413,18,-72,W,0,1,0
2014-11-23 00:00:00.000000,Singapore,Thailand,1,2,AFF Championship,Kallang,Singapore,0,161,115,165,102,-4,13,L,2,1,0
2014-11-25 00:00:00.000000,Philippines,Indonesia,4,0,AFF Championship,Hanoi,Vietnam,1,129,229,157,129,-28,100,W,0,0,0
2014-11-25 00:00:00.000000,Vietnam,Laos,3,0,AFF Championship,Hanoi,Vietnam,0,136,208,154,141,-18,67,W,0,1,0
2014-11-28 00:00:00.000000,Indonesia,Laos,5,1,AFF Championship,Hanoi,Vietnam,1,157,126,159,120,-2,6,W,0,0,0
2014-11-28 00:00:00.000000,Vietnam,Philippines,3,1,AFF Championship,Hanoi,Vietnam,0,138,206,128,231,10,-25,W,0,1,0
2014-11-29 00:00:00.000000,Singapore,Malaysia,1,3,AFF Championship,Kallang,Singapore,0,158,123,155,137,3,-14,L,2,1,0
2014-12-06 00:00:00.000000,Philippines,Thailand,0,0,AFF Championship,Manila,Philippines,0,128,231,144,182,-16,49,D,1,1,0
2014-12-07 00:00:00.000000,Malaysia,Vietnam,1,2,AFF Championship,Shah Alam,Malaysia,0,155,137,138,206,17,-69,L,2,1,0
2014-12-10 00:00:00.000000,Thailand,Philippines,3,0,AFF Championship,Bangkok,Thailand,0,144,182,128,231,16,-49,W,0,1,0
2014-12-11 00:00:00.000000,Vietnam,Malaysia,2,4,AFF Championship,Hanoi,Vietnam,0,138,206,155,137,-17,69,L,2,1,0
2014-12-13 00:00:00.000000,Uzbekistan,Palestine,1,0,Friendly,Dubai,United Arab Emirates,1,74,448,113,276,-39,172,W,0,0,0
2014-12-20 00:00:00.000000,Malaysia,Thailand,3,2,AFF Championship,Shah Alam,Malaysia,0,154,138,142,194,12,-56,W,0,1,0
2014-12-21 00:00:00.000000,Uzbekistan,Jordan,2,1,Friendly,Dubai,United Arab Emirates,1,74,454,81,393,-7,61,W,0,0,0
2014-12-22 00:00:00.000000,Iraq,Kuwait,1,1,Friendly,al-Hamriyah,United Arab Emirates,1,103,320,124,246,-21,74,D,1,0,0
2014-12-25 00:00:00.000000,Uzbekistan,Iraq,0,1,Friendly,Sharjah,United Arab Emirates,1,74,454,103,320,-29,134,L,2,0,0
2014-12-27 00:00:00.000000,Qatar,Estonia,3,0,Friendly,Doha,Qatar,0,95,342,84,390,11,-48,W,0,1,0
2014-12-28 00:00:00.000000,Uzbekistan,Iraq,0,0,Friendly,Sharjah,United Arab Emirates,1,74,454,103,320,-29,134,D,1,0,0
2014-12-30 00:00:00.000000,Bahrain,Saudi Arabia,4,1,Friendly,South Geelong,Australia,1,122,249,102,323,20,-74,W,0,0,0
2014-12-30 00:00:00.000000,United Arab Emirates,Jordan,1,0,Friendly,Robina,Australia,1,81,393,81,393,0,0,W,0,0,0
2014-12-31 00:00:00.000000,Qatar,Oman,2,2,Friendly,Canberra,Australia,1,95,342,93,347,2,-5,D,1,0,0
2015-01-04 00:00:00.000000,Bahrain,Jordan,1,0,Friendly,Ballarat,Australia,1,122,249,81,393,41,-144,W,0,0,0
2015-01-04 00:00:00.000000,Iran,Iraq,1,0,Friendly,Wollongong,Australia,1,51,580,103,320,-52,260,W,0,0,0
2015-01-04 00:00:00.000000,Korea Republic,Saudi Arabia,2,0,Friendly,Parramatta,Australia,1,69,481,102,323,-33,158,W,0,0,0
2015-01-04 00:00:00.000000,South Africa,Zambia,1,0,Friendly,Johannesburg,South Africa,0,52,579,46,625,6,-46,W,0,1,0
2015-01-09 00:00:00.000000,Australia,Kuwait,4,1,AFC Asian Cup,Melbourne,Australia,0,100,329,125,241,-25,88,W,0,1,0
2015-01-09 00:00:00.000000,Senegal,Gabon,1,0,Friendly,Casablanca,Morocco,1,35,734,62,527,-27,207,W,0,0,0
2015-01-10 00:00:00.000000,Burkina Faso,Swaziland,5,1,Friendly,Nelspruit,South Africa,1,64,523,164,113,-100,410,W,0,0,0
2015-01-10 00:00:00.000000,Cameroon,South Africa,1,1,Friendly,Libreville,Gabon,1,42,665,52,587,-10,78,D,1,0,0
2015-01-10 00:00:00.000000,Korea Republic,Oman,1,0,AFC Asian Cup,Canberra,Australia,1,69,487,93,346,-24,141,W,0,0,0
2015-01-10 00:00:00.000000,Uzbekistan,Korea DPR,1,0,AFC Asian Cup,Sydney,Australia,1,71,464,150,157,-79,307,W,0,0,0
2015-01-11 00:00:00.000000,Iran,Bahrain,2,0,AFC Asian Cup,Melbourne,Australia,1,51,588,110,292,-59,296,W,0,0,0
2015-01-11 00:00:00.000000,Tunisia,Algeria,1,1,Friendly,Radès,Tunisia,0,22,873,18,948,4,-75,D,1,1,0
2015-01-11 00:00:00.000000,United Arab Emirates,Qatar,4,1,AFC Asian Cup,Canberra,Australia,1,80,408,92,347,-12,61,W,0,0,0
2015-01-12 00:00:00.000000,Japan,Palestine,4,0,AFC Asian Cup,Newcastle,Australia,1,54,563,115,268,-61,295,W,0,0,0
2015-01-12 00:00:00.000000,Jordan,Iraq,0,1,AFC Asian Cup,Brisbane,Australia,1,93,346,114,269,-21,77,L,2,0,0
2015-01-13 00:00:00.000000,Australia,Oman,4,0,AFC Asian Cup,Sydney,Australia,0,100,329,93,346,7,-17,W,0,1,0
2015-01-13 00:00:00.000000,Botswana,Burkina Faso,0,2,Friendly,Nelspruit,South Africa,1,106,308,64,523,42,-215,L,2,0,0
2015-01-13 00:00:00.000000,Kuwait,Korea Republic,0,1,AFC Asian Cup,Canberra,Australia,1,125,241,69,487,56,-246,L,2,0,0
2015-01-13 00:00:00.000000,Senegal,Guinea,5,2,Friendly,Casablanca,Morocco,1,35,734,39,706,-4,28,W,0,0,0
2015-01-14 00:00:00.000000,Korea DPR,Saudi Arabia,1,4,AFC Asian Cup,Melbourne,Australia,1,150,157,102,318,48,-161,L,2,0,0
2015-01-14 00:00:00.000000,Mali,South Africa,0,3,Friendly,Libreville,Gabon,1,49,603,52,587,-3,16,L,2,0,0
2015-01-15 00:00:00.000000,Bahrain,United Arab Emirates,1,2,AFC Asian Cup,Canberra,Australia,1,110,292,80,408,30,-116,L,2,0,0
2015-01-15 00:00:00.000000,Qatar,Iran,0,1,AFC Asian Cup,Sydney,Australia,1,92,347,51,588,41,-241,L,2,0,0
2015-01-16 00:00:00.000000,Canada,Iceland,1,2,Friendly,Orlando,USA,1,112,287,33,761,79,-474,L,2,0,0
2015-01-16 00:00:00.000000,Iraq,Japan,0,1,AFC Asian Cup,Brisbane,Australia,1,114,269,54,563,60,-294,L,2,0,0
2015-01-16 00:00:00.000000,Palestine,Jordan,1,5,AFC Asian Cup,Melbourne,Australia,1,115,268,93,346,22,-78,L,2,0,0
2015-01-17 00:00:00.000000,Australia,Korea Republic,0,1,AFC Asian Cup,Brisbane,Australia,0,100,329,69,487,31,-158,L,2,1,0
2015-01-17 00:00:00.000000,Burkina Faso,Gabon,0,2,African Cup of Nations,Bata,Equatorial Guinea,1,64,523,62,527,2,-4,L,2,0,0
2015-01-17 00:00:00.000000,Equatorial Guinea,Congo,1,1,African Cup of Nations,Bata,Equatorial Guinea,0,118,260,61,529,57,-269,D,1,1,0
2015-01-17 00:00:00.000000,Oman,Kuwait,1,0,AFC Asian Cup,Newcastle,Australia,1,93,346,125,241,-32,105,W,0,0,0
2015-01-17 00:00:00.000000,Yemen,Nigeria,0,2,Friendly,Dubai,United Arab Emirates,1,176,67,43,654,133,-587,L,2,0,0
2015-01-18 00:00:00.000000,Uzbekistan,Saudi Arabia,3,1,AFC Asian Cup,Melbourne,Australia,1,71,464,102,318,-31,146,W,0,0,0
2015-01-18 00:00:00.000000,Zambia,Congo DR,1,1,African Cup of Nations,Ebebiyín,Equatorial Guinea,1,50,594,57,548,-7,46,D,1,0,0
2015-01-19 00:00:00.000000,Algeria,South Africa,3,1,African Cup of Nations,Mongomo,Equatorial Guinea,1,18,948,52,587,-34,361,W,0,0,0
2015-01-19 00:00:00.000000,Canada,Iceland,1,1,Friendly,Orlando,USA,1,112,287,33,761,79,-474,D,1,0,0
2015-01-19 00:00:00.000000,Finland,Sweden,1,0,Friendly,Abu Dhabi,United Arab Emirates,1,70,468,44,646,26,-178,W,0,0,0
2015-01-19 00:00:00.000000,Ghana,Senegal,1,2,African Cup of Nations,Mongomo,Equatorial Guinea,1,37,714,35,734,2,-20,L,2,0,0
2015-01-19 00:00:00.000000,Iran,United Arab Emirates,1,0,AFC Asian Cup,Brisbane,Australia,1,51,588,80,408,-29,180,W,0,0,0
2015-01-19 00:00:00.000000,Qatar,Bahrain,1,2,AFC Asian Cup,Sydney,Australia,1,92,347,110,292,-18,55,L,2,0,0
2015-01-20 00:00:00.000000,Iraq,Palestine,2,0,AFC Asian Cup,Canberra,Australia,1,114,269,115,268,-1,1,W,0,0,0
2015-01-20 00:00:00.000000,Japan,Jordan,2,0,AFC Asian Cup,Melbourne,Australia,1,54,563,93,346,-39,217,W,0,0,0
2015-01-20 00:00:00.000000,Mali,Cameroon,1,1,African Cup of Nations,Malabo,Equatorial Guinea,1,49,603,42,665,7,-62,D,1,0,0
2015-01-21 00:00:00.000000,Equatorial Guinea,Burkina Faso,0,0,African Cup of Nations,Bata,Equatorial Guinea,0,118,260,64,523,54,-263,D,1,1,0
2015-01-21 00:00:00.000000,Gabon,Congo,0,1,African Cup of Nations,Bata,Equatorial Guinea,1,62,527,61,529,1,-2,L,2,0,0
2015-01-22 00:00:00.000000,Korea Republic,Uzbekistan,2,0,AFC Asian Cup,Melbourne,Australia,1,69,487,71,464,-2,23,W,0,0,0
2015-01-22 00:00:00.000000,Yemen,Finland,0,0,Friendly,Dubai,United Arab Emirates,1,176,67,70,468,106,-401,D,1,0,0
2015-01-22 00:00:00.000000,Zambia,Tunisia,1,2,African Cup of Nations,Ebebiyín,Equatorial Guinea,1,50,594,22,873,28,-279,L,2,0,0
2015-01-23 00:00:00.000000,Ghana,Algeria,1,0,African Cup of Nations,Mongomo,Equatorial Guinea,1,37,714,18,948,19,-234,W,0,0,0
2015-01-23 00:00:00.000000,Iran,Iraq,3,3,AFC Asian Cup,Canberra,Australia,1,51,588,114,269,-63,319,D,1,0,0
2015-01-23 00:00:00.000000,Japan,United Arab Emirates,1,1,AFC Asian Cup,Sydney,Australia,1,54,563,80,408,-26,155,D,1,0,0
2015-01-23 00:00:00.000000,South Africa,Senegal,1,1,African Cup of Nations,Mongomo,Equatorial Guinea,1,52,587,35,734,17,-147,D,1,0,0
2015-01-24 00:00:00.000000,Cameroon,Guinea,1,1,African Cup of Nations,Malabo,Equatorial Guinea,1,42,665,39,706,3,-41,D,1,0,0
2015-01-25 00:00:00.000000,Congo,Burkina Faso,2,1,African Cup of Nations,Ebebiyín,Equatorial Guinea,1,61,529,64,523,-3,6,W,0,0,0
2015-01-25 00:00:00.000000,Equatorial Guinea,Gabon,2,0,African Cup of Nations,Bata,Equatorial Guinea,0,118,260,62,527,56,-267,W,0,1,0
2015-01-26 00:00:00.000000,Congo DR,Tunisia,1,1,African Cup of Nations,Bata,Equatorial Guinea,1,57,548,22,873,35,-325,D,1,0,0
2015-01-26 00:00:00.000000,Korea Republic,Iraq,2,0,AFC Asian Cup,Sydney,Australia,1,69,487,114,269,-45,218,W,0,0,0
2015-01-27 00:00:00.000000,Australia,United Arab Emirates,2,0,AFC Asian Cup,Newcastle,Australia,0,100,329,80,408,20,-79,W,0,1,0
2015-01-27 00:00:00.000000,Senegal,Algeria,0,2,African Cup of Nations,Malabo,Equatorial Guinea,1,35,734,18,948,17,-214,L,2,0,0
2015-01-27 00:00:00.000000,South Africa,Ghana,1,2,African Cup of Nations,Mongomo,Equatorial Guinea,1,52,587,37,714,15,-127,L,2,0,0
2015-01-28 00:00:00.000000,Chile,USA,3,2,Friendly,Rancagua,Chile,0,14,1016,27,836,-13,180,W,0,1,0
2015-01-28 00:00:00.000000,Guinea,Mali,1,1,African Cup of Nations,Mongomo,Equatorial Guinea,1,39,706,49,603,-10,103,D,1,0,0
2015-01-30 00:00:00.000000,Curaçao,Aruba,0,0,ABCS Tournament,Paramaribo,Suriname,1,158,125,129,221,29,-96,D,1,0,0
2015-01-30 00:00:00.000000,Iraq,United Arab Emirates,2,3,AFC Asian Cup,Newcastle,Australia,1,114,269,80,408,34,-139,L,2,0,0
2015-01-31 00:00:00.000000,Australia,Korea Republic,2,1,AFC Asian Cup,Sydney,Australia,0,100,329,69,487,31,-158,W,0,1,0
2015-01-31 00:00:00.000000,Congo,Congo DR,2,4,African Cup of Nations,Bata,Equatorial Guinea,1,61,529,57,548,4,-19,L,2,0,0
2015-01-31 00:00:00.000000,Equatorial Guinea,Tunisia,2,1,African Cup of Nations,Bata,Equatorial Guinea,0,118,260,22,873,96,-613,W,0,1,0
2015-02-01 00:00:00.000000,Ghana,Guinea,3,0,African Cup of Nations,Malabo,Equatorial Guinea,1,37,714,39,706,-2,8,W,0,0,0
2015-02-01 00:00:00.000000,Suriname,Aruba,1,0,ABCS Tournament,Paramaribo,Suriname,0,163,115,129,221,34,-106,W,0,1,0
2015-02-02 00:00:00.000000,Bangladesh,Sri Lanka,1,0,Friendly,Dhaka,Bangladesh,0,165,103,172,78,-7,25,W,0,1,0
2015-02-04 00:00:00.000000,Honduras,Venezuela,2,3,Friendly,San Pedro Sula,Honduras,0,72,460,87,371,-15,89,L,2,1,0
2015-02-05 00:00:00.000000,Equatorial Guinea,Ghana,0,3,African Cup of Nations,Malabo,Equatorial Guinea,0,118,260,37,714,81,-454,L,2,1,0
2015-02-06 00:00:00.000000,Pakistan,Afghanistan,2,1,Friendly,Lahore,Pakistan,0,188,45,142,190,46,-145,W,0,1,0
2015-02-07 00:00:00.000000,Equatorial Guinea,Congo DR,0,0,African Cup of Nations,Malabo,Equatorial Guinea,0,118,260,57,548,61,-288,D,1,1,0
2015-02-08 00:00:00.000000,USA,Panama,2,0,Friendly,Carson,USA,0,27,836,55,551,-28,285,W,0,1,0
2015-02-18 00:00:00.000000,Kazakhstan,Moldova,1,1,Friendly,Antalya,Turkey,1,139,203,121,254,18,-51,D,1,0,0
2015-03-08 00:00:00.000000,Bermuda,Grenada,2,0,Friendly,Hamilton,Bermuda,0,180,55,155,137,25,-82,W,0,1,0
2015-03-12 00:00:00.000000,Cambodia,Macau,3,0,FIFA World Cup qualification,Phnom Penh,Cambodia,0,181,55,187,45,-6,10,W,0,1,0
2015-03-12 00:00:00.000000,India,Nepal,2,0,FIFA World Cup qualification,Guwahati,India,0,173,74,180,57,-7,17,W,0,1,0
2015-03-12 00:00:00.000000,Sri Lanka,Bhutan,0,1,FIFA World Cup qualification,Colombo,Sri Lanka,0,174,73,209,0,-35,73,L,2,1,0
2015-03-12 00:00:00.000000,Yemen,Pakistan,3,1,FIFA World Cup qualification,Doha,Qatar,1,175,72,170,88,5,-16,W,0,0,0
2015-03-15 00:00:00.000000,Antigua and Barbuda,Dominica,1,0,Friendly,St. John's,Antigua and Barbuda,0,102,325,181,55,-79,270,W,0,1,0
2015-03-17 00:00:00.000000,Bhutan,Sri Lanka,2,1,FIFA World Cup qualification,Thimphu,Bhutan,0,209,0,174,73,35,-73,W,0,1,0
2015-03-17 00:00:00.000000,Macau,Cambodia,1,1,FIFA World Cup qualification,Taipa,Macau,0,187,45,181,55,6,-10,D,1,1,0
2015-03-17 00:00:00.000000,Nepal,India,0,0,FIFA World Cup qualification,Kathmandu,Nepal,0,180,57,173,74,7,-17,D,1,1,0
2015-03-22 00:00:00.000000,Antigua and Barbuda,British Virgin Islands,1,0,Friendly,St. John's,Antigua and Barbuda,0,102,325,201,8,-99,317,W,0,1,0
2015-03-23 00:00:00.000000,Pakistan,Yemen,0,0,FIFA World Cup qualification,Isa Town,Bahrain,1,170,88,175,72,-5,16,D,1,0,0
2015-03-25 00:00:00.000000,Botswana,Lesotho,2,0,Friendly,Gaborone,Botswana,0,106,316,120,257,-14,59,W,0,1,0
2015-03-25 00:00:00.000000,Denmark,USA,3,2,Friendly,Århus,Denmark,0,28,863,32,828,-4,35,W,0,1,0
2015-03-25 00:00:00.000000,Dominican Republic,Cuba,0,3,Friendly,Santiago de los Caballeros,Dominican Republic,0,107,310,110,288,-3,22,L,2,1,0
2015-03-25 00:00:00.000000,Gabon,Mali,4,3,Friendly,Beauvais,France,1,54,610,51,626,3,-16,W,0,0,0
2015-03-25 00:00:00.000000,Georgia,Malta,2,0,Friendly,Tbilisi,Georgia,0,126,225,145,168,-19,57,W,0,1,0
2015-03-25 00:00:00.000000,Germany,Australia,2,2,Friendly,Kaiserslautern,Germany,0,1,1770,65,549,-64,1221,D,1,1,0
2015-03-25 00:00:00.000000,Indonesia,Cameroon,0,1,Friendly,Sidoarjo,Indonesia,0,156,129,49,646,107,-517,L,2,1,0
2015-03-25 00:00:00.000000,Mauritius,Burundi,2,2,Friendly,Curepipe,Mauritius,0,190,36,126,225,64,-189,D,1,1,0
2015-03-25 00:00:00.000000,Nigeria,Uganda,0,1,Friendly,Uyo,Nigeria,0,41,701,74,478,-33,223,L,2,1,0
2015-03-25 00:00:00.000000,Scotland,Northern Ireland,1,0,Friendly,Glasgow,Scotland,0,39,727,43,679,-4,48,W,0,1,0
2015-03-25 00:00:00.000000,Swaziland,South Africa,1,3,Friendly,Lobamba,Swaziland,0,163,106,55,608,108,-502,L,2,1,0
2015-03-26 00:00:00.000000,Bahrain,Colombia,0,6,Friendly,Riffa,Bahrain,0,104,319,3,1499,101,-1180,L,2,1,0
2015-03-26 00:00:00.000000,Chile,Iran,0,2,Friendly,Sankt Pölten,Austria,1,15,1057,42,692,-27,365,L,2,0,0
2015-03-26 00:00:00.000000,Egypt,Equatorial Guinea,2,0,Friendly,Cairo,Egypt,0,58,582,50,630,8,-48,W,0,1,0
2015-03-26 00:00:00.000000,France,Brazil,1,3,Friendly,Saint-Denis,France,0,8,1180,6,1348,2,-168,L,2,1,0
2015-03-26 00:00:00.000000,Jordan,Syria,0,1,Friendly,Amman,Jordan,0,101,326,152,141,-51,185,L,2,1,0
2015-03-26 00:00:00.000000,Maldives,Tajikistan,0,2,Friendly,Malé,Maldives,0,133,214,141,192,-8,22,L,2,1,0
2015-03-26 00:00:00.000000,Oman,Malaysia,6,0,Friendly,Seeb,Oman,0,96,356,153,137,-57,219,W,0,1,0
2015-03-26 00:00:00.000000,Qatar,Algeria,1,0,Friendly,Doha,Qatar,0,109,300,18,986,91,-686,W,0,1,0
2015-03-26 00:00:00.000000,Thailand,Singapore,2,0,Friendly,Nakhon Ratchasima,Thailand,0,142,189,153,137,-11,52,W,0,1,0
2015-03-27 00:00:00.000000,Canada,Guatemala,1,0,Friendly,Fort Lauderdale,USA,1,116,266,82,425,34,-159,W,0,0,0
2015-03-27 00:00:00.000000,Curaçao,Montserrat,2,1,FIFA World Cup qualification,Willemstad,Curaçao,0,159,125,172,86,-13,39,W,0,1,0
2015-03-27 00:00:00.000000,England,Lithuania,4,0,UEFA Euro qualification,London,England,0,17,1031,94,364,-77,667,W,0,1,0
2015-03-27 00:00:00.000000,Gambia,Mauritania,1,0,Friendly,Bakau,Gambia,0,168,90,115,268,53,-178,W,0,1,0
2015-03-27 00:00:00.000000,Japan,Tunisia,2,0,Friendly,Ōita,Japan,0,53,617,25,881,28,-264,W,0,1,0
2015-03-27 00:00:00.000000,Korea Republic,Uzbekistan,1,1,Friendly,Daejeon,Korea Republic,0,56,594,72,483,-16,111,D,1,1,0
2015-03-27 00:00:00.000000,Liechtenstein,Austria,0,5,UEFA Euro qualification,Vaduz,Liechtenstein,0,123,238,23,916,100,-678,L,2,1,0
2015-03-27 00:00:00.000000,Moldova,Sweden,0,2,UEFA Euro qualification,Chișinău,Moldova,0,122,243,45,663,77,-420,L,2,1,0
2015-03-27 00:00:00.000000,Montenegro,Russia,0,3,UEFA Euro qualification,Podgorica,Montenegro,0,67,531,33,788,34,-257,L,2,1,0
2015-03-27 00:00:00.000000,Slovakia,Luxembourg,3,0,UEFA Euro qualification,Žilina,Slovakia,0,22,932,136,209,-114,723,W,0,1,0
2015-03-27 00:00:00.000000,Slovenia,San Marino,6,0,UEFA Euro qualification,Ljubljana,Slovenia,0,48,649,181,55,-133,594,W,0,1,0
2015-03-27 00:00:00.000000,Spain,Ukraine,1,0,UEFA Euro qualification,Seville,Spain,0,11,1130,31,838,-20,292,W,0,1,0
2015-03-27 00:00:00.000000,Switzerland,Estonia,3,0,UEFA Euro qualification,Lucerne,Switzerland,0,12,1126,87,379,-75,747,W,0,1,0
2015-03-27 00:00:00.000000,Trinidad and Tobago,Panama,0,1,Friendly,Couva,Trinidad and Tobago,0,63,553,61,557,2,-4,L,2,1,0
2015-03-28 00:00:00.000000,Azerbaijan,Malta,2,0,UEFA Euro qualification,Baku,Azerbaijan,0,139,198,145,168,-6,30,W,0,1,0
2015-03-28 00:00:00.000000,Belgium,Cyprus,5,0,UEFA Euro qualification,Brussels,Belgium,0,4,1471,85,398,-81,1073,W,0,1,0
2015-03-28 00:00:00.000000,Bulgaria,Italy,2,2,UEFA Euro qualification,Sofia,Bulgaria,0,71,501,10,1146,61,-645,D,1,1,0
2015-03-28 00:00:00.000000,Croatia,Norway,5,1,UEFA Euro qualification,Zagreb,Croatia,0,19,963,70,522,-51,441,W,0,1,0
2015-03-28 00:00:00.000000,Czech Republic,Latvia,1,1,UEFA Euro qualification,Prague,Czech Republic,0,16,1045,95,361,-79,684,D,1,1,0
2015-03-28 00:00:00.000000,Ghana,Senegal,1,2,Friendly,Le Havre,France,1,24,887,36,772,-12,115,L,2,0,0
2015-03-28 00:00:00.000000,Hong Kong,Guam,1,0,Friendly,Kowloon,Hong Kong,0,157,127,167,93,-10,34,W,0,1,0
2015-03-28 00:00:00.000000,Iraq,Congo DR,2,1,Friendly,Sharjah,United Arab Emirates,1,97,353,47,651,50,-298,W,0,0,0
2015-03-28 00:00:00.000000,Israel,Wales,0,3,UEFA Euro qualification,Haifa,Israel,0,26,880,37,763,-11,117,L,2,1,0
2015-03-28 00:00:00.000000,Kazakhstan,Iceland,0,3,UEFA Euro qualification,Astana,Kazakhstan,0,138,199,35,776,103,-577,L,2,1,0
2015-03-28 00:00:00.000000,Mauritius,Togo,1,1,Friendly,Mapou,Mauritius,0,190,36,75,466,115,-430,D,1,1,0
2015-03-28 00:00:00.000000,Morocco,Uruguay,0,1,Friendly,Agadir,Morocco,0,89,378,9,1164,80,-786,L,2,1,0
2015-03-28 00:00:00.000000,Netherlands,Turkey,1,1,UEFA Euro qualification,Amsterdam,Netherlands,0,5,1415,56,594,-51,821,D,1,1,0
2015-03-29 00:00:00.000000,Albania,Armenia,2,1,UEFA Euro qualification,Elbasan,Albania,0,61,557,79,437,-18,120,W,0,1,0
2015-03-29 00:00:00.000000,Anguilla,Nicaragua,0,3,FIFA World Cup qualification,The Valley,Anguilla,0,208,2,185,51,23,-49,L,2,1,0
2015-03-29 00:00:00.000000,Bermuda,Bahamas,3,0,FIFA World Cup qualification,Hamilton,Bermuda,0,169,89,194,26,-25,63,W,0,1,0
2015-03-29 00:00:00.000000,Botswana,Mozambique,1,2,Friendly,Lobatse,Botswana,0,106,316,86,385,20,-69,L,2,1,0
2015-03-29 00:00:00.000000,Brazil,Chile,1,0,Friendly,London,England,1,6,1348,15,1057,-9,291,W,0,0,0
2015-03-29 00:00:00.000000,Dominica,British Virgin Islands,0,0,FIFA World Cup qualification,Roseau,Dominica,0,181,55,201,8,-20,47,D,1,1,0
2015-03-29 00:00:00.000000,France,Denmark,2,0,Friendly,Saint-Étienne,France,0,8,1180,28,863,-20,317,W,0,1,0
2015-03-29 00:00:00.000000,Georgia,Germany,0,2,UEFA Euro qualification,Tbilisi,Georgia,0,126,225,1,1770,125,-1545,L,2,1,0
2015-03-29 00:00:00.000000,Guyana,Grenada,2,0,Friendly,Providence,Guyana,0,166,94,158,126,8,-32,W,0,1,0
2015-03-29 00:00:00.000000,Hungary,Greece,0,0,UEFA Euro qualification,Budapest,Hungary,0,46,659,27,872,19,-213,D,1,1,0
2015-03-29 00:00:00.000000,Northern Ireland,Finland,2,1,UEFA Euro qualification,Belfast,Northern Ireland,0,43,679,78,450,-35,229,W,0,1,0
2015-03-29 00:00:00.000000,Portugal,Serbia,2,1,UEFA Euro qualification,Lisbon,Portugal,0,7,1191,40,709,-33,482,W,0,1,0
2015-03-29 00:00:00.000000,Romania,Faroe Islands,1,0,UEFA Euro qualification,Ploieşti,Romania,0,14,1081,105,317,-91,764,W,0,1,0
2015-03-29 00:00:00.000000,South Africa,Nigeria,1,1,Friendly,Nelspruit,South Africa,0,55,608,41,701,14,-93,D,1,1,0
2015-03-29 00:00:00.000000,Tanzania,Malawi,1,1,Friendly,Mwanza,Tanzania,0,100,331,91,376,9,-45,D,1,1,0
2015-03-29 00:00:00.000000,Zambia,Rwanda,2,0,Friendly,Lusaka,Zambia,0,60,560,64,550,-4,10,W,0,1,0
2015-03-30 00:00:00.000000,Bahrain,Philippines,2,1,Friendly,Riffa,Bahrain,0,104,319,128,221,-24,98,W,0,1,0
2015-03-30 00:00:00.000000,Belarus,Gabon,0,0,Friendly,Belek,Turkey,1,98,346,54,610,44,-264,D,1,0,0
2015-03-30 00:00:00.000000,Jamaica,Cuba,3,0,Friendly,Montego Bay,Jamaica,0,76,463,110,288,-34,175,W,0,1,0
2015-03-30 00:00:00.000000,Kuwait,Colombia,1,3,Friendly,Abu Dhabi,United Arab Emirates,1,125,231,3,1499,122,-1268,L,2,0,0
2015-03-30 00:00:00.000000,Oman,Algeria,1,4,Friendly,Doha,Qatar,1,96,356,18,986,78,-630,L,2,0,0
2015-03-30 00:00:00.000000,Qatar,Slovenia,1,0,Friendly,Doha,Qatar,0,109,300,48,649,61,-349,W,0,1,0
2015-03-30 00:00:00.000000,Saudi Arabia,Jordan,2,1,Friendly,Dammam,Saudi Arabia,0,99,339,101,326,-2,13,W,0,1,0
2015-03-30 00:00:00.000000,Thailand,Cameroon,2,3,Friendly,Nonthaburi,Thailand,0,142,189,49,646,93,-457,L,2,1,0
2015-03-31 00:00:00.000000,Estonia,Iceland,1,1,Friendly,Tallinn,Estonia,0,87,379,35,776,52,-397,D,1,1,0
2015-03-31 00:00:00.000000,Ghana,Mali,1,1,Friendly,Paris,France,1,24,887,51,626,-27,261,D,1,0,0
2015-03-31 00:00:00.000000,Iraq,Congo DR,1,0,Friendly,Sharjah,United Arab Emirates,1,97,353,47,651,50,-298,W,0,0,0
2015-03-31 00:00:00.000000,Israel,Belgium,0,1,UEFA Euro qualification,Jerusalem,Israel,0,26,880,4,1471,22,-591,L,2,1,0
2015-03-31 00:00:00.000000,Italy,England,1,1,Friendly,Turin,Italy,0,10,1146,17,1031,-7,115,D,1,1,0
2015-03-31 00:00:00.000000,Japan,Uzbekistan,5,1,Friendly,Chōfu,Japan,0,53,617,72,483,-19,134,W,0,1,0
2015-03-31 00:00:00.000000,Korea Republic,New Zealand,1,0,Friendly,Seoul,Korea Republic,0,56,594,134,211,-78,383,W,0,1,0
2015-03-31 00:00:00.000000,Liechtenstein,San Marino,1,0,Friendly,Eschen,Liechtenstein,0,123,238,181,55,-58,183,W,0,1,0
2015-03-31 00:00:00.000000,Luxembourg,Turkey,1,2,Friendly,Luxembourg,Luxembourg,0,136,209,56,594,80,-385,L,2,1,0
2015-03-31 00:00:00.000000,Mauritania,Niger,2,0,Friendly,Nouakchott,Mauritania,0,115,268,114,271,1,-3,W,0,1,0
2015-03-31 00:00:00.000000,Montserrat,Curaçao,2,2,FIFA World Cup qualification,Lookout,Montserrat,0,172,86,159,125,13,-39,D,1,1,0
2015-03-31 00:00:00.000000,Netherlands,Spain,2,0,Friendly,Amsterdam,Netherlands,0,5,1415,11,1130,-6,285,W,0,1,0
2015-03-31 00:00:00.000000,Panama,Costa Rica,2,1,Friendly,Panama City,Panama,0,61,557,13,1095,48,-538,W,0,1,0
2015-03-31 00:00:00.000000,Peru,Venezuela,0,1,Friendly,Fort Lauderdale,USA,1,59,565,72,483,-13,82,L,2,0,0
2015-03-31 00:00:00.000000,Russia,Kazakhstan,0,0,Friendly,Khimki,Russia,0,33,788,138,199,-105,589,D,1,1,0
2015-03-31 00:00:00.000000,Singapore,Guam,2,2,Friendly,Kallang,Singapore,0,153,137,167,93,-14,44,D,1,1,0
2015-03-31 00:00:00.000000,Slovakia,Czech Republic,1,0,Friendly,Žilina,Slovakia,0,22,932,16,1045,6,-113,W,0,1,0
2015-03-31 00:00:00.000000,Sweden,Iran,3,1,Friendly,Solna,Sweden,0,45,663,42,692,3,-29,W,0,1,0
2015-03-31 00:00:00.000000,Switzerland,USA,1,1,Friendly,Zürich,Switzerland,0,12,1126,32,828,-20,298,D,1,1,0
2015-03-31 00:00:00.000000,Tajikistan,Syria,2,3,Friendly,Dushanbe,Tajikistan,0,141,192,152,141,-11,51,L,2,1,0
2015-03-31 00:00:00.000000,Ukraine,Latvia,1,1,Friendly,L'viv,Ukraine,0,31,838,95,361,-64,477,D,1,1,0
2015-04-15 00:00:00.000000,USA,Mexico,2,0,Friendly,San Antonio,USA,0,27,815,18,937,9,-122,W,0,1,0
2015-05-10 00:00:00.000000,Barbados,St. Kitts and Nevis,1,3,Friendly,Bridgetown,Barbados,0,130,215,112,281,18,-66,L,2,1,0
2015-05-10 00:00:00.000000,Zambia,Malawi,2,0,Friendly,Lusaka,Zambia,0,60,552,97,341,-37,211,W,0,1,0
2015-05-12 00:00:00.000000,Kazakhstan,Burkina Faso,0,0,Friendly,Almaty,Kazakhstan,0,134,210,66,517,68,-307,D,1,1,0
2015-05-13 00:00:00.000000,Dominican Republic,Cayman Islands,6,0,Friendly,Santiago de los Caballeros,Dominican Republic,0,118,257,191,48,-73,209,W,0,1,0
2015-05-14 00:00:00.000000,Grenada,Dominica,1,2,Windward Islands Tournament,Vieux Fort,St. Lucia,1,171,113,165,121,6,-8,L,2,0,0
2015-05-14 00:00:00.000000,Lesotho,South Africa,0,0,Friendly,Maseru,Lesotho,0,121,242,59,553,62,-311,D,1,1,0
2015-05-14 00:00:00.000000,St. Lucia,St. Vincent and the Grenadines,1,2,Windward Islands Tournament,Vieux Fort,St. Lucia,0,131,214,110,291,21,-77,L,2,1,0
2015-05-16 00:00:00.000000,Lesotho,South Africa,1,1,Friendly,Maseru,Lesotho,0,121,242,59,553,62,-311,D,1,1,0
2015-05-16 00:00:00.000000,St. Lucia,Grenada,0,2,Windward Islands Tournament,Vieux Fort,St. Lucia,0,131,214,171,113,-40,101,L,2,1,0
2015-05-17 00:00:00.000000,Namibia,Seychelles,0,0,COSAFA Cup,Moruleng-Saulspoort,South Africa,1,114,279,189,60,-75,219,D,1,0,0
2015-05-17 00:00:00.000000,Vietnam,Korea DPR,1,1,Friendly,Hanoi,Vietnam,0,124,229,156,139,-32,90,D,1,1,0
2015-05-17 00:00:00.000000,Zimbabwe,Mauritius,2,0,COSAFA Cup,Moruleng-Saulspoort,South Africa,1,123,235,185,65,-62,170,W,0,0,0
2015-05-18 00:00:00.000000,Lesotho,Madagascar,1,2,COSAFA Cup,Phokeng,South Africa,1,121,242,150,156,-29,86,L,2,0,0
2015-05-18 00:00:00.000000,Tanzania,Swaziland,0,1,COSAFA Cup,Phokeng,South Africa,1,107,304,176,97,-69,207,L,2,0,0
2015-05-19 00:00:00.000000,Namibia,Mauritius,2,0,COSAFA Cup,Moruleng-Saulspoort,South Africa,1,114,279,185,65,-71,214,W,0,0,0
2015-05-19 00:00:00.000000,Seychelles,Zimbabwe,0,1,COSAFA Cup,Moruleng-Saulspoort,South Africa,1,189,60,123,235,66,-175,L,2,0,0
2015-05-20 00:00:00.000000,Lesotho,Swaziland,0,2,COSAFA Cup,Phokeng,South Africa,1,121,242,176,97,-55,145,L,2,0,0
2015-05-20 00:00:00.000000,Madagascar,Tanzania,2,0,COSAFA Cup,Phokeng,South Africa,1,150,156,107,304,43,-148,W,0,0,0
2015-05-20 00:00:00.000000,Thailand,Korea DPR,0,1,Friendly,Bangkok,Thailand,0,142,183,156,139,-14,44,L,2,1,0
2015-05-21 00:00:00.000000,Namibia,Zimbabwe,4,1,COSAFA Cup,Moruleng-Saulspoort,South Africa,1,114,279,123,235,-9,44,W,0,0,0
2015-05-21 00:00:00.000000,Seychelles,Mauritius,0,1,COSAFA Cup,Phokeng,South Africa,1,189,60,185,65,4,-5,L,2,0,0
2015-05-22 00:00:00.000000,Lesotho,Tanzania,1,0,COSAFA Cup,Moruleng-Saulspoort,South Africa,1,121,242,107,304,14,-62,W,0,0,0
2015-05-22 00:00:00.000000,Madagascar,Swaziland,1,1,COSAFA Cup,Phokeng,South Africa,1,150,156,176,97,-26,59,D,1,0,0
2015-05-24 00:00:00.000000,Lebanon,Syria,2,2,Friendly,Sidon,Lebanon,0,144,163,125,225,19,-62,D,1,1,0
2015-05-24 00:00:00.000000,South Africa,Botswana,0,0,COSAFA Cup,Moruleng-Saulspoort,South Africa,0,59,553,104,314,-45,239,D,1,1,0
2015-05-24 00:00:00.000000,Thailand,Vietnam,1,0,FIFA World Cup qualification,Bangkok,Thailand,0,142,183,124,229,18,-46,W,0,1,0
2015-05-24 00:00:00.000000,Zambia,Namibia,0,0,COSAFA Cup,Moruleng-Saulspoort,South Africa,1,60,552,114,279,-54,273,D,1,0,0
2015-05-25 00:00:00.000000,Ghana,Madagascar,1,2,COSAFA Cup,Phokeng,South Africa,1,26,833,150,156,-124,677,L,2,0,0
2015-05-25 00:00:00.000000,Mozambique,Malawi,2,2,COSAFA Cup,Phokeng,South Africa,1,86,383,97,341,-11,42,D,1,0,0
2015-05-27 00:00:00.000000,South Africa,Malawi,0,0,COSAFA Cup,Moruleng-Saulspoort,South Africa,0,59,553,97,341,-38,212,D,1,1,0
2015-05-27 00:00:00.000000,Zambia,Ghana,3,0,COSAFA Cup,Moruleng-Saulspoort,South Africa,1,60,552,26,833,34,-281,W,0,0,0
2015-05-28 00:00:00.000000,Botswana,Mozambique,1,2,COSAFA Cup,Moruleng-Saulspoort,South Africa,1,104,314,86,383,18,-69,L,2,0,0
2015-05-28 00:00:00.000000,Namibia,Madagascar,3,2,COSAFA Cup,Moruleng-Saulspoort,South Africa,1,114,279,150,156,-36,123,W,0,0,0
2015-05-29 00:00:00.000000,Laos,Afghanistan,0,2,Friendly,Vientiane,Laos,0,178,88,135,208,43,-120,L,2,1,0
2015-05-29 00:00:00.000000,Zambia,Malawi,0,1,COSAFA Cup,Phokeng,South Africa,1,60,552,97,341,-37,211,L,2,0,0
2015-05-30 00:00:00.000000,Bahrain,Oman,0,0,Friendly,Riffa,Bahrain,0,108,299,97,341,11,-42,D,1,1,0
2015-05-30 00:00:00.000000,Bangladesh,Singapore,1,2,Friendly,Dhaka,Bangladesh,0,169,116,162,130,7,-14,L,2,1,0
2015-05-30 00:00:00.000000,Jordan,Lebanon,0,0,Friendly,Irbid,Jordan,0,103,316,144,163,-41,153,D,1,1,0
2015-05-30 00:00:00.000000,Madagascar,Botswana,2,1,COSAFA Cup,Moruleng-Saulspoort,South Africa,1,150,156,104,314,46,-158,W,0,0,0
2015-05-30 00:00:00.000000,Mexico,Guatemala,3,0,Friendly,Tuxtla Gutiérrez,Mexico,0,22,908,90,371,-68,537,W,0,1,0
2015-05-30 00:00:00.000000,Namibia,Mozambique,2,0,COSAFA Cup,Moruleng-Saulspoort,South Africa,1,114,279,86,383,28,-104,W,0,0,0
2015-05-31 00:00:00.000000,El Salvador,Honduras,0,2,Friendly,Washington,USA,1,84,388,76,453,8,-65,L,2,0,0
2015-05-31 00:00:00.000000,Northern Ireland,Qatar,1,1,Friendly,Crewe,England,1,42,672,99,337,-57,335,D,1,0,0
2015-06-02 00:00:00.000000,Bangladesh,Afghanistan,1,1,Friendly,Dhaka,Bangladesh,0,169,116,135,208,34,-92,D,1,1,0
2015-06-02 00:00:00.000000,Cambodia,Laos,1,1,Friendly,Phnom Penh,Cambodia,0,179,86,178,88,1,-2,D,1,1,0
2015-06-05 00:00:00.000000,Curaçao,Trinidad and Tobago,1,0,Friendly,Willemstad,Curaçao,0,144,159,67,519,77,-360,W,0,1,0
2015-06-05 00:00:00.000000,Hungary,Lithuania,4,0,Friendly,Debrecen,Hungary,0,42,685,96,341,-54,344,W,0,1,0
2015-06-05 00:00:00.000000,Jordan,Kuwait,2,2,Friendly,Istanbul,Turkey,1,103,316,125,218,-22,98,D,1,0,0
2015-06-05 00:00:00.000000,Netherlands,USA,3,4,Friendly,Amsterdam,Netherlands,0,6,1378,27,823,-21,555,L,2,1,0
2015-06-05 00:00:00.000000,Oman,Syria,1,2,Friendly,Muscat,Oman,0,101,319,121,234,-20,85,L,2,1,0
2015-06-05 00:00:00.000000,Scotland,Qatar,1,0,Friendly,Edinburgh,Scotland,0,28,818,97,334,-69,484,W,0,1,0
2015-06-05 00:00:00.000000,Thailand,Bahrain,1,1,Friendly,Bangkok,Thailand,0,129,207,106,299,23,-92,D,1,1,0
2015-06-06 00:00:00.000000,Andorra,Equatorial Guinea,0,1,Friendly,Sant Julià de Lòria,Andorra,0,204,8,50,635,154,-627,L,2,1,0
2015-06-06 00:00:00.000000,Burkina Faso,Cameroon,2,3,Friendly,Colombes,France,1,66,520,49,641,17,-121,L,2,0,0
2015-06-06 00:00:00.000000,Colombia,Costa Rica,1,0,Friendly,Buenos Aires,Argentina,1,4,1435,14,1056,-10,379,W,0,0,0
2015-06-06 00:00:00.000000,Ecuador,Panama,4,0,Friendly,Portoviejo,Ecuador,0,31,806,54,597,-23,209,W,0,1,0
2015-06-06 00:00:00.000000,Guinea,Chad,2,1,Friendly,Saint-Leu-la-Forêt,France,1,45,673,172,100,-127,573,W,0,0,0
2015-06-06 00:00:00.000000,Malaysia,Hong Kong,0,0,Friendly,Shah Alam,Malaysia,0,162,121,164,118,-2,3,D,1,1,0
2015-06-06 00:00:00.000000,Niger,Gabon,2,1,Friendly,Niamey,Niger,0,117,251,59,583,58,-332,W,0,1,0
2015-06-06 00:00:00.000000,Paraguay,Honduras,2,2,Friendly,Asunción,Paraguay,0,85,382,75,462,10,-80,D,1,1,0
2015-06-06 00:00:00.000000,Rwanda,Kenya,0,0,Friendly,Kigali,Rwanda,0,94,346,123,220,-29,126,D,1,1,0
2015-06-06 00:00:00.000000,Uruguay,Guatemala,5,1,Friendly,Montevideo,Uruguay,0,8,1183,93,348,-85,835,W,0,1,0
2015-06-07 00:00:00.000000,Brazil,Mexico,2,0,Friendly,São Paulo,Brazil,0,5,1392,23,926,-18,466,W,0,1,0
2015-06-07 00:00:00.000000,Ethiopia,Zambia,0,1,Friendly,Addis Abeba,Ethiopia,0,99,324,68,517,31,-193,L,2,1,0
2015-06-07 00:00:00.000000,France,Belgium,3,4,Friendly,Saint-Denis,France,0,9,1164,2,1509,7,-345,L,2,1,0
2015-06-07 00:00:00.000000,Kenya,South Sudan,2,0,Friendly,Kigali,Rwanda,1,123,220,197,24,-74,196,W,0,0,0
2015-06-07 00:00:00.000000,Russia,Belarus,4,2,Friendly,Khimki,Russia,0,26,833,80,400,-54,433,W,0,1,0
2015-06-07 00:00:00.000000,Rwanda,Tanzania,2,0,Friendly,Kigali,Rwanda,0,94,346,127,215,-33,131,W,0,1,0
2015-06-07 00:00:00.000000,Serbia,Azerbaijan,4,1,Friendly,Sankt Pölten,Austria,1,45,673,115,272,-70,401,W,0,0,0
2015-06-08 00:00:00.000000,Denmark,Montenegro,2,1,Friendly,Viborg,Denmark,0,29,808,70,513,-41,295,W,0,1,0
2015-06-08 00:00:00.000000,Egypt,Malawi,2,1,Friendly,Alexandria,Egypt,0,55,596,95,345,-40,251,W,0,1,0
2015-06-08 00:00:00.000000,Ghana,Togo,1,0,Friendly,Accra,Ghana,0,34,800,77,438,-43,362,W,0,1,0
2015-06-08 00:00:00.000000,Malta,Lithuania,2,0,Friendly,Attard,Malta,0,145,154,96,341,49,-187,W,0,1,0
2015-06-08 00:00:00.000000,Norway,Sweden,0,0,Friendly,Oslo,Norway,0,64,528,39,737,25,-209,D,1,1,0
2015-06-08 00:00:00.000000,Turkey,Bulgaria,4,0,Friendly,Istanbul,Turkey,0,57,590,62,537,-5,53,W,0,1,0
2015-06-09 00:00:00.000000,Congo DR,Cameroon,1,1,Friendly,Mons,Belgium,1,56,591,49,641,7,-50,D,1,0,0
2015-06-09 00:00:00.000000,Finland,Estonia,0,2,Friendly,Turku,Finland,0,78,410,91,370,-13,40,L,2,1,0
2015-06-09 00:00:00.000000,Georgia,Ukraine,1,2,Friendly,Linz,Austria,1,139,173,35,784,104,-611,L,2,0,0
2015-06-09 00:00:00.000000,Luxembourg,Moldova,0,0,Friendly,Luxembourg,Luxembourg,0,131,201,124,219,7,-18,D,1,1,0
2015-06-09 00:00:00.000000,Uganda,Gambia,1,1,Friendly,Kampala,Uganda,0,71,504,160,124,-89,380,D,1,1,0
2015-06-10 00:00:00.000000,Brazil,Honduras,1,0,Friendly,Porto Alegre,Brazil,0,5,1392,75,462,-70,930,W,0,1,0
2015-06-10 00:00:00.000000,Curaçao,Cuba,0,0,FIFA World Cup qualification,Willemstad,Curaçao,0,144,159,107,295,37,-136,D,1,1,0
2015-06-10 00:00:00.000000,Germany,USA,1,2,Friendly,Cologne,Germany,0,1,1775,27,823,-26,952,L,2,1,0
2015-06-10 00:00:00.000000,Switzerland,Liechtenstein,3,0,Friendly,Thun,Switzerland,0,11,1146,129,207,-118,939,W,0,1,0
2015-06-11 00:00:00.000000,Afghanistan,Syria,0,6,FIFA World Cup qualification,Mashhad,Iran,1,151,138,121,234,30,-96,L,2,0,0
2015-06-11 00:00:00.000000,Cambodia,Singapore,0,4,FIFA World Cup qualification,Phnom Penh,Cambodia,0,178,86,154,136,24,-50,L,2,1,0
2015-06-11 00:00:00.000000,Chile,Ecuador,2,0,Copa América,Santiago,Chile,0,19,989,31,806,-12,183,W,0,1,0
2015-06-11 00:00:00.000000,Dominican Republic,Belize,1,2,FIFA World Cup qualification,Santo Domingo,Dominican Republic,0,116,257,155,131,-39,126,L,2,1,0
2015-06-11 00:00:00.000000,Guam,Turkmenistan,1,0,FIFA World Cup qualification,Dededo,Guam,0,174,97,173,99,1,-2,W,0,1,0
2015-06-11 00:00:00.000000,Hong Kong,Bhutan,7,0,FIFA World Cup qualification,Kowloon,Hong Kong,0,164,118,159,128,5,-10,W,0,1,0
2015-06-11 00:00:00.000000,India,Oman,1,2,FIFA World Cup qualification,Bangalore,India,0,141,161,101,319,40,-158,L,2,1,0
2015-06-11 00:00:00.000000,Japan,Iraq,4,0,Friendly,Yokohama,Japan,0,52,623,86,381,-34,242,W,0,1,0
2015-06-11 00:00:00.000000,Korea Republic,United Arab Emirates,3,0,Friendly,Kuala Lumpur,Malaysia,1,58,587,73,496,-15,91,W,0,0,0
2015-06-11 00:00:00.000000,Lebanon,Kuwait,0,1,FIFA World Cup qualification,Sidon,Lebanon,0,135,188,125,218,10,-30,L,2,1,0
2015-06-11 00:00:00.000000,Maldives,Qatar,0,1,FIFA World Cup qualification,Malé,Maldives,0,178,86,97,334,81,-248,L,2,1,0
2015-06-11 00:00:00.000000,Philippines,Bahrain,2,1,FIFA World Cup qualification,Bocaue,Philippines,0,137,183,106,299,31,-116,W,0,1,0
2015-06-11 00:00:00.000000,Saudi Arabia,Palestine,3,2,FIFA World Cup qualification,Dammam,Saudi Arabia,0,98,329,118,242,-20,87,W,0,1,0
2015-06-11 00:00:00.000000,Spain,Costa Rica,2,1,Friendly,León,Spain,0,10,1147,14,1056,-4,91,W,0,1,0
2015-06-11 00:00:00.000000,Tajikistan,Jordan,1,3,FIFA World Cup qualification,Dushanbe,Tajikistan,0,139,173,103,316,36,-143,L,2,1,0
2015-06-11 00:00:00.000000,Uzbekistan,Iran,0,1,Friendly,Tashkent,Uzbekistan,0,74,479,41,717,33,-238,L,2,1,0
2015-06-11 00:00:00.000000,Yemen,Korea DPR,0,3,FIFA World Cup qualification,Doha,Qatar,1,165,117,146,151,19,-34,L,2,0,0
2015-06-12 00:00:00.000000,Andorra,Cyprus,1,3,UEFA Euro qualification,Sant Julià de Lòria,Andorra,0,204,8,87,377,117,-369,L,2,1,0
2015-06-12 00:00:00.000000,Croatia,Italy,1,1,UEFA Euro qualification,Split,Croatia,0,18,992,13,1101,5,-109,D,1,1,0
2015-06-12 00:00:00.000000,Guinea,Swaziland,1,2,African Cup of Nations qualification,Casablanca,Morocco,1,45,673,162,121,-117,552,L,2,0,0
2015-06-12 00:00:00.000000,Iceland,Czech Republic,2,1,UEFA Euro qualification,Reykjavík,Iceland,0,37,769,16,1036,21,-267,W,0,1,0
2015-06-12 00:00:00.000000,Kazakhstan,Turkey,0,1,UEFA Euro qualification,Almaty,Kazakhstan,0,133,195,57,590,76,-395,L,2,1,0
2015-06-12 00:00:00.000000,Latvia,Netherlands,0,2,UEFA Euro qualification,Riga,Latvia,0,82,390,6,1378,76,-988,L,2,1,0
2015-06-12 00:00:00.000000,Malta,Bulgaria,0,1,UEFA Euro qualification,Attard,Malta,0,145,154,62,537,83,-383,L,2,1,0
2015-06-12 00:00:00.000000,Mexico,Bolivia,0,0,Copa América,Viña del Mar,Chile,1,23,926,89,371,-66,555,D,1,0,0
2015-06-12 00:00:00.000000,Morocco,Libya,1,0,African Cup of Nations qualification,Agadir,Morocco,0,92,369,119,238,-27,131,W,0,1,0
2015-06-12 00:00:00.000000,Norway,Azerbaijan,0,0,UEFA Euro qualification,Oslo,Norway,0,64,528,115,272,-51,256,D,1,1,0
2015-06-12 00:00:00.000000,Tunisia,Djibouti,8,1,African Cup of Nations qualification,Radès,Tunisia,0,29,808,207,4,-178,804,W,0,1,0
2015-06-12 00:00:00.000000,Wales,Belgium,1,0,UEFA Euro qualification,Cardiff,Wales,0,22,929,2,1509,20,-580,W,0,1,0
2015-06-13 00:00:00.000000,Albania,France,1,0,Friendly,Elbasan,Albania,0,51,624,9,1164,42,-540,W,0,1,0
2015-06-13 00:00:00.000000,Algeria,Seychelles,4,0,African Cup of Nations qualification,Blida,Algeria,0,21,941,187,60,-166,881,W,0,1,0
2015-06-13 00:00:00.000000,Angola,Central African Republic,4,0,African Cup of Nations qualification,Lubango,Angola,0,88,374,141,161,-53,213,W,0,1,0
2015-06-13 00:00:00.000000,Argentina,Paraguay,2,2,Copa América,La Serena,Chile,1,3,1496,85,382,-82,1114,D,1,0,0
2015-06-13 00:00:00.000000,Armenia,Portugal,2,3,UEFA Euro qualification,Yerevan,Armenia,0,84,383,7,1229,77,-846,L,2,1,0
2015-06-13 00:00:00.000000,Burkina Faso,Comoros,2,0,African Cup of Nations qualification,Ouagadougou,Burkina Faso,0,66,520,190,44,-124,476,W,0,1,0
2015-06-13 00:00:00.000000,Denmark,Serbia,2,0,UEFA Euro qualification,Copenhagen,Denmark,0,29,808,45,673,-16,135,W,0,1,0
2015-06-13 00:00:00.000000,Faroe Islands,Greece,2,1,UEFA Euro qualification,Tórshavn,Faroe Islands,0,102,318,25,899,77,-581,W,0,1,0
2015-06-13 00:00:00.000000,Finland,Hungary,0,1,UEFA Euro qualification,Helsinki,Finland,0,78,410,42,685,36,-275,L,2,1,0
2015-06-13 00:00:00.000000,Malawi,Zimbabwe,1,2,African Cup of Nations qualification,Blantyre,Malawi,0,95,345,119,238,-24,107,L,2,1,0
2015-06-13 00:00:00.000000,Mali,South Sudan,2,0,African Cup of Nations qualification,Bamako,Mali,0,52,623,197,24,-145,599,W,0,1,0
2015-06-13 00:00:00.000000,Nigeria,Chad,2,0,African Cup of Nations qualification,Kaduna,Nigeria,0,43,681,172,100,-129,581,W,0,1,0
2015-06-13 00:00:00.000000,Northern Ireland,Romania,0,0,UEFA Euro qualification,Belfast,Northern Ireland,0,44,676,12,1115,32,-439,D,1,1,0
2015-06-13 00:00:00.000000,Poland,Georgia,4,0,UEFA Euro qualification,Warsaw,Poland,0,32,802,139,173,-107,629,W,0,1,0
2015-06-13 00:00:00.000000,Senegal,Burundi,3,1,African Cup of Nations qualification,Dakar,Senegal,0,36,782,134,194,-98,588,W,0,1,0
2015-06-13 00:00:00.000000,South Africa,Gambia,0,0,African Cup of Nations qualification,Durban,South Africa,0,69,515,160,124,-91,391,D,1,1,0
2015-06-13 00:00:00.000000,Uganda,Botswana,2,0,African Cup of Nations qualification,Kampala,Uganda,0,71,504,111,285,-40,219,W,0,1,0
2015-06-13 00:00:00.000000,Uruguay,Jamaica,1,0,Copa América,Antofagasta,Chile,1,8,1183,65,524,-57,659,W,0,0,0
2015-06-13 00:00:00.000000,Zambia,Guinea-Bissau,0,0,African Cup of Nations qualification,Ndola,Zambia,0,68,517,155,131,-87,386,D,1,1,0
2015-06-14 00:00:00.000000,Barbados,Aruba,0,3,FIFA World Cup qualification,Bridgetown,Barbados,0,132,196,151,138,-19,58,L,2,1,0
2015-06-14 00:00:00.000000,Belarus,Spain,0,1,UEFA Euro qualification,Barysaw,Belarus,0,80,400,10,1147,70,-747,L,2,1,0
2015-06-14 00:00:00.000000,Brazil,Peru,2,1,Copa América,Temuco,Chile,1,5,1392,61,546,-56,846,W,0,0,0
2015-06-14 00:00:00.000000,Cameroon,Mauritania,1,0,African Cup of Nations qualification,Yaoundé,Cameroon,0,49,641,149,146,-100,495,W,0,1,0
2015-06-14 00:00:00.000000,Colombia,Venezuela,0,1,Copa América,Rancagua,Chile,1,4,1435,72,497,-68,938,L,2,0,0
2015-06-14 00:00:00.000000,Congo,Kenya,1,1,African Cup of Nations qualification,Owando,Congo,0,47,666,123,220,-76,446,D,1,1,0
2015-06-14 00:00:00.000000,Congo DR,Madagascar,2,1,African Cup of Nations qualification,Kinshasa,Congo DR,0,56,591,113,278,-57,313,W,0,1,0
2015-06-14 00:00:00.000000,Cuba,Curaçao,1,1,FIFA World Cup qualification,Havana,Cuba,0,107,295,144,159,-37,136,D,1,1,0
2015-06-14 00:00:00.000000,Egypt,Tanzania,3,0,African Cup of Nations qualification,Alexandria,Egypt,0,55,596,127,215,-72,381,W,0,1,0
2015-06-14 00:00:00.000000,Equatorial Guinea,Benin,1,1,African Cup of Nations qualification,Bata,Equatorial Guinea,0,50,635,110,289,-60,346,D,1,1,0
2015-06-14 00:00:00.000000,Estonia,San Marino,2,0,UEFA Euro qualification,Tallinn,Estonia,0,91,370,192,40,-101,330,W,0,1,0
2015-06-14 00:00:00.000000,Ethiopia,Lesotho,2,1,African Cup of Nations qualification,Addis Abeba,Ethiopia,0,99,324,122,226,-23,98,W,0,1,0
2015-06-14 00:00:00.000000,Ghana,Mauritius,7,1,African Cup of Nations qualification,Accra,Ghana,0,34,800,176,90,-142,710,W,0,1,0
2015-06-14 00:00:00.000000,Liechtenstein,Moldova,1,1,UEFA Euro qualification,Vaduz,Liechtenstein,0,129,207,124,219,5,-12,D,1,1,0
2015-06-14 00:00:00.000000,Lithuania,Switzerland,1,2,UEFA Euro qualification,Vilnius,Lithuania,0,96,341,11,1146,85,-805,L,2,1,0
2015-06-14 00:00:00.000000,Mozambique,Rwanda,0,1,African Cup of Nations qualification,Maputo,Mozambique,0,81,391,94,346,-13,45,L,2,1,0
2015-06-14 00:00:00.000000,Niger,Namibia,1,0,African Cup of Nations qualification,Niamey,Niger,0,117,251,105,303,12,-52,W,0,1,0
2015-06-14 00:00:00.000000,Russia,Austria,0,1,UEFA Euro qualification,Moscow,Russia,0,26,833,20,946,6,-113,L,2,1,0
2015-06-14 00:00:00.000000,Slovenia,England,2,3,UEFA Euro qualification,Ljubljana,Slovenia,0,48,653,15,1051,33,-398,L,2,1,0
2015-06-14 00:00:00.000000,Sudan,Sierra Leone,1,0,African Cup of Nations qualification,Khartoum,Sudan,0,108,292,83,387,25,-95,W,0,1,0
2015-06-14 00:00:00.000000,Sweden,Montenegro,3,1,UEFA Euro qualification,Solna,Sweden,0,39,737,70,513,-31,224,W,0,1,0
2015-06-14 00:00:00.000000,Togo,Liberia,2,1,African Cup of Nations qualification,Lomé,Togo,0,77,438,148,149,-71,289,W,0,1,0
2015-06-14 00:00:00.000000,Ukraine,Luxembourg,3,0,UEFA Euro qualification,L'viv,Ukraine,0,35,784,131,201,-96,583,W,0,1,0
2015-06-15 00:00:00.000000,Chile,Mexico,3,3,Copa América,Santiago,Chile,0,19,989,23,926,-4,63,D,1,1,0
2015-06-15 00:00:00.000000,Ecuador,Bolivia,2,3,Copa América,Valparaíso,Chile,1,31,806,89,371,-58,435,L,2,0,0
2015-06-15 00:00:00.000000,Morocco,Tunisia,1,1,African Nations Championship,Casablanca,Morocco,0,92,369,29,808,63,-439,D,1,1,0
2015-06-16 00:00:00.000000,Argentina,Uruguay,1,0,Copa América,La Serena,Chile,1,3,1496,8,1183,-5,313,W,0,0,0
2015-06-16 00:00:00.000000,Bangladesh,Tajikistan,1,1,FIFA World Cup qualification,Dhaka,Bangladesh,0,166,116,139,173,27,-57,D,1,1,0
2015-06-16 00:00:00.000000,Cambodia,Afghanistan,0,1,FIFA World Cup qualification,Phnom Penh,Cambodia,0,178,86,151,138,27,-52,L,2,1,0
2015-06-16 00:00:00.000000,Grenada,Puerto Rico,2,0,FIFA World Cup qualification,St. George's,Grenada,0,160,124,167,114,-7,10,W,0,1,0
2015-06-16 00:00:00.000000,Guam,India,2,1,FIFA World Cup qualification,Dededo,Guam,0,174,97,141,161,33,-64,W,0,1,0
2015-06-16 00:00:00.000000,Hong Kong,Maldives,2,0,FIFA World Cup qualification,Kowloon,Hong Kong,0,164,118,178,86,-14,32,W,0,1,0
2015-06-16 00:00:00.000000,Italy,Portugal,0,1,Friendly,Geneva,Switzerland,1,13,1101,7,1229,6,-128,L,2,0,0
2015-06-16 00:00:00.000000,Japan,Singapore,0,0,FIFA World Cup qualification,Saitama,Japan,0,52,623,154,136,-102,487,D,1,1,0
2015-06-16 00:00:00.000000,Jordan,Trinidad and Tobago,3,0,Friendly,Irbid,Jordan,0,103,316,67,519,36,-203,W,0,1,0
2015-06-16 00:00:00.000000,Korea DPR,Uzbekistan,4,2,FIFA World Cup qualification,P'yŏngyang,Korea DPR,0,146,151,74,479,72,-328,W,0,1,0
2015-06-16 00:00:00.000000,Laos,Lebanon,0,2,FIFA World Cup qualification,Vientiane,Laos,0,175,94,135,188,40,-94,L,2,1,0
2015-06-16 00:00:00.000000,Malaysia,Palestine,0,6,FIFA World Cup qualification,Kuala Lumpur,Malaysia,0,162,121,118,242,44,-121,L,2,1,0
2015-06-16 00:00:00.000000,Paraguay,Jamaica,1,0,Copa América,Antofagasta,Chile,1,85,382,65,524,20,-142,W,0,0,0
2015-06-16 00:00:00.000000,Poland,Greece,0,0,Friendly,Gdańsk,Poland,0,32,802,25,899,7,-97,D,1,1,0
2015-06-16 00:00:00.000000,South Africa,Angola,2,1,Friendly,Cape Town,South Africa,0,69,515,88,374,-19,141,W,0,1,0
2015-06-16 00:00:00.000000,Suriname,Nicaragua,1,3,FIFA World Cup qualification,Paramaribo,Suriname,0,150,141,151,138,-1,3,L,2,1,0
2015-06-16 00:00:00.000000,Turkmenistan,Iran,1,1,FIFA World Cup qualification,Daşoguz,Turkmenistan,0,173,99,41,717,132,-618,D,1,1,0
2015-06-16 00:00:00.000000,Yemen,Philippines,0,2,FIFA World Cup qualification,Doha,Qatar,1,165,117,137,183,28,-66,L,2,0,0
2015-06-17 00:00:00.000000,Brazil,Colombia,0,1,Copa América,Santiago,Chile,1,5,1392,4,1435,1,-43,L,2,0,0
2015-06-18 00:00:00.000000,Peru,Venezuela,1,0,Copa América,Valparaíso,Chile,1,61,546,72,497,-11,49,W,0,0,0
2015-06-19 00:00:00.000000,Chile,Bolivia,5,0,Copa América,Santiago,Chile,0,19,989,89,371,-70,618,W,0,1,0
2015-06-19 00:00:00.000000,Mexico,Ecuador,1,2,Copa América,Rancagua,Chile,1,23,926,31,806,-8,120,L,2,0,0
2015-06-20 00:00:00.000000,Argentina,Jamaica,1,0,Copa América,Viña del Mar,Chile,1,3,1496,65,524,-62,972,W,0,0,0
2015-06-20 00:00:00.000000,Mozambique,Seychelles,5,1,African Nations Championship,Beira,Mozambique,0,81,391,187,60,-106,331,W,0,1,0
2015-06-20 00:00:00.000000,Senegal,Gambia,3,1,African Nations Championship,Dakar,Senegal,0,36,782,160,124,-124,658,W,0,1,0
2015-06-20 00:00:00.000000,South Africa,Mauritius,3,0,African Nations Championship,Johannesburg,South Africa,0,69,515,176,90,-107,425,W,0,1,0
2015-06-20 00:00:00.000000,Tanzania,Uganda,0,3,African Nations Championship,Zanzibar,Tanzania,0,127,215,71,504,56,-289,L,2,1,0
2015-06-20 00:00:00.000000,Uruguay,Paraguay,1,1,Copa América,La Serena,Chile,1,8,1183,85,382,-77,801,D,1,0,0
2015-06-21 00:00:00.000000,Brazil,Venezuela,2,1,Copa América,Santiago,Chile,1,5,1392,72,497,-67,895,W,0,0,0
2015-06-21 00:00:00.000000,Colombia,Peru,0,0,Copa América,Temuco,Chile,1,4,1435,61,546,-57,889,D,1,0,0
2015-06-21 00:00:00.000000,Djibouti,Burundi,1,2,African Nations Championship,Djibouti,Djibouti,0,207,4,134,194,73,-190,L,2,1,0
2015-06-21 00:00:00.000000,Ethiopia,Kenya,2,0,African Nations Championship,Bahir Dar,Ethiopia,0,99,324,123,220,-24,104,W,0,1,0
2015-06-21 00:00:00.000000,Lesotho,Botswana,0,0,African Nations Championship,Maseru,Lesotho,0,122,226,111,285,11,-59,D,1,1,0
2015-06-21 00:00:00.000000,Mauritania,Sierra Leone,2,1,African Nations Championship,Nouakchott,Mauritania,0,149,146,83,387,66,-241,W,0,1,0
2015-06-21 00:00:00.000000,Morocco,Libya,3,0,African Nations Championship,Casablanca,Morocco,0,92,369,119,238,-27,131,W,0,1,0
2015-06-21 00:00:00.000000,Namibia,Zambia,2,1,African Nations Championship,Windhoek,Namibia,0,105,303,68,517,37,-214,W,0,1,0
2015-06-21 00:00:00.000000,Swaziland,Angola,2,2,African Nations Championship,Lobamba,Swaziland,0,162,121,88,374,74,-253,D,1,1,0
2015-06-21 00:00:00.000000,Zimbabwe,Comoros,2,0,African Nations Championship,Harare,Zimbabwe,0,119,238,190,44,-71,194,W,0,1,0
2015-06-22 00:00:00.000000,Guinea,Liberia,3,1,African Nations Championship,Bamako,Mali,1,45,673,148,149,-103,524,W,0,0,0
2015-06-24 00:00:00.000000,Chile,Uruguay,1,0,Copa América,Santiago,Chile,0,19,989,8,1183,11,-194,W,0,1,0
2015-06-25 00:00:00.000000,Bolivia,Peru,1,3,Copa América,Temuco,Chile,1,89,371,61,546,28,-175,L,2,0,0
2015-06-26 00:00:00.000000,Argentina,Colombia,0,0,Copa América,Viña del Mar,Chile,1,3,1496,4,1435,-1,61,D,1,0,0
2015-06-27 00:00:00.000000,Brazil,Paraguay,1,1,Copa América,Concepción,Chile,1,5,1392,85,382,-80,1010,D,1,0,0
2015-06-27 00:00:00.000000,Mexico,Costa Rica,2,2,Friendly,Orlando,USA,1,23,926,14,1056,9,-130,D,1,0,0
2015-06-29 00:00:00.000000,Chile,Peru,2,1,Copa América,Santiago,Chile,0,19,989,61,546,-42,443,W,0,1,0
2015-06-30 00:00:00.000000,Argentina,Paraguay,6,1,Copa América,Concepción,Chile,1,3,1496,85,382,-82,1114,W,0,0,0
2015-07-01 00:00:00.000000,Honduras,Mexico,0,0,Friendly,Houston,USA,1,75,462,23,926,52,-464,D,1,0,0
2015-07-03 00:00:00.000000,Peru,Paraguay,2,0,Copa América,Concepción,Chile,1,61,546,85,382,-24,164,W,0,0,0
2015-07-04 00:00:00.000000,Angola,Swaziland,2,0,African Nations Championship,Luanda,Angola,0,88,374,162,121,-74,253,W,0,1,0
2015-07-04 00:00:00.000000,Chile,Argentina,0,0,Copa América,Santiago,Chile,0,19,989,3,1496,16,-507,D,1,1,0
2015-07-04 00:00:00.000000,Zambia,Namibia,2,1,African Nations Championship,Lusaka,Zambia,0,68,517,105,303,-37,214,W,0,1,0
2015-07-06 00:00:00.000000,Malawi,Uganda,1,0,Friendly,Blantyre,Malawi,0,95,345,71,504,24,-159,W,0,1,0
2015-07-07 00:00:00.000000,Panama,Haiti,1,1,Gold Cup,Frisco,USA,1,54,597,76,442,-22,155,D,1,0,0
2015-07-07 00:00:00.000000,USA,Honduras,2,1,Gold Cup,Frisco,USA,0,27,823,75,462,-48,361,W,0,1,0
2015-07-09 00:00:00.000000,Mexico,Cuba,6,0,Gold Cup,Chicago,USA,1,40,697,104,313,-64,384,W,0,0,0
2015-07-09 00:00:00.000000,Trinidad and Tobago,Guatemala,3,1,Gold Cup,Chicago,USA,1,64,543,105,311,-41,232,W,0,0,0
2015-07-10 00:00:00.000000,Honduras,Panama,1,1,Gold Cup,Foxborough,USA,1,80,427,62,549,18,-122,D,1,0,0
2015-07-10 00:00:00.000000,USA,Haiti,1,0,Gold Cup,Foxborough,USA,0,34,748,79,428,-45,320,W,0,1,0
2015-07-11 00:00:00.000000,Costa Rica,El Salvador,1,1,Gold Cup,Houston,USA,1,41,695,88,374,-47,321,D,1,0,0
2015-07-11 00:00:00.000000,Jamaica,Canada,1,0,Gold Cup,Houston,USA,1,76,437,103,328,-27,109,W,0,0,0
2015-07-12 00:00:00.000000,Guatemala,Mexico,0,0,Gold Cup,Glendale,USA,1,105,311,40,697,65,-386,D,1,0,0
2015-07-12 00:00:00.000000,Trinidad and Tobago,Cuba,2,0,Gold Cup,Glendale,USA,1,64,543,104,313,-40,230,W,0,0,0
2015-07-13 00:00:00.000000,Honduras,Haiti,0,1,Gold Cup,Kansas City,USA,1,80,427,79,428,1,-1,L,2,0,0
2015-07-13 00:00:00.000000,USA,Panama,1,1,Gold Cup,Kansas City,USA,0,34,748,62,549,-28,199,D,1,1,0
2015-07-14 00:00:00.000000,Canada,Costa Rica,0,0,Gold Cup,Toronto,Canada,0,103,328,41,695,62,-367,D,1,1,0
2015-07-14 00:00:00.000000,Jamaica,El Salvador,1,0,Gold Cup,Toronto,Canada,1,76,437,88,374,-12,63,W,0,0,0
2015-07-15 00:00:00.000000,Guatemala,Cuba,0,1,Gold Cup,Charlotte,USA,1,105,311,104,313,1,-2,L,2,0,0
2015-07-15 00:00:00.000000,Trinidad and Tobago,Mexico,4,4,Gold Cup,Charlotte,USA,1,64,543,40,697,24,-154,D,1,0,0
2015-07-18 00:00:00.000000,Haiti,Jamaica,0,1,Gold Cup,Baltimore,USA,1,79,428,76,437,3,-9,L,2,0,0
2015-07-18 00:00:00.000000,USA,Cuba,6,0,Gold Cup,Baltimore,USA,0,34,748,104,313,-70,435,W,0,1,0
2015-07-19 00:00:00.000000,Mexico,Costa Rica,1,0,Gold Cup,East Rutherford,USA,1,40,697,41,695,-1,2,W,0,0,0
2015-07-19 00:00:00.000000,Trinidad and Tobago,Panama,1,1,Gold Cup,East Rutherford,USA,1,64,543,62,549,2,-6,D,1,0,0
2015-07-22 00:00:00.000000,Panama,Mexico,1,2,Gold Cup,Atlanta,USA,1,62,549,40,697,22,-148,L,2,0,0
2015-07-22 00:00:00.000000,USA,Jamaica,1,2,Gold Cup,Atlanta,USA,0,34,748,76,437,-42,311,L,2,1,0
2015-07-25 00:00:00.000000,USA,Panama,1,1,Gold Cup,Chester,USA,0,34,748,62,549,-28,199,D,1,1,0
2015-07-26 00:00:00.000000,Jamaica,Mexico,1,3,Gold Cup,Philadelphia,USA,1,76,437,40,697,36,-260,L,2,0,0
2015-08-02 00:00:00.000000,Korea DPR,Japan,2,1,EAFF Championship,Wuhan,China,1,129,222,50,621,79,-399,W,0,0,0
2015-08-09 00:00:00.000000,Korea Republic,Korea DPR,0,0,EAFF Championship,Wuhan,China,1,54,599,124,240,-70,359,D,1,0,0
2015-08-19 00:00:00.000000,Fiji,Tonga,5,0,Friendly,Ba,Fiji,0,198,17,198,17,0,0,W,0,1,0
2015-08-20 00:00:00.000000,Cambodia,Bhutan,2,0,Friendly,Phnom Penh,Cambodia,0,180,66,164,128,16,-62,W,0,1,0
2015-08-26 00:00:00.000000,Lebanon,Iraq,2,3,Friendly,Sidon,Lebanon,0,130,223,85,386,45,-163,L,2,1,0
2015-08-27 00:00:00.000000,Fiji,American Samoa,6,0,Friendly,Nadi,Fiji,0,198,17,200,12,-2,5,W,0,1,0
2015-08-28 00:00:00.000000,Oman,Yemen,1,0,Friendly,Seeb,Oman,0,99,330,174,96,-75,234,W,0,1,0
2015-08-28 00:00:00.000000,Qatar,Singapore,4,0,Friendly,Doha,Qatar,0,95,344,155,162,-60,182,W,0,1,0
2015-08-28 00:00:00.000000,Rwanda,Ethiopia,3,1,Friendly,Kigali,Rwanda,0,91,369,99,330,-8,39,W,0,1,0
2015-08-28 00:00:00.000000,Tanzania,Libya,1,2,Friendly,Kertepe,Turkey,1,140,194,94,345,46,-151,L,2,0,0
2015-08-29 00:00:00.000000,Laos,Cambodia,2,1,Friendly,Bangkok,Thailand,1,177,86,180,66,-3,20,W,0,0,0
2015-08-29 00:00:00.000000,Malaysia,Bangladesh,0,0,Friendly,Shah Alam,Malaysia,0,168,116,170,102,-2,14,D,1,1,0
2015-08-30 00:00:00.000000,Niger,Burkina Faso,0,0,Friendly,Niamey,Niger,0,102,312,71,482,31,-170,D,1,1,0
2015-08-31 00:00:00.000000,India,Nepal,0,0,Friendly,Pune,India,0,156,160,184,57,-28,103,D,1,1,0
2015-08-31 00:00:00.000000,Lebanon,Palestine,0,0,Friendly,Sidon,Lebanon,0,130,223,118,255,12,-32,D,1,1,0
2015-08-31 00:00:00.000000,Samoa,American Samoa,3,2,Oceania Nations Cup qualification,‘Atele,Tonga,1,197,19,200,12,-3,7,W,0,0,0
2015-08-31 00:00:00.000000,Tonga,Cook Islands,0,3,Oceania Nations Cup qualification,‘Atele,Tonga,0,198,17,206,4,-8,13,L,2,1,0
2015-09-01 00:00:00.000000,Congo,Ghana,2,3,Friendly,Brazzaville,Congo,0,43,666,27,827,16,-161,L,2,1,0
2015-09-03 00:00:00.000000,Australia,Bangladesh,5,0,FIFA World Cup qualification,Perth,Australia,0,61,548,173,95,-112,453,W,0,1,0
2015-09-03 00:00:00.000000,Azerbaijan,Croatia,0,0,UEFA Euro qualification,Baku,Azerbaijan,0,110,291,14,1037,96,-746,D,1,1,0
2015-09-03 00:00:00.000000,Bahrain,Korea DPR,0,1,FIFA World Cup qualification,Riffa,Bahrain,0,112,281,126,237,-14,44,L,2,1,0
2015-09-03 00:00:00.000000,Bulgaria,Norway,0,1,UEFA Euro qualification,Sofia,Bulgaria,0,68,503,69,496,-1,7,L,2,1,0
2015-09-03 00:00:00.000000,Cyprus,Wales,0,1,UEFA Euro qualification,Nicosia,Cyprus,0,86,386,9,1146,77,-760,L,2,1,0
2015-09-03 00:00:00.000000,Czech Republic,Kazakhstan,2,1,UEFA Euro qualification,Plzeň,Czech Republic,0,20,940,145,184,-125,756,W,0,1,0
2015-09-03 00:00:00.000000,Iran,Guam,6,0,FIFA World Cup qualification,Teheran,Iran,0,40,716,146,182,-106,534,W,0,1,0
2015-09-03 00:00:00.000000,Israel,Andorra,4,0,UEFA Euro qualification,Haifa,Israel,0,46,635,202,6,-156,629,W,0,1,0
2015-09-03 00:00:00.000000,Italy,Malta,1,0,UEFA Euro qualification,Florence,Italy,0,16,1012,160,154,-144,858,W,0,1,0
2015-09-03 00:00:00.000000,Japan,Cambodia,3,0,FIFA World Cup qualification,Saitama,Japan,0,58,570,180,66,-122,504,W,0,1,0
2015-09-03 00:00:00.000000,Korea Republic,Laos,8,0,FIFA World Cup qualification,Hwaseong,Korea Republic,0,57,574,174,92,-117,482,W,0,1,0
2015-09-03 00:00:00.000000,Netherlands,Iceland,0,1,UEFA Euro qualification,Amsterdam,Netherlands,0,12,1054,23,894,-11,160,L,2,1,0
2015-09-03 00:00:00.000000,Oman,Turkmenistan,3,1,FIFA World Cup qualification,Seeb,Oman,0,100,329,149,172,-49,157,W,0,1,0
2015-09-03 00:00:00.000000,Philippines,Maldives,2,0,Friendly,Manila,Philippines,0,125,241,177,82,-52,159,W,0,1,0
2015-09-03 00:00:00.000000,Qatar,Bhutan,15,0,FIFA World Cup qualification,Doha,Qatar,0,94,347,164,128,-70,219,W,0,1,0
2015-09-03 00:00:00.000000,Syria,Singapore,1,0,FIFA World Cup qualification,Muscat,Oman,1,121,251,157,159,-36,92,W,0,0,0
2015-09-03 00:00:00.000000,Thailand,Afghanistan,2,0,Friendly,Bangkok,Thailand,0,137,201,130,226,7,-25,W,0,1,0
2015-09-03 00:00:00.000000,Turkey,Latvia,1,1,UEFA Euro qualification,Konya,Turkey,0,46,635,90,366,-44,269,D,1,1,0
2015-09-03 00:00:00.000000,United Arab Emirates,Malaysia,10,0,FIFA World Cup qualification,Abu Dhabi,United Arab Emirates,0,70,484,169,115,-99,369,W,0,1,0
2015-09-03 00:00:00.000000,Uzbekistan,Yemen,1,0,FIFA World Cup qualification,Tashkent,Uzbekistan,0,76,453,175,90,-99,363,W,0,1,0
2015-09-04 00:00:00.000000,American Samoa,Cook Islands,2,0,Oceania Nations Cup qualification,‘Atele,Tonga,1,199,17,205,4,-6,13,W,0,0,0
2015-09-04 00:00:00.000000,Curaçao,El Salvador,0,1,FIFA World Cup qualification,Willemstad,Curaçao,0,148,178,107,300,41,-122,L,2,1,0
2015-09-04 00:00:00.000000,Denmark,Albania,0,0,UEFA Euro qualification,Copenhagen,Denmark,0,22,901,25,878,-3,23,D,1,1,0
2015-09-04 00:00:00.000000,Djibouti,Togo,0,2,African Cup of Nations qualification,Djibouti,Djibouti,0,205,4,79,418,126,-414,L,2,1,0
2015-09-04 00:00:00.000000,Faroe Islands,Northern Ireland,1,3,UEFA Euro qualification,Tórshavn,Faroe Islands,0,75,459,41,687,34,-228,L,2,1,0
2015-09-04 00:00:00.000000,Georgia,Scotland,1,0,UEFA Euro qualification,Tbilisi,Georgia,0,147,180,31,789,116,-609,W,0,1,0
2015-09-04 00:00:00.000000,Germany,Poland,3,1,UEFA Euro qualification,Frankfurt am Main,Germany,0,3,1248,34,764,-31,484,W,0,1,0
2015-09-04 00:00:00.000000,Greece,Finland,0,1,UEFA Euro qualification,Piraeus,Greece,0,44,657,92,351,-48,306,L,2,1,0
2015-09-04 00:00:00.000000,Grenada,Haiti,1,3,FIFA World Cup qualification,St. George's,Grenada,0,158,155,87,385,71,-230,L,2,1,0
2015-09-04 00:00:00.000000,Hungary,Romania,0,0,UEFA Euro qualification,Budapest,Hungary,0,37,740,7,1176,30,-436,D,1,1,0
2015-09-04 00:00:00.000000,Portugal,France,0,1,Friendly,Lisbon,Portugal,0,6,1186,24,893,-18,293,L,2,1,0
2015-09-04 00:00:00.000000,Serbia,Armenia,2,0,UEFA Euro qualification,Novi Sad,Serbia,0,66,528,83,394,-17,134,W,0,1,0
2015-09-04 00:00:00.000000,Tonga,Samoa,0,3,Oceania Nations Cup qualification,‘Atele,Tonga,0,199,17,196,25,3,-8,L,2,1,0
2015-09-04 00:00:00.000000,Venezuela,Honduras,0,3,Friendly,Puerto Ordaz,Venezuela,0,50,613,81,404,-31,209,L,2,1,0
2015-09-05 00:00:00.000000,Austria,Moldova,1,0,UEFA Euro qualification,Vienna,Austria,0,13,1038,124,245,-111,793,W,0,1,0
2015-09-05 00:00:00.000000,Botswana,Burkina Faso,1,0,African Cup of Nations qualification,Francistown,Botswana,0,118,266,73,468,45,-202,W,0,1,0
2015-09-05 00:00:00.000000,Chile,Paraguay,3,2,Friendly,Santiago,Chile,0,8,1149,55,592,-47,557,W,0,1,0
2015-09-05 00:00:00.000000,Comoros,Uganda,0,1,African Cup of Nations qualification,Mitsamiouli,Comoros,0,190,48,71,478,119,-430,L,2,1,0
2015-09-05 00:00:00.000000,Costa Rica,Brazil,0,1,Friendly,Harrison,USA,1,39,731,5,1209,34,-478,L,2,0,0
2015-09-05 00:00:00.000000,Estonia,Lithuania,1,0,UEFA Euro qualification,Tallinn,Estonia,0,80,405,109,294,-29,111,W,0,1,0
2015-09-05 00:00:00.000000,Gabon,Sudan,4,0,Friendly,Libreville,Gabon,0,63,535,89,377,-26,158,W,0,1,0
2015-09-05 00:00:00.000000,Guinea-Bissau,Congo,2,4,African Cup of Nations qualification,Bissau,Guinea-Bissau,0,142,191,42,671,100,-480,L,2,1,0
2015-09-05 00:00:00.000000,Liberia,Tunisia,1,0,African Cup of Nations qualification,Monrovia,Liberia,0,160,154,33,774,127,-620,W,0,1,0
2015-09-05 00:00:00.000000,Mauritania,South Africa,3,1,African Cup of Nations qualification,Nouakchott,Mauritania,0,114,273,72,469,42,-196,W,0,1,0
2015-09-05 00:00:00.000000,Montenegro,Liechtenstein,2,0,UEFA Euro qualification,Podgorica,Montenegro,0,77,430,150,171,-73,259,W,0,1,0
2015-09-05 00:00:00.000000,Namibia,Senegal,0,2,African Cup of Nations qualification,Windhoek,Namibia,0,111,284,38,734,73,-450,L,2,1,0
2015-09-05 00:00:00.000000,Russia,Sweden,1,0,UEFA Euro qualification,Moscow,Russia,0,32,780,36,756,-4,24,W,0,1,0
2015-09-05 00:00:00.000000,Rwanda,Ghana,0,1,African Cup of Nations qualification,Kigali,Rwanda,0,78,426,27,827,51,-401,L,2,1,0
2015-09-05 00:00:00.000000,San Marino,England,0,6,UEFA Euro qualification,Serravalle,San Marino,0,193,40,10,1143,183,-1103,L,2,1,0
2015-09-05 00:00:00.000000,Seychelles,Ethiopia,1,1,African Cup of Nations qualification,Victoria,Seychelles,0,192,43,103,313,89,-270,D,1,1,0
2015-09-05 00:00:00.000000,South Sudan,Equatorial Guinea,1,0,African Cup of Nations qualification,Juba,South Sudan,0,198,22,62,546,136,-524,W,0,1,0
2015-09-05 00:00:00.000000,Spain,Slovakia,2,0,UEFA Euro qualification,Oviedo,Spain,0,11,1122,15,1013,-4,109,W,0,1,0
2015-09-05 00:00:00.000000,Switzerland,Slovenia,3,2,UEFA Euro qualification,Basel,Switzerland,0,17,1011,45,653,-28,358,W,0,1,0
2015-09-05 00:00:00.000000,Tanzania,Nigeria,0,0,African Cup of Nations qualification,Dar es Salaam,Tanzania,0,140,195,53,599,87,-404,D,1,1,0
2015-09-05 00:00:00.000000,Ukraine,Belarus,3,1,UEFA Euro qualification,L'viv,Ukraine,0,29,812,97,335,-68,477,W,0,1,0
2015-09-06 00:00:00.000000,Central African Republic,Congo DR,2,0,African Cup of Nations qualification,Bangui,Central African Republic,0,168,118,65,529,103,-411,W,0,1,0
2015-09-06 00:00:00.000000,Chad,Egypt,1,5,African Cup of Nations qualification,N'Djamena,Chad,0,171,100,49,619,122,-519,L,2,1,0
2015-09-06 00:00:00.000000,Cyprus,Belgium,0,1,UEFA Euro qualification,Nicosia,Cyprus,0,86,386,2,1269,84,-883,L,2,1,0
2015-09-06 00:00:00.000000,Iceland,Kazakhstan,0,0,UEFA Euro qualification,Reykjavík,Iceland,0,23,894,145,184,-122,710,D,1,1,0
2015-09-06 00:00:00.000000,Italy,Bulgaria,1,0,UEFA Euro qualification,Palermo,Italy,0,16,1012,68,503,-52,509,W,0,1,0
2015-09-06 00:00:00.000000,Latvia,Czech Republic,1,2,UEFA Euro qualification,Riga,Latvia,0,90,366,20,940,70,-574,L,2,1,0
2015-09-06 00:00:00.000000,Lesotho,Algeria,1,3,African Cup of Nations qualification,Maseru,Lesotho,0,128,227,19,955,109,-728,L,2,1,0
2015-09-06 00:00:00.000000,Madagascar,Angola,0,0,African Cup of Nations qualification,Antananarivo,Madagascar,0,121,251,88,381,33,-130,D,1,1,0
2015-09-06 00:00:00.000000,Malta,Azerbaijan,2,2,UEFA Euro qualification,Attard,Malta,0,160,154,110,291,50,-137,D,1,1,0
2015-09-06 00:00:00.000000,Mauritius,Mozambique,1,0,African Cup of Nations qualification,Curepipe,Mauritius,0,185,56,95,340,90,-284,W,0,1,0
2015-09-06 00:00:00.000000,Norway,Croatia,2,0,UEFA Euro qualification,Oslo,Norway,0,69,496,14,1037,55,-541,W,0,1,0
2015-09-06 00:00:00.000000,Swaziland,Malawi,2,2,African Cup of Nations qualification,Lobamba,Swaziland,0,135,213,96,336,39,-123,D,1,1,0
2015-09-06 00:00:00.000000,Turkey,Netherlands,3,0,UEFA Euro qualification,Konya,Turkey,0,46,635,12,1054,34,-419,W,0,1,0
2015-09-06 00:00:00.000000,Wales,Israel,0,0,UEFA Euro qualification,Cardiff,Wales,0,9,1146,46,635,-37,511,D,1,1,0
2015-09-07 00:00:00.000000,Albania,Portugal,0,1,UEFA Euro qualification,Elbasan,Albania,0,25,878,6,1186,19,-308,L,2,1,0
2015-09-07 00:00:00.000000,Armenia,Denmark,0,0,UEFA Euro qualification,Yerevan,Armenia,0,83,394,22,901,61,-507,D,1,1,0
2015-09-07 00:00:00.000000,Finland,Faroe Islands,1,0,UEFA Euro qualification,Helsinki,Finland,0,92,351,75,459,17,-108,W,0,1,0
2015-09-07 00:00:00.000000,France,Serbia,2,1,Friendly,Bordeaux,France,0,24,893,66,528,-42,365,W,0,1,0
2015-09-07 00:00:00.000000,Northern Ireland,Hungary,1,1,UEFA Euro qualification,Belfast,Northern Ireland,0,41,687,37,740,4,-53,D,1,1,0
2015-09-07 00:00:00.000000,Romania,Greece,0,0,UEFA Euro qualification,Bucharest,Romania,0,7,1176,44,657,-37,519,D,1,1,0
2015-09-07 00:00:00.000000,Scotland,Germany,2,3,UEFA Euro qualification,Glasgow,Scotland,0,31,789,3,1248,28,-459,L,2,1,0
2015-09-08 00:00:00.000000,Afghanistan,Japan,0,6,FIFA World Cup qualification,Teheran,Iran,1,130,226,58,570,72,-344,L,2,0,0
2015-09-08 00:00:00.000000,Bangladesh,Jordan,0,4,FIFA World Cup qualification,Dhaka,Bangladesh,0,173,95,91,356,82,-261,L,2,1,0
2015-09-08 00:00:00.000000,Belarus,Luxembourg,2,0,UEFA Euro qualification,Barysaw,Belarus,0,97,335,141,194,-44,141,W,0,1,0
2015-09-08 00:00:00.000000,Cambodia,Syria,0,6,FIFA World Cup qualification,Phnom Penh,Cambodia,0,180,66,121,251,59,-185,L,2,1,0
2015-09-08 00:00:00.000000,Ecuador,Honduras,2,0,Friendly,Quito,Ecuador,0,34,764,81,404,-47,360,W,0,1,0
2015-09-08 00:00:00.000000,El Salvador,Curaçao,1,0,FIFA World Cup qualification,San Salvador,El Salvador,0,107,300,148,178,-41,122,W,0,1,0
2015-09-08 00:00:00.000000,England,Switzerland,2,0,UEFA Euro qualification,London,England,0,10,1143,17,1011,-7,132,W,0,1,0
2015-09-08 00:00:00.000000,Guam,Oman,0,0,FIFA World Cup qualification,Dededo,Guam,0,146,182,100,329,46,-147,D,1,1,0
2015-09-08 00:00:00.000000,Hong Kong,Qatar,2,3,FIFA World Cup qualification,Kowloon,Hong Kong,0,151,169,94,347,57,-178,L,2,1,0
2015-09-08 00:00:00.000000,India,Iran,0,3,FIFA World Cup qualification,Bangalore,India,0,155,160,40,716,115,-556,L,2,1,0
2015-09-08 00:00:00.000000,Laos,Kuwait,0,2,FIFA World Cup qualification,Vientiane,Laos,0,174,92,127,235,47,-143,L,2,1,0
2015-09-08 00:00:00.000000,Lebanon,Korea Republic,0,3,FIFA World Cup qualification,Sidon,Lebanon,0,133,219,57,574,76,-355,L,2,1,0
2015-09-08 00:00:00.000000,Liechtenstein,Russia,0,7,UEFA Euro qualification,Vaduz,Liechtenstein,0,150,171,32,780,118,-609,L,2,1,0
2015-09-08 00:00:00.000000,Lithuania,San Marino,2,1,UEFA Euro qualification,Vilnius,Lithuania,0,109,294,193,40,-84,254,W,0,1,0
2015-09-08 00:00:00.000000,Malaysia,Saudi Arabia,0,3,FIFA World Cup qualification,Shah Alam,Malaysia,0,169,115,93,350,76,-235,L,2,1,0
2015-09-08 00:00:00.000000,Mexico,Argentina,2,2,Friendly,Arlington,USA,1,26,848,1,1442,25,-594,D,1,0,0
2015-09-08 00:00:00.000000,Moldova,Montenegro,0,2,UEFA Euro qualification,Chișinău,Moldova,0,124,245,77,430,47,-185,L,2,1,0
2015-09-08 00:00:00.000000,Nigeria,Niger,2,0,Friendly,Port Harcourt,Nigeria,0,53,599,101,326,-48,273,W,0,1,0
2015-09-08 00:00:00.000000,Palestine,United Arab Emirates,0,0,FIFA World Cup qualification,al-Ramm,Palestine,0,119,256,70,484,49,-228,D,1,1,0
2015-09-08 00:00:00.000000,Philippines,Uzbekistan,1,5,FIFA World Cup qualification,Bocaue,Philippines,0,125,241,76,453,49,-212,L,2,1,0
2015-09-08 00:00:00.000000,Slovakia,Ukraine,0,0,UEFA Euro qualification,Žilina,Slovakia,0,15,1013,29,812,-14,201,D,1,1,0
2015-09-08 00:00:00.000000,Slovenia,Estonia,1,0,UEFA Euro qualification,Maribor,Slovenia,0,45,653,80,405,-35,248,W,0,1,0
2015-09-08 00:00:00.000000,South Africa,Senegal,1,0,Friendly,Johannesburg,South Africa,0,72,469,38,734,34,-265,W,0,1,0
2015-09-08 00:00:00.000000,Sweden,Austria,1,4,UEFA Euro qualification,Solna,Sweden,0,36,756,13,1038,23,-282,L,2,1,0
2015-09-08 00:00:00.000000,Tajikistan,Australia,0,3,FIFA World Cup qualification,Dushanbe,Tajikistan,0,158,155,61,548,97,-393,L,2,1,0
2015-09-08 00:00:00.000000,Thailand,Iraq,2,2,FIFA World Cup qualification,Bangkok,Thailand,0,137,201,82,399,55,-198,D,1,1,0
2015-09-08 00:00:00.000000,Venezuela,Panama,1,1,Friendly,Puerto Ordaz,Venezuela,0,50,613,59,551,-9,62,D,1,1,0
2015-09-08 00:00:00.000000,Yemen,Bahrain,0,4,FIFA World Cup qualification,Doha,Qatar,1,175,90,112,281,63,-191,L,2,0,0
2015-09-08 00:00:00.000000,Zambia,Gabon,1,1,Friendly,Lusaka,Zambia,0,74,464,63,535,11,-71,D,1,1,0
2015-09-12 00:00:00.000000,Rwanda,Gabon,0,1,Friendly,Kigali,Rwanda,0,78,426,63,535,15,-109,L,2,1,0
2015-10-02 00:00:00.000000,Oman,Syria,2,1,Friendly,Muscat,Oman,0,102,338,123,283,-21,55,W,0,1,0
2015-10-03 00:00:00.000000,Jordan,Iraq,3,0,Friendly,Amman,Jordan,0,99,348,85,396,14,-48,W,0,1,0
2015-10-07 00:00:00.000000,Comoros,Lesotho,0,0,FIFA World Cup qualification,Moroni,Comoros,0,193,48,140,201,53,-153,D,1,1,0
2015-10-07 00:00:00.000000,Mauritius,Kenya,2,5,FIFA World Cup qualification,Mapou,Mauritius,0,168,123,131,245,37,-122,L,2,1,0
2015-10-07 00:00:00.000000,Seychelles,Burundi,0,1,FIFA World Cup qualification,Roche Caiman,Seychelles,0,184,67,113,302,71,-235,L,2,1,0
2015-10-07 00:00:00.000000,South Sudan,Mauritania,1,1,FIFA World Cup qualification,Juba,South Sudan,0,144,198,89,379,55,-181,D,1,1,0
2015-10-07 00:00:00.000000,Tanzania,Malawi,2,0,FIFA World Cup qualification,Dar es Salaam,Tanzania,0,136,218,101,339,35,-121,W,0,1,0
2015-10-08 00:00:00.000000,Albania,Serbia,0,2,UEFA Euro qualification,Elbasan,Albania,0,32,755,63,538,-31,217,L,2,1,0
2015-10-08 00:00:00.000000,Argentina,Ecuador,0,2,FIFA World Cup qualification,Buenos Aires,Argentina,0,1,1419,31,765,-30,654,L,2,1,0
2015-10-08 00:00:00.000000,Bahrain,Uzbekistan,0,4,FIFA World Cup qualification,Riffa,Bahrain,0,123,283,74,464,49,-181,L,2,1,0
2015-10-08 00:00:00.000000,Bhutan,Maldives,3,4,FIFA World Cup qualification,Thimphu,Bhutan,0,173,106,176,96,-3,10,L,2,1,0
2015-10-08 00:00:00.000000,Bolivia,Uruguay,0,0,FIFA World Cup qualification,La Paz,Bolivia,0,67,510,20,919,47,-409,D,1,1,0
2015-10-08 00:00:00.000000,Chile,Brazil,2,0,FIFA World Cup qualification,Santiago,Chile,0,9,1177,7,1204,2,-27,W,0,1,0
2015-10-08 00:00:00.000000,Colombia,Peru,2,0,FIFA World Cup qualification,Barranquilla,Colombia,0,5,1228,50,623,-45,605,W,0,1,0
2015-10-08 00:00:00.000000,France,Armenia,4,0,Friendly,Nice,France,0,22,899,91,377,-69,522,W,0,1,0
2015-10-08 00:00:00.000000,Hungary,Faroe Islands,2,1,UEFA Euro qualification,Budapest,Hungary,0,33,741,85,396,-52,345,W,0,1,0
2015-10-08 00:00:00.000000,Jordan,Australia,2,0,FIFA World Cup qualification,Amman,Jordan,0,99,348,58,567,41,-219,W,0,1,0
2015-10-08 00:00:00.000000,Korea DPR,Philippines,0,0,FIFA World Cup qualification,P'yŏngyang,Korea DPR,0,129,252,134,238,-5,14,D,1,1,0
2015-10-08 00:00:00.000000,Kuwait,Korea Republic,0,1,FIFA World Cup qualification,Kuwait City,Kuwait,0,128,260,53,590,75,-330,L,2,1,0
2015-10-08 00:00:00.000000,Laos,Malaysia,1,3,Friendly,Pathum Thani,Thailand,1,179,85,171,111,8,-26,L,2,0,0
2015-10-08 00:00:00.000000,Liberia,Guinea-Bissau,1,1,FIFA World Cup qualification,Monrovia,Liberia,0,95,360,147,193,-52,167,D,1,1,0
2015-10-08 00:00:00.000000,Nigeria,Congo DR,0,2,Friendly,Visé,Belgium,1,52,600,60,563,-8,37,L,2,0,0
2015-10-08 00:00:00.000000,Northern Ireland,Greece,3,1,UEFA Euro qualification,Belfast,Northern Ireland,0,35,724,44,676,-9,48,W,0,1,0
2015-10-08 00:00:00.000000,Oman,Iran,1,1,FIFA World Cup qualification,Muscat,Oman,0,102,338,39,703,63,-365,D,1,1,0
2015-10-08 00:00:00.000000,Portugal,Denmark,1,0,UEFA Euro qualification,Braga,Portugal,0,4,1235,28,835,-24,400,W,0,1,0
2015-10-08 00:00:00.000000,Romania,Finland,1,1,UEFA Euro qualification,Bucharest,Romania,0,13,1042,64,534,-51,508,D,1,1,0
2015-10-08 00:00:00.000000,Saudi Arabia,United Arab Emirates,2,1,FIFA World Cup qualification,Jeddah,Saudi Arabia,0,88,384,70,491,18,-107,W,0,1,0
2015-10-08 00:00:00.000000,Scotland,Poland,2,2,UEFA Euro qualification,Glasgow,Scotland,0,40,702,43,680,-3,22,D,1,1,0
2015-10-08 00:00:00.000000,Singapore,Afghanistan,1,0,FIFA World Cup qualification,Kallang,Singapore,0,157,164,150,183,7,-19,W,0,1,0
2015-10-08 00:00:00.000000,Syria,Japan,0,3,FIFA World Cup qualification,Seeb,Oman,1,123,283,55,582,68,-299,L,2,0,0
2015-10-08 00:00:00.000000,Turkmenistan,India,2,1,FIFA World Cup qualification,Ashgabat,Turkmenistan,0,155,172,167,128,-12,44,W,0,1,0
2015-10-08 00:00:00.000000,Venezuela,Paraguay,0,1,FIFA World Cup qualification,Ciudad Guayana,Venezuela,0,69,501,61,552,8,-51,L,2,1,0
2015-10-08 00:00:00.000000,Vietnam,Iraq,1,1,FIFA World Cup qualification,Hanoi,Vietnam,0,149,187,85,396,64,-209,D,1,1,0
2015-10-09 00:00:00.000000,Algeria,Guinea,1,2,Friendly,Algiers,Algeria,0,19,927,55,582,-36,345,L,2,1,0
2015-10-09 00:00:00.000000,Burkina Faso,Mali,1,4,Friendly,Troyes,France,1,76,427,62,546,14,-119,L,2,0,0
2015-10-09 00:00:00.000000,Djibouti,Swaziland,0,6,FIFA World Cup qualification,Djibouti,Djibouti,0,206,4,135,224,71,-220,L,2,1,0
2015-10-09 00:00:00.000000,England,Estonia,2,0,UEFA Euro qualification,London,England,0,10,1161,87,388,-77,773,W,0,1,0
2015-10-09 00:00:00.000000,Gambia,Namibia,1,1,FIFA World Cup qualification,Bakau,Gambia,0,161,154,125,274,36,-120,D,1,1,0
2015-10-09 00:00:00.000000,Liechtenstein,Sweden,0,2,UEFA Euro qualification,Vaduz,Liechtenstein,0,156,170,45,672,111,-502,L,2,1,0
2015-10-09 00:00:00.000000,Moldova,Russia,1,2,UEFA Euro qualification,Chișinău,Moldova,0,132,239,26,845,106,-606,L,2,1,0
2015-10-09 00:00:00.000000,Montenegro,Austria,2,3,UEFA Euro qualification,Podgorica,Montenegro,0,72,470,11,1100,61,-630,L,2,1,0
2015-10-09 00:00:00.000000,Slovakia,Belarus,0,1,UEFA Euro qualification,Žilina,Slovakia,0,18,936,98,350,-80,586,L,2,1,0
2015-10-09 00:00:00.000000,Slovenia,Lithuania,1,1,UEFA Euro qualification,Ljubljana,Slovenia,0,46,662,116,298,-70,364,D,1,1,0
2015-10-09 00:00:00.000000,Somalia,Niger,0,2,FIFA World Cup qualification,Addis Abeba,Ethiopia,1,203,6,120,287,83,-281,L,2,0,0
2015-10-09 00:00:00.000000,Spain,Luxembourg,4,0,UEFA Euro qualification,Logroño,Spain,0,6,1223,142,199,-136,1024,W,0,1,0
2015-10-09 00:00:00.000000,Switzerland,San Marino,7,0,UEFA Euro qualification,St. Gallen,Switzerland,0,12,1044,196,35,-184,1009,W,0,1,0
2015-10-09 00:00:00.000000,Thailand,Hong Kong,1,0,Friendly,Bangkok,Thailand,0,145,196,153,180,-8,16,W,0,1,0
2015-10-09 00:00:00.000000,Tunisia,Gabon,3,3,Friendly,Radès,Tunisia,0,36,722,65,529,-29,193,D,1,1,0
2015-10-10 00:00:00.000000,Andorra,Belgium,1,4,UEFA Euro qualification,Sant Julià de Lòria,Andorra,0,205,5,3,1387,202,-1382,L,2,1,0
2015-10-10 00:00:00.000000,Azerbaijan,Italy,1,3,UEFA Euro qualification,Baku,Azerbaijan,0,105,328,17,962,88,-634,L,2,1,0
2015-10-10 00:00:00.000000,Chad,Sierra Leone,1,0,FIFA World Cup qualification,N'Djamena,Chad,0,175,100,121,286,54,-186,W,0,1,0
2015-10-10 00:00:00.000000,Croatia,Bulgaria,3,0,UEFA Euro qualification,Zagreb,Croatia,0,16,965,78,414,-62,551,W,0,1,0
2015-10-10 00:00:00.000000,Czech Republic,Turkey,0,2,UEFA Euro qualification,Prague,Czech Republic,0,15,983,37,717,-22,266,L,2,1,0
2015-10-10 00:00:00.000000,Eritrea,Botswana,0,2,FIFA World Cup qualification,Asmara,Eritrea,0,202,8,111,305,91,-297,L,2,1,0
2015-10-10 00:00:00.000000,Iceland,Latvia,2,2,UEFA Euro qualification,Reykjavík,Iceland,0,23,882,103,335,-80,547,D,1,1,0
2015-10-10 00:00:00.000000,Israel,Cyprus,1,2,UEFA Euro qualification,Jerusalem,Israel,0,47,659,114,300,-67,359,L,2,1,0
2015-10-10 00:00:00.000000,Kazakhstan,Netherlands,1,2,UEFA Euro qualification,Astana,Kazakhstan,0,142,199,14,1004,128,-805,L,2,1,0
2015-10-10 00:00:00.000000,Madagascar,Central African Republic,3,0,FIFA World Cup qualification,Antananarivo,Madagascar,0,127,262,126,271,1,-9,W,0,1,0
2015-10-10 00:00:00.000000,Norway,Malta,2,0,UEFA Euro qualification,Oslo,Norway,0,34,739,157,164,-123,575,W,0,1,0
2015-10-10 00:00:00.000000,USA,Mexico,2,3,Friendly,Pasadena,USA,0,29,807,27,842,2,-35,L,2,1,0
2015-10-11 00:00:00.000000,Armenia,Albania,0,3,UEFA Euro qualification,Yerevan,Armenia,0,91,377,32,755,59,-378,L,2,1,0
2015-10-11 00:00:00.000000,Denmark,France,1,2,Friendly,Copenhagen,Denmark,0,28,835,22,899,6,-64,L,2,1,0
2015-10-11 00:00:00.000000,Egypt,Zambia,3,0,Friendly,Abu Dhabi,United Arab Emirates,1,51,620,71,487,-20,133,W,0,0,0
2015-10-11 00:00:00.000000,Faroe Islands,Romania,0,3,UEFA Euro qualification,Tórshavn,Faroe Islands,0,85,396,13,1042,72,-646,L,2,1,0
2015-10-11 00:00:00.000000,Finland,Northern Ireland,1,1,UEFA Euro qualification,Helsinki,Finland,0,64,534,35,724,29,-190,D,1,1,0
2015-10-11 00:00:00.000000,Germany,Georgia,2,1,UEFA Euro qualification,Leipzig,Germany,0,2,1401,110,308,-108,1093,W,0,1,0
2015-10-11 00:00:00.000000,Greece,Hungary,4,3,UEFA Euro qualification,Piraeus,Greece,0,44,676,33,741,11,-65,W,0,1,0
2015-10-11 00:00:00.000000,Kenya,Mauritius,0,0,FIFA World Cup qualification,Nairobi,Kenya,0,131,245,168,123,-37,122,D,1,1,0
2015-10-11 00:00:00.000000,Malawi,Tanzania,1,0,FIFA World Cup qualification,Blantyre,Malawi,0,101,339,136,218,-35,121,W,0,1,0
2015-10-11 00:00:00.000000,Nigeria,Cameroon,3,0,Friendly,Brussels,Belgium,1,52,600,48,640,4,-40,W,0,0,0
2015-10-11 00:00:00.000000,Serbia,Portugal,1,2,UEFA Euro qualification,Belgrade,Serbia,0,63,538,4,1235,59,-697,L,2,1,0
2015-10-12 00:00:00.000000,Austria,Liechtenstein,3,0,UEFA Euro qualification,Vienna,Austria,0,11,1100,156,170,-145,930,W,0,1,0
2015-10-12 00:00:00.000000,Estonia,Switzerland,0,1,UEFA Euro qualification,Tallinn,Estonia,0,87,388,12,1044,75,-656,L,2,1,0
2015-10-12 00:00:00.000000,Gabon,Congo DR,1,2,Friendly,Mons,Belgium,1,65,529,60,563,5,-34,L,2,0,0
2015-10-12 00:00:00.000000,Lithuania,England,0,3,UEFA Euro qualification,Vilnius,Lithuania,0,116,298,10,1161,106,-863,L,2,1,0
2015-10-12 00:00:00.000000,Luxembourg,Slovakia,2,4,UEFA Euro qualification,Luxembourg,Luxembourg,0,142,199,18,936,124,-737,L,2,1,0
2015-10-12 00:00:00.000000,Morocco,Guinea,1,1,Friendly,Agadir,Morocco,0,80,407,55,582,25,-175,D,1,1,0
2015-10-12 00:00:00.000000,Russia,Montenegro,2,0,UEFA Euro qualification,Moscow,Russia,0,26,845,72,470,-46,375,W,0,1,0
2015-10-12 00:00:00.000000,San Marino,Slovenia,0,2,UEFA Euro qualification,Serravalle,San Marino,0,196,35,46,662,150,-627,L,2,1,0
2015-10-12 00:00:00.000000,Sweden,Moldova,2,0,UEFA Euro qualification,Solna,Sweden,0,45,672,132,239,-87,433,W,0,1,0
2015-10-12 00:00:00.000000,Ukraine,Spain,0,1,UEFA Euro qualification,Kyïv,Ukraine,0,24,874,6,1223,18,-349,L,2,1,0
2015-10-13 00:00:00.000000,Algeria,Senegal,1,0,Friendly,Algiers,Algeria,0,19,927,38,713,-19,214,W,0,1,0
2015-10-13 00:00:00.000000,Bahrain,Philippines,2,0,FIFA World Cup qualification,Riffa,Bahrain,0,123,283,134,238,-11,45,W,0,1,0
2015-10-13 00:00:00.000000,Belgium,Israel,3,1,UEFA Euro qualification,Brussels,Belgium,0,3,1387,47,659,-44,728,W,0,1,0
2015-10-13 00:00:00.000000,Bhutan,Hong Kong,0,1,FIFA World Cup qualification,Thimphu,Bhutan,0,173,106,153,180,20,-74,L,2,1,0
2015-10-13 00:00:00.000000,Botswana,Eritrea,3,1,FIFA World Cup qualification,Francistown,Botswana,0,111,305,202,8,-91,297,W,0,1,0
2015-10-13 00:00:00.000000,Brazil,Venezuela,3,1,FIFA World Cup qualification,Fortaleza,Brazil,0,7,1204,69,501,-62,703,W,0,1,0
2015-10-13 00:00:00.000000,Bulgaria,Azerbaijan,2,0,UEFA Euro qualification,Sofia,Bulgaria,0,78,414,105,328,-27,86,W,0,1,0
2015-10-13 00:00:00.000000,Burundi,Seychelles,2,0,FIFA World Cup qualification,Bujumbura,Burundi,0,113,302,184,67,-71,235,W,0,1,0
2015-10-13 00:00:00.000000,Congo,Benin,2,1,Friendly,Brazzaville,Congo,0,49,636,100,341,-51,295,W,0,1,0
2015-10-13 00:00:00.000000,Ecuador,Bolivia,2,0,FIFA World Cup qualification,Quito,Ecuador,0,31,765,67,510,-36,255,W,0,1,0
2015-10-13 00:00:00.000000,El Salvador,Guatemala,1,1,Friendly,Carson,USA,1,94,363,82,401,12,-38,D,1,0,0
2015-10-13 00:00:00.000000,Guinea-Bissau,Liberia,1,3,FIFA World Cup qualification,Bissau,Guinea-Bissau,0,147,193,95,360,52,-167,L,2,1,0
2015-10-13 00:00:00.000000,Iran,Japan,1,1,Friendly,Teheran,Iran,0,39,703,55,582,-16,121,D,1,1,0
2015-10-13 00:00:00.000000,Italy,Norway,2,1,UEFA Euro qualification,Rome,Italy,0,17,962,34,739,-17,223,W,0,1,0
2015-10-13 00:00:00.000000,Jordan,Tajikistan,3,0,FIFA World Cup qualification,Irbid,Jordan,0,99,348,160,156,-61,192,W,0,1,0
2015-10-13 00:00:00.000000,Korea DPR,Yemen,1,0,FIFA World Cup qualification,P'yŏngyang,Korea DPR,0,129,252,180,82,-51,170,W,0,1,0
2015-10-13 00:00:00.000000,Korea Republic,Jamaica,3,0,Friendly,Seoul,Korea Republic,0,53,590,57,576,-4,14,W,0,1,0
2015-10-13 00:00:00.000000,Kuwait,Lebanon,0,0,FIFA World Cup qualification,Kuwait City,Kuwait,0,128,260,140,201,-12,59,D,1,1,0
2015-10-13 00:00:00.000000,Latvia,Kazakhstan,0,1,UEFA Euro qualification,Riga,Latvia,0,103,335,142,199,-39,136,L,2,1,0
2015-10-13 00:00:00.000000,Lesotho,Comoros,1,1,FIFA World Cup qualification,Maseru,Lesotho,0,140,201,193,48,-53,153,D,1,1,0
2015-10-13 00:00:00.000000,Madagascar,Central African Republic,2,2,FIFA World Cup qualification,Antananarivo,Madagascar,0,127,262,126,271,1,-9,D,1,1,0
2015-10-13 00:00:00.000000,Malta,Croatia,0,1,UEFA Euro qualification,Attard,Malta,0,157,164,16,965,141,-801,L,2,1,0
2015-10-13 00:00:00.000000,Mauritania,South Sudan,4,0,FIFA World Cup qualification,Nouakchott,Mauritania,0,89,379,144,198,-55,181,W,0,1,0
2015-10-13 00:00:00.000000,Namibia,Gambia,2,1,FIFA World Cup qualification,Windhoek,Namibia,0,125,274,161,154,-36,120,W,0,1,0
2015-10-13 00:00:00.000000,Netherlands,Czech Republic,2,3,UEFA Euro qualification,Amsterdam,Netherlands,0,14,1004,15,983,-1,21,L,2,1,0
2015-10-13 00:00:00.000000,Niger,Somalia,4,0,FIFA World Cup qualification,Niamey,Niger,0,120,287,203,6,-83,281,W,0,1,0
2015-10-13 00:00:00.000000,Oman,India,3,0,FIFA World Cup qualification,Muscat,Oman,0,102,338,167,128,-65,210,W,0,1,0
2015-10-13 00:00:00.000000,Paraguay,Argentina,0,0,FIFA World Cup qualification,Asunción,Paraguay,0,61,552,1,1419,60,-867,D,1,1,0
2015-10-13 00:00:00.000000,Peru,Chile,3,4,FIFA World Cup qualification,Lima,Peru,0,50,623,9,1177,41,-554,L,2,1,0
2015-10-13 00:00:00.000000,Qatar,Maldives,4,0,FIFA World Cup qualification,Doha,Qatar,0,92,365,176,96,-84,269,W,0,1,0
2015-10-13 00:00:00.000000,Sierra Leone,Chad,2,1,FIFA World Cup qualification,Port Harcourt,Nigeria,1,121,286,175,100,-54,186,W,0,0,0
2015-10-13 00:00:00.000000,Singapore,Cambodia,2,1,FIFA World Cup qualification,Kallang,Singapore,0,157,164,186,66,-29,98,W,0,1,0
2015-10-13 00:00:00.000000,Syria,Afghanistan,5,2,FIFA World Cup qualification,Seeb,Oman,1,123,283,150,183,-27,100,W,0,0,0
2015-10-13 00:00:00.000000,Turkey,Iceland,1,0,UEFA Euro qualification,Konya,Turkey,0,37,717,23,882,14,-165,W,0,1,0
2015-10-13 00:00:00.000000,Turkmenistan,Guam,1,0,FIFA World Cup qualification,Ashgabat,Turkmenistan,0,155,172,150,183,5,-11,W,0,1,0
2015-10-13 00:00:00.000000,Uruguay,Colombia,3,0,FIFA World Cup qualification,Montevideo,Uruguay,0,20,919,5,1228,15,-309,W,0,1,0
2015-10-13 00:00:00.000000,Vietnam,Thailand,0,3,FIFA World Cup qualification,Hanoi,Vietnam,0,149,187,145,196,4,-9,L,2,1,0
2015-10-13 00:00:00.000000,Wales,Andorra,2,0,UEFA Euro qualification,Cardiff,Wales,0,8,1195,205,5,-197,1190,W,0,1,0
2015-10-17 00:00:00.000000,Niger,Togo,2,0,African Nations Championship,Niamey,Niger,0,120,287,79,411,41,-124,W,0,1,0
2015-10-17 00:00:00.000000,Nigeria,Burkina Faso,2,0,African Nations Championship,Port Harcourt,Nigeria,0,52,600,76,427,-24,173,W,0,1,0
2015-10-17 00:00:00.000000,South Africa,Angola,0,2,African Nations Championship,Johannesburg,South Africa,0,73,465,97,353,-24,112,L,2,1,0
2015-10-17 00:00:00.000000,Swaziland,Djibouti,2,1,FIFA World Cup qualification,Lobamba,Swaziland,0,135,224,206,4,-71,220,W,0,1,0
2015-10-17 00:00:00.000000,Uganda,Sudan,2,0,African Nations Championship,Kampala,Uganda,0,75,455,84,399,-9,56,W,0,1,0
2015-10-17 00:00:00.000000,Zambia,Mozambique,3,0,African Nations Championship,Ndola,Zambia,0,71,487,107,327,-36,160,W,0,1,0
2015-10-18 00:00:00.000000,Cameroon,Congo,0,0,African Nations Championship,Yaoundé,Cameroon,0,48,640,49,636,-1,4,D,1,1,0
2015-10-18 00:00:00.000000,Mali,Mauritania,2,1,African Nations Championship,Bamako,Mali,0,62,546,89,379,-27,167,W,0,1,0
2015-10-18 00:00:00.000000,Zimbabwe,Lesotho,3,1,African Nations Championship,Bulawayo,Zimbabwe,0,109,313,140,201,-31,112,W,0,1,0
2015-10-19 00:00:00.000000,Tunisia,Libya,1,0,African Nations Championship,Radès,Tunisia,0,36,722,105,328,-69,394,W,0,1,0
2015-10-22 00:00:00.000000,Libya,Morocco,0,4,African Nations Championship,Radès,Tunisia,1,105,328,80,407,25,-79,L,2,0,0
2015-10-24 00:00:00.000000,Angola,South Africa,1,2,African Nations Championship,Luanda,Angola,0,97,353,73,465,24,-112,L,2,1,0
2015-10-24 00:00:00.000000,Gabon,Chad,0,1,African Nations Championship,Libreville,Gabon,0,65,529,175,100,-110,429,L,2,1,0
2015-10-24 00:00:00.000000,Mauritania,Mali,1,1,African Nations Championship,Nouakchott,Mauritania,0,89,379,62,546,27,-167,D,1,1,0
2015-10-24 00:00:00.000000,Senegal,Guinea,3,1,African Nations Championship,Dakar,Senegal,0,38,713,55,582,-17,131,W,0,1,0
2015-10-25 00:00:00.000000,Burkina Faso,Nigeria,0,0,African Nations Championship,Ouagadougou,Burkina Faso,0,76,427,52,600,24,-173,D,1,1,0
2015-10-25 00:00:00.000000,Ethiopia,Burundi,3,0,African Nations Championship,Addis Abeba,Ethiopia,0,108,315,113,302,-5,13,W,0,1,0
2015-10-25 00:00:00.000000,Lesotho,Zimbabwe,1,1,African Nations Championship,Maseru,Lesotho,0,140,201,109,313,31,-112,D,1,1,0
2015-10-25 00:00:00.000000,Mozambique,Zambia,1,1,African Nations Championship,Maputo,Mozambique,0,107,327,71,487,36,-160,D,1,1,0
2015-10-25 00:00:00.000000,Sudan,Uganda,0,2,African Nations Championship,Khartoum,Sudan,0,84,399,75,455,9,-56,L,2,1,0
2015-10-25 00:00:00.000000,Togo,Niger,1,1,African Nations Championship,Lomé,Togo,0,79,411,120,287,-41,124,D,1,1,0
2015-10-25 00:00:00.000000,Tunisia,Morocco,2,3,African Nations Championship,Radès,Tunisia,0,36,722,80,407,-44,315,L,2,1,0
2015-10-31 00:00:00.000000,Congo,Cameroon,0,1,African Nations Championship,Brazzaville,Congo,0,49,636,48,640,1,-4,L,2,1,0
2015-11-05 00:00:00.000000,United Arab Emirates,Turkmenistan,5,1,Friendly,Abu Dhabi,United Arab Emirates,0,67,495,121,281,-54,214,W,0,1,0
2015-11-06 00:00:00.000000,Angola,Namibia,1,0,Friendly,Luanda,Angola,0,98,344,118,290,-20,54,W,0,1,0
2015-11-06 00:00:00.000000,Congo DR,Zambia,3,0,Friendly,Luanda,Angola,1,55,587,71,477,-16,110,W,0,0,0
2015-11-07 00:00:00.000000,Angola,Congo DR,1,0,Friendly,Luanda,Angola,0,98,344,55,587,43,-243,W,0,1,0
2015-11-07 00:00:00.000000,Namibia,Zambia,0,0,Friendly,Luanda,Angola,1,118,290,71,477,47,-187,D,1,0,0
2015-11-07 00:00:00.000000,Vanuatu,Fiji,1,1,Friendly,Port Vila,Vanuatu,0,201,13,190,59,11,-46,D,1,1,0
2015-11-09 00:00:00.000000,Palestine,Saudi Arabia,0,0,FIFA World Cup qualification,Amman,Jordan,1,138,233,80,417,58,-184,D,1,0,0
2015-11-10 00:00:00.000000,Vanuatu,Fiji,2,1,Friendly,Port Vila,Vanuatu,0,201,13,190,59,11,-46,W,0,1,0
2015-11-11 00:00:00.000000,Estonia,Georgia,3,0,Friendly,Tallinn,Estonia,0,90,370,111,301,-21,69,W,0,1,0
2015-11-11 00:00:00.000000,Jordan,Malta,2,0,Friendly,Istanbul,Turkey,1,82,411,158,164,-76,247,W,0,0,0
2015-11-11 00:00:00.000000,Mozambique,Gabon,1,0,FIFA World Cup qualification,Maputo,Mozambique,0,125,274,73,470,52,-196,W,0,1,0
2015-11-11 00:00:00.000000,Sudan,Zambia,0,1,FIFA World Cup qualification,Khartoum,Sudan,0,128,267,71,477,57,-210,L,2,1,0
2015-11-12 00:00:00.000000,Afghanistan,Cambodia,3,0,FIFA World Cup qualification,Teheran,Iran,1,156,168,183,78,-27,90,W,0,0,0
2015-11-12 00:00:00.000000,Andorra,St. Kitts and Nevis,0,1,Friendly,Sant Julià de Lòria,Andorra,0,205,5,101,340,104,-335,L,2,1,0
2015-11-12 00:00:00.000000,Benin,Burkina Faso,2,1,FIFA World Cup qualification,Cotonou,Benin,0,103,333,93,363,10,-30,W,0,1,0
2015-11-12 00:00:00.000000,Bolivia,Venezuela,4,2,FIFA World Cup qualification,La Paz,Bolivia,0,77,442,83,408,-6,34,W,0,1,0
2015-11-12 00:00:00.000000,Burundi,Congo DR,2,3,FIFA World Cup qualification,Bujumbura,Burundi,0,107,321,55,587,52,-266,L,2,1,0
2015-11-12 00:00:00.000000,Chile,Colombia,1,1,FIFA World Cup qualification,Santiago,Chile,0,5,1288,7,1233,-2,55,D,1,1,0
2015-11-12 00:00:00.000000,Ecuador,Uruguay,2,1,FIFA World Cup qualification,Quito,Ecuador,0,21,921,12,1051,9,-130,W,0,1,0
2015-11-12 00:00:00.000000,India,Guam,1,0,FIFA World Cup qualification,Bangalore,India,0,172,122,155,170,17,-48,W,0,1,0
2015-11-12 00:00:00.000000,Iran,Turkmenistan,3,1,FIFA World Cup qualification,Teheran,Iran,0,43,651,121,281,-78,370,W,0,1,0
2015-11-12 00:00:00.000000,Lebanon,Laos,7,0,FIFA World Cup qualification,Sidon,Lebanon,0,140,228,176,90,-36,138,W,0,1,0
2015-11-12 00:00:00.000000,Maldives,Hong Kong,0,1,FIFA World Cup qualification,Malé,Maldives,0,166,141,145,199,21,-58,L,2,1,0
2015-11-12 00:00:00.000000,Morocco,Equatorial Guinea,2,0,FIFA World Cup qualification,Agadir,Morocco,0,79,422,69,487,10,-65,W,0,1,0
2015-11-12 00:00:00.000000,Namibia,Guinea,0,1,FIFA World Cup qualification,Windhoek,Namibia,0,118,290,53,589,65,-299,L,2,1,0
2015-11-12 00:00:00.000000,Norway,Hungary,0,1,UEFA Euro qualification,Oslo,Norway,0,46,637,33,759,13,-122,L,2,1,0
2015-11-12 00:00:00.000000,Oman,New Zealand,0,1,Friendly,Seeb,Oman,0,92,365,159,163,-67,202,L,2,1,0
2015-11-12 00:00:00.000000,Palestine,Malaysia,6,0,FIFA World Cup qualification,Amman,Jordan,1,138,233,171,127,-33,106,W,0,0,0
2015-11-12 00:00:00.000000,Philippines,Yemen,0,1,FIFA World Cup qualification,Manila,Philippines,0,137,236,179,81,-42,155,L,2,1,0
2015-11-12 00:00:00.000000,Singapore,Japan,0,3,FIFA World Cup qualification,Kallang,Singapore,0,152,179,50,603,102,-424,L,2,1,0
2015-11-12 00:00:00.000000,Tajikistan,Bangladesh,5,0,FIFA World Cup qualification,Dushanbe,Tajikistan,0,160,159,180,80,-20,79,W,0,1,0
2015-11-12 00:00:00.000000,Togo,Uganda,0,1,FIFA World Cup qualification,Lomé,Togo,0,88,386,68,491,20,-105,L,2,1,0
2015-11-12 00:00:00.000000,Uzbekistan,Korea DPR,3,1,FIFA World Cup qualification,Tashkent,Uzbekistan,0,71,477,120,288,-49,189,W,0,1,0
2015-11-13 00:00:00.000000,Angola,South Africa,1,3,FIFA World Cup qualification,Benguela,Angola,0,98,344,75,461,23,-117,L,2,1,0
2015-11-13 00:00:00.000000,Argentina,Brazil,1,1,FIFA World Cup qualification,Buenos Aires,Argentina,0,3,1383,8,1208,-5,175,D,1,1,0
2015-11-13 00:00:00.000000,Belgium,Italy,3,1,Friendly,Brussels,Belgium,0,1,1440,13,1040,-12,400,W,0,1,0
2015-11-13 00:00:00.000000,Comoros,Ghana,0,0,FIFA World Cup qualification,Mitsamiouli,Comoros,0,177,89,30,793,147,-704,D,1,1,0
2015-11-13 00:00:00.000000,Costa Rica,Haiti,1,0,FIFA World Cup qualification,San José,Costa Rica,0,40,671,73,470,-33,201,W,0,1,0
2015-11-13 00:00:00.000000,Czech Republic,Serbia,4,1,Friendly,Ostrava,Czech Republic,0,17,974,49,605,-32,369,W,0,1,0
2015-11-13 00:00:00.000000,France,Germany,2,0,Friendly,Saint-Denis,France,0,24,881,2,1388,22,-507,W,0,1,0
2015-11-13 00:00:00.000000,Libya,Rwanda,1,0,FIFA World Cup qualification,Sfax,Tunisia,1,113,297,96,356,17,-59,W,0,0,0
2015-11-13 00:00:00.000000,Luxembourg,Greece,1,0,Friendly,Luxembourg,Luxembourg,0,146,197,37,718,109,-521,W,0,1,0
2015-11-13 00:00:00.000000,Madagascar,Senegal,2,2,FIFA World Cup qualification,Antananarivo,Madagascar,0,118,290,39,678,79,-388,D,1,1,0
2015-11-13 00:00:00.000000,Mauritania,Tunisia,1,2,FIFA World Cup qualification,Nouakchott,Mauritania,0,104,328,41,668,63,-340,L,2,1,0
2015-11-13 00:00:00.000000,Niger,Cameroon,0,3,FIFA World Cup qualification,Niamey,Niger,0,105,327,51,597,54,-270,L,2,1,0
2015-11-13 00:00:00.000000,Northern Ireland,Latvia,1,0,Friendly,Belfast,Northern Ireland,0,29,797,99,342,-70,455,W,0,1,0
2015-11-13 00:00:00.000000,Peru,Paraguay,1,0,FIFA World Cup qualification,Lima,Peru,0,57,583,47,610,10,-27,W,0,1,0
2015-11-13 00:00:00.000000,Poland,Iceland,4,2,Friendly,Warsaw,Poland,0,38,712,31,792,7,-80,W,0,1,0
2015-11-13 00:00:00.000000,Qatar,Turkey,1,2,Friendly,Doha,Qatar,0,85,397,18,941,67,-544,L,2,1,0
2015-11-13 00:00:00.000000,Slovakia,Switzerland,3,2,Friendly,Trnava,Slovakia,0,27,857,11,1073,16,-216,W,0,1,0
2015-11-13 00:00:00.000000,Spain,England,2,0,Friendly,Alicante,Spain,0,6,1287,9,1179,-3,108,W,0,1,0
2015-11-13 00:00:00.000000,Swaziland,Nigeria,0,0,FIFA World Cup qualification,Lobamba,Swaziland,0,130,258,59,582,71,-324,D,1,1,0
2015-11-13 00:00:00.000000,Wales,Netherlands,2,3,Friendly,Cardiff,Wales,0,15,1032,16,976,-1,56,L,2,1,0
2015-11-14 00:00:00.000000,Botswana,Mali,2,1,FIFA World Cup qualification,Francistown,Botswana,0,105,327,63,552,42,-225,W,0,1,0
2015-11-14 00:00:00.000000,Chad,Egypt,1,0,FIFA World Cup qualification,N'Djamena,Chad,0,136,240,57,583,79,-343,W,0,1,0
2015-11-14 00:00:00.000000,Ethiopia,Congo,3,4,FIFA World Cup qualification,Addis Abeba,Ethiopia,0,114,294,52,593,62,-299,L,2,1,0
2015-11-14 00:00:00.000000,Gabon,Mozambique,1,0,FIFA World Cup qualification,Libreville,Gabon,0,73,470,125,274,-52,196,W,0,1,0
2015-11-14 00:00:00.000000,Hong Kong,Macau,2,0,Friendly,Siu Sai Wan,Hong Kong,0,145,199,195,44,-50,155,W,0,1,0
2015-11-14 00:00:00.000000,Russia,Portugal,1,0,Friendly,Krasnodar,Russia,0,23,885,4,1364,19,-479,W,0,1,0
2015-11-14 00:00:00.000000,Sweden,Denmark,2,1,UEFA Euro qualification,Solna,Sweden,0,45,647,35,743,10,-96,W,0,1,0
2015-11-14 00:00:00.000000,Tanzania,Algeria,2,2,FIFA World Cup qualification,Dar es Salaam,Tanzania,0,135,245,26,872,109,-627,D,1,1,0
2015-11-14 00:00:00.000000,Ukraine,Slovenia,2,0,UEFA Euro qualification,L'viv,Ukraine,0,28,806,64,547,-36,259,W,0,1,0
2015-11-15 00:00:00.000000,Congo DR,Burundi,3,0,FIFA World Cup qualification,Kinshasa,Congo DR,0,55,587,107,321,-52,266,W,0,1,0
2015-11-15 00:00:00.000000,Equatorial Guinea,Morocco,1,0,FIFA World Cup qualification,Bata,Equatorial Guinea,0,69,487,79,422,-10,65,W,0,1,0
2015-11-15 00:00:00.000000,Guinea,Namibia,2,0,FIFA World Cup qualification,Casablanca,Morocco,1,53,589,118,290,-65,299,W,0,0,0
2015-11-15 00:00:00.000000,Hungary,Norway,2,1,UEFA Euro qualification,Budapest,Hungary,0,33,759,46,637,-13,122,W,0,1,0
2015-11-15 00:00:00.000000,Uganda,Togo,3,0,FIFA World Cup qualification,Kampala,Uganda,0,68,491,88,386,-20,105,W,0,1,0
2015-11-15 00:00:00.000000,Zambia,Sudan,2,0,FIFA World Cup qualification,Ndola,Zambia,0,71,477,128,267,-57,210,W,0,1,0
2015-11-16 00:00:00.000000,Albania,Georgia,2,2,Friendly,Tirana,Albania,0,36,723,111,301,-75,422,D,1,1,0
2015-11-17 00:00:00.000000,Algeria,Tanzania,7,0,FIFA World Cup qualification,Blida,Algeria,0,26,872,135,245,-109,627,W,0,1,0
2015-11-17 00:00:00.000000,Austria,Switzerland,1,2,Friendly,Vienna,Austria,0,10,1130,11,1073,-1,57,L,2,1,0
2015-11-17 00:00:00.000000,Azerbaijan,Moldova,2,1,Friendly,Baku,Azerbaijan,0,115,293,154,177,-39,116,W,0,1,0
2015-11-17 00:00:00.000000,Bangladesh,Australia,0,4,FIFA World Cup qualification,Dhaka,Bangladesh,0,180,80,60,573,120,-493,L,2,1,0
2015-11-17 00:00:00.000000,Bhutan,Qatar,0,3,FIFA World Cup qualification,Thimphu,Bhutan,0,180,80,85,397,95,-317,L,2,1,0
2015-11-17 00:00:00.000000,Brazil,Peru,3,0,FIFA World Cup qualification,Salvador,Brazil,0,8,1208,57,583,-49,625,W,0,1,0
2015-11-17 00:00:00.000000,Burkina Faso,Benin,2,0,FIFA World Cup qualification,Ouagadougou,Burkina Faso,0,93,363,103,333,-10,30,W,0,1,0
2015-11-17 00:00:00.000000,Cambodia,Japan,0,2,FIFA World Cup qualification,Phnom Penh,Cambodia,0,183,78,50,603,133,-525,L,2,1,0
2015-11-17 00:00:00.000000,Cameroon,Niger,0,0,FIFA World Cup qualification,Yaoundé,Cameroon,0,51,597,105,327,-54,270,D,1,1,0
2015-11-17 00:00:00.000000,Colombia,Argentina,0,1,FIFA World Cup qualification,Barranquilla,Colombia,0,7,1233,3,1383,4,-150,L,2,1,0
2015-11-17 00:00:00.000000,Congo,Ethiopia,2,1,FIFA World Cup qualification,Brazzaville,Congo,0,52,593,114,294,-62,299,W,0,1,0
2015-11-17 00:00:00.000000,Denmark,Sweden,2,2,UEFA Euro qualification,Copenhagen,Denmark,0,35,743,45,647,-10,96,D,1,1,0
2015-11-17 00:00:00.000000,Egypt,Chad,4,0,FIFA World Cup qualification,Alexandria,Egypt,0,57,583,136,240,-79,343,W,0,1,0
2015-11-17 00:00:00.000000,England,France,2,0,Friendly,London,England,0,9,1179,24,881,-15,298,W,0,1,0
2015-11-17 00:00:00.000000,Estonia,St. Kitts and Nevis,3,0,Friendly,Tallinn,Estonia,0,90,370,101,340,-11,30,W,0,1,0
2015-11-17 00:00:00.000000,Ghana,Comoros,2,0,FIFA World Cup qualification,Kumasi,Ghana,0,30,793,177,89,-147,704,W,0,1,0
2015-11-17 00:00:00.000000,Guam,Iran,0,6,FIFA World Cup qualification,Dededo,Guam,0,155,170,43,651,112,-481,L,2,1,0
2015-11-17 00:00:00.000000,Honduras,Mexico,0,2,FIFA World Cup qualification,San Pedro Sula,Honduras,0,95,359,24,881,71,-522,L,2,1,0
2015-11-17 00:00:00.000000,Italy,Romania,2,2,Friendly,Bologna,Italy,0,13,1040,14,1039,-1,1,D,1,1,0
2015-11-17 00:00:00.000000,Korea DPR,Bahrain,2,0,FIFA World Cup qualification,P'yŏngyang,Korea DPR,0,120,288,115,293,5,-5,W,0,1,0
2015-11-17 00:00:00.000000,Laos,Korea Republic,0,5,FIFA World Cup qualification,Vientiane,Laos,0,176,90,48,606,128,-516,L,2,1,0
2015-11-17 00:00:00.000000,Luxembourg,Portugal,0,2,Friendly,Luxembourg,Luxembourg,0,146,197,4,1364,142,-1167,L,2,1,0
2015-11-17 00:00:00.000000,Malaysia,United Arab Emirates,1,2,FIFA World Cup qualification,Shah Alam,Malaysia,0,171,127,67,495,104,-368,L,2,1,0
2015-11-17 00:00:00.000000,Mali,Botswana,2,0,FIFA World Cup qualification,Bamako,Mali,0,63,552,105,327,-42,225,W,0,1,0
2015-11-17 00:00:00.000000,Nigeria,Swaziland,2,0,FIFA World Cup qualification,Port Harcourt,Nigeria,0,59,582,130,258,-71,324,W,0,1,0
2015-11-17 00:00:00.000000,Paraguay,Bolivia,2,1,FIFA World Cup qualification,Asunción,Paraguay,0,47,610,77,442,-30,168,W,0,1,0
2015-11-17 00:00:00.000000,Poland,Czech Republic,3,1,Friendly,Wrocław,Poland,0,38,712,17,974,21,-262,W,0,1,0
2015-11-17 00:00:00.000000,Russia,Croatia,1,3,Friendly,Rostov-on-Don,Russia,0,23,885,19,924,4,-39,L,2,1,0
2015-11-17 00:00:00.000000,Rwanda,Libya,1,3,FIFA World Cup qualification,Kigali,Rwanda,0,96,356,113,297,-17,59,L,2,1,0
2015-11-17 00:00:00.000000,Senegal,Madagascar,3,0,FIFA World Cup qualification,Dakar,Senegal,0,39,678,118,290,-79,388,W,0,1,0
2015-11-17 00:00:00.000000,Singapore,Syria,1,2,FIFA World Cup qualification,Kallang,Singapore,0,152,179,132,254,20,-75,L,2,1,0
2015-11-17 00:00:00.000000,Slovakia,Iceland,3,1,Friendly,Žilina,Slovakia,0,27,857,31,792,-4,65,W,0,1,0
2015-11-17 00:00:00.000000,Slovenia,Ukraine,1,1,UEFA Euro qualification,Maribor,Slovenia,0,64,547,28,806,36,-259,D,1,1,0
2015-11-17 00:00:00.000000,South Africa,Angola,1,0,FIFA World Cup qualification,Durban,South Africa,0,75,461,98,344,-23,117,W,0,1,0
2015-11-17 00:00:00.000000,Tunisia,Mauritania,2,1,FIFA World Cup qualification,Radès,Tunisia,0,41,668,104,328,-63,340,W,0,1,0
2015-11-17 00:00:00.000000,Turkey,Greece,0,0,Friendly,Istanbul,Turkey,0,18,941,37,718,-19,223,D,1,1,0
2015-11-17 00:00:00.000000,Turkmenistan,Oman,2,1,FIFA World Cup qualification,Ashgabat,Turkmenistan,0,121,281,92,365,29,-84,W,0,1,0
2015-11-17 00:00:00.000000,Uruguay,Chile,3,0,FIFA World Cup qualification,Montevideo,Uruguay,0,12,1051,5,1288,7,-237,W,0,1,0
2015-11-17 00:00:00.000000,Venezuela,Ecuador,1,3,FIFA World Cup qualification,Ciudad Guayana,Venezuela,0,83,408,21,921,62,-513,L,2,1,0
2015-11-17 00:00:00.000000,Yemen,Uzbekistan,1,3,FIFA World Cup qualification,Doha,Qatar,1,179,81,71,477,108,-396,L,2,0,0
2015-11-21 00:00:00.000000,Ethiopia,Rwanda,0,1,CECAFA Cup,Addis Abeba,Ethiopia,0,114,294,96,356,18,-62,L,2,1,0
2015-11-22 00:00:00.000000,Kenya,Uganda,2,0,CECAFA Cup,Addis Abeba,Ethiopia,1,125,274,68,491,57,-217,W,0,0,0
2015-11-22 00:00:00.000000,Somalia,Tanzania,0,4,CECAFA Cup,Addis Abeba,Ethiopia,1,203,6,135,245,68,-239,L,2,0,0
2015-11-23 00:00:00.000000,South Sudan,Djibouti,2,0,CECAFA Cup,Bahir Dar,Ethiopia,1,134,246,207,0,-73,246,W,0,0,0
2015-11-23 00:00:00.000000,Sudan,Malawi,1,2,CECAFA Cup,Bahir Dar,Ethiopia,1,128,267,97,351,31,-84,L,2,0,0
2015-11-24 00:00:00.000000,Rwanda,Tanzania,1,2,CECAFA Cup,Hawassa,Ethiopia,1,96,356,135,245,-39,111,L,2,0,0
2015-11-25 00:00:00.000000,Ethiopia,Somalia,2,0,CECAFA Cup,Hawassa,Ethiopia,0,114,294,203,6,-89,288,W,0,1,0
2015-11-25 00:00:00.000000,Kenya,Burundi,1,1,CECAFA Cup,Hawassa,Ethiopia,1,125,274,107,321,18,-47,D,1,0,0
2015-11-25 00:00:00.000000,Malawi,Djibouti,3,0,CECAFA Cup,Bahir Dar,Ethiopia,1,97,351,207,0,-110,351,W,0,0,0
2015-11-25 00:00:00.000000,South Sudan,Sudan,0,0,CECAFA Cup,Bahir Dar,Ethiopia,1,134,246,128,267,6,-21,D,1,0,0
2015-11-27 00:00:00.000000,Djibouti,Sudan,0,4,CECAFA Cup,Bahir Dar,Ethiopia,1,207,0,128,267,79,-267,L,2,0,0
2015-11-27 00:00:00.000000,Rwanda,Somalia,3,0,CECAFA Cup,Hawassa,Ethiopia,1,96,356,203,6,-107,350,W,0,0,0
2015-11-27 00:00:00.000000,South Sudan,Malawi,2,0,CECAFA Cup,Bahir Dar,Ethiopia,1,134,246,97,351,37,-105,W,0,0,0
2015-11-28 00:00:00.000000,Ethiopia,Tanzania,1,1,CECAFA Cup,Hawassa,Ethiopia,0,114,294,135,245,-21,49,D,1,1,0
2015-11-28 00:00:00.000000,Uganda,Burundi,1,0,CECAFA Cup,Hawassa,Ethiopia,1,68,491,107,321,-39,170,W,0,0,0
2015-11-30 00:00:00.000000,Ethiopia,Tanzania,1,1,CECAFA Cup,Addis Abeba,Ethiopia,0,114,294,135,245,-21,49,D,1,1,0
2015-11-30 00:00:00.000000,Uganda,Malawi,2,0,CECAFA Cup,Addis Abeba,Ethiopia,1,68,491,97,351,-29,140,W,0,0,0
2015-12-01 00:00:00.000000,Rwanda,Kenya,0,0,CECAFA Cup,Addis Abeba,Ethiopia,1,96,356,125,274,-29,82,D,1,0,0
2015-12-01 00:00:00.000000,South Sudan,Sudan,0,0,CECAFA Cup,Addis Abeba,Ethiopia,1,134,246,128,267,6,-21,D,1,0,0
2015-12-03 00:00:00.000000,Ethiopia,Uganda,0,0,CECAFA Cup,Addis Abeba,Ethiopia,0,120,293,63,550,57,-257,D,1,1,0
2015-12-03 00:00:00.000000,Rwanda,Sudan,1,1,CECAFA Cup,Addis Abeba,Ethiopia,1,101,338,134,259,-33,79,D,1,0,0
2015-12-05 00:00:00.000000,Ethiopia,Sudan,1,1,CECAFA Cup,Addis Abeba,Ethiopia,0,120,293,134,259,-14,34,D,1,1,0
2015-12-05 00:00:00.000000,Uganda,Rwanda,1,0,CECAFA Cup,Addis Abeba,Ethiopia,1,63,550,101,338,-38,212,W,0,0,0
2015-12-08 00:00:00.000000,Nicaragua,Cuba,5,0,Friendly,Managua,Nicaragua,0,92,370,91,377,1,-7,W,0,1,0
2015-12-11 00:00:00.000000,Nicaragua,Cuba,1,0,Friendly,Estelí,Nicaragua,0,92,370,91,377,1,-7,W,0,1,0
2015-12-16 00:00:00.000000,Honduras,Cuba,2,0,Friendly,Juticalpa,Honduras,0,101,338,91,377,10,-39,W,0,1,0
2015-12-17 00:00:00.000000,Bangladesh,Nepal,1,0,Friendly,Dhaka,Bangladesh,0,182,78,192,49,-10,29,W,0,1,0
2015-12-23 00:00:00.000000,Nepal,Sri Lanka,0,1,SAFF Cup,Thiruvananthapuram,India,1,192,49,194,45,-2,4,L,2,0,0
2015-12-24 00:00:00.000000,Afghanistan,Bangladesh,4,0,SAFF Cup,Thiruvananthapuram,India,1,150,194,182,78,-32,116,W,0,0,0
2015-12-24 00:00:00.000000,Maldives,Bhutan,3,1,SAFF Cup,Thiruvananthapuram,India,1,160,150,188,64,-28,86,W,0,0,0
2015-12-25 00:00:00.000000,India,Sri Lanka,2,0,SAFF Cup,Thiruvananthapuram,India,0,166,132,194,45,-28,87,W,0,1,0
2015-12-26 00:00:00.000000,Bangladesh,Maldives,1,3,SAFF Cup,Thiruvananthapuram,India,1,182,78,160,150,22,-72,L,2,0,0
2015-12-26 00:00:00.000000,Bhutan,Afghanistan,0,3,SAFF Cup,Thiruvananthapuram,India,1,188,64,150,194,38,-130,L,2,0,0
2015-12-27 00:00:00.000000,India,Nepal,4,1,SAFF Cup,Thiruvananthapuram,India,0,166,132,192,49,-26,83,W,0,1,0
2015-12-28 00:00:00.000000,Afghanistan,Maldives,4,1,SAFF Cup,Thiruvananthapuram,India,1,150,194,160,150,-10,44,W,0,0,0
2015-12-28 00:00:00.000000,Bhutan,Bangladesh,0,3,SAFF Cup,Thiruvananthapuram,India,1,188,64,182,78,6,-14,L,2,0,0
2015-12-31 00:00:00.000000,Afghanistan,Sri Lanka,5,0,SAFF Cup,Thiruvananthapuram,India,1,150,194,194,45,-44,149,W,0,0,0
2015-12-31 00:00:00.000000,India,Maldives,3,2,SAFF Cup,Thiruvananthapuram,India,0,166,132,160,150,6,-18,W,0,1,0
2016-01-03 00:00:00.000000,India,Afghanistan,2,1,SAFF Cup,Thiruvananthapuram,India,0,166,132,150,194,16,-62,W,0,1,0
2016-01-08 00:00:00.000000,Bangladesh,Sri Lanka,4,2,Friendly,Jessore,Bangladesh,0,179,87,188,61,-9,26,W,0,1,0
2016-01-08 00:00:00.000000,Trinidad and Tobago,Haiti,0,1,Friendly,Panama City,Panama,1,50,623,79,453,-29,170,L,2,0,0
2016-01-10 00:00:00.000000,Rwanda,Congo DR,1,0,Friendly,Gisenyi,Rwanda,0,91,375,60,580,31,-205,W,0,1,0
2016-01-10 00:00:00.000000,Sweden,Finland,3,0,Friendly,Abu Dhabi,United Arab Emirates,1,34,771,44,663,-10,108,W,0,0,0
2016-01-11 00:00:00.000000,Maldives,Cambodia,3,2,Friendly,Jessore,Bangladesh,1,157,159,181,83,-24,76,W,0,0,0
2016-01-13 00:00:00.000000,Finland,Iceland,0,1,Friendly,Abu Dhabi,United Arab Emirates,1,44,663,36,761,8,-98,L,2,0,0
2016-01-13 00:00:00.000000,Nepal,Sri Lanka,1,0,Friendly,Dhaka,Bangladesh,1,196,41,188,61,8,-20,W,0,0,0
2016-01-13 00:00:00.000000,Uganda,Cameroon,0,0,Friendly,Njeru,Uganda,0,62,553,57,586,5,-33,D,1,1,0
2016-01-15 00:00:00.000000,Bangladesh,Nepal,0,0,Friendly,Dhaka,Bangladesh,0,179,87,196,41,-17,46,D,1,1,0
2016-01-16 00:00:00.000000,Gabon,Morocco,0,0,African Nations Championship,Kigali,Rwanda,1,77,468,76,469,1,-1,D,1,0,0
2016-01-16 00:00:00.000000,United Arab Emirates,Iceland,2,1,Friendly,Dubai,United Arab Emirates,0,64,547,36,761,28,-214,W,0,1,0
2016-01-17 00:00:00.000000,Angola,Cameroon,0,1,African Nations Championship,Butare,Rwanda,1,105,333,57,586,48,-253,L,2,0,0
2016-01-17 00:00:00.000000,Congo DR,Ethiopia,3,0,African Nations Championship,Butare,Rwanda,1,60,580,118,291,-58,289,W,0,0,0
2016-01-18 00:00:00.000000,Nigeria,Niger,4,1,African Nations Championship,Kigali,Rwanda,1,66,540,103,337,-37,203,W,0,0,0
2016-01-18 00:00:00.000000,Tunisia,Guinea,2,2,African Nations Championship,Kigali,Rwanda,1,40,711,49,624,-9,87,D,1,0,0
2016-01-19 00:00:00.000000,Maldives,Nepal,1,4,Friendly,Dhaka,Bangladesh,1,157,159,196,41,-39,118,L,2,0,0
2016-01-19 00:00:00.000000,Mali,Uganda,2,2,African Nations Championship,Gisenyi,Rwanda,1,63,552,62,553,1,-1,D,1,0,0
2016-01-19 00:00:00.000000,Zimbabwe,Zambia,0,1,African Nations Championship,Gisenyi,Rwanda,1,108,322,67,516,41,-194,L,2,0,0
2016-01-20 00:00:00.000000,Rwanda,Gabon,2,1,African Nations Championship,Kigali,Rwanda,0,91,375,77,468,14,-93,W,0,1,0
2016-01-21 00:00:00.000000,Cameroon,Ethiopia,0,0,African Nations Championship,Butare,Rwanda,1,57,586,118,291,-61,295,D,1,0,0
2016-01-21 00:00:00.000000,Congo DR,Angola,4,2,African Nations Championship,Butare,Rwanda,1,60,580,105,333,-45,247,W,0,0,0
2016-01-22 00:00:00.000000,Niger,Guinea,2,2,African Nations Championship,Kigali,Rwanda,1,103,337,49,624,54,-287,D,1,0,0
2016-01-22 00:00:00.000000,Tunisia,Nigeria,1,1,African Nations Championship,Kigali,Rwanda,1,40,711,66,540,-26,171,D,1,0,0
2016-01-23 00:00:00.000000,Uganda,Zambia,0,1,African Nations Championship,Gisenyi,Rwanda,1,62,553,67,516,-5,37,L,2,0,0
2016-01-23 00:00:00.000000,Zimbabwe,Mali,0,1,African Nations Championship,Gisenyi,Rwanda,1,108,322,63,552,45,-230,L,2,0,0
2016-01-24 00:00:00.000000,Rwanda,Morocco,1,4,African Nations Championship,Kigali,Rwanda,0,91,375,76,469,15,-94,L,2,1,0
2016-01-25 00:00:00.000000,Cameroon,Congo DR,3,1,African Nations Championship,Butare,Rwanda,1,57,586,60,580,-3,6,W,0,0,0
2016-01-25 00:00:00.000000,Ethiopia,Angola,1,2,African Nations Championship,Kigali,Rwanda,1,118,291,105,333,13,-42,L,2,0,0
2016-01-26 00:00:00.000000,Guinea,Nigeria,1,0,African Nations Championship,Gisenyi,Rwanda,1,49,624,66,540,-17,84,W,0,0,0
2016-01-26 00:00:00.000000,Niger,Tunisia,0,5,African Nations Championship,Kigali,Rwanda,1,103,337,40,711,63,-374,L,2,0,0
2016-01-27 00:00:00.000000,Egypt,Jordan,0,1,Friendly,Aswan,Egypt,0,58,585,86,398,-28,187,L,2,1,0
2016-01-27 00:00:00.000000,Uganda,Zimbabwe,1,1,African Nations Championship,Gisenyi,Rwanda,1,62,553,108,322,-46,231,D,1,0,0
2016-01-27 00:00:00.000000,Zambia,Mali,0,0,African Nations Championship,Kigali,Rwanda,1,67,516,63,552,4,-36,D,1,0,0
2016-01-29 00:00:00.000000,Egypt,Libya,2,0,Friendly,Aswan,Egypt,0,58,585,81,427,-23,158,W,0,1,0
2016-01-30 00:00:00.000000,Rwanda,Congo DR,1,2,African Nations Championship,Kigali,Rwanda,0,91,375,60,580,31,-205,L,2,1,0
2016-01-31 00:00:00.000000,Tunisia,Mali,1,2,African Nations Championship,Kigali,Rwanda,1,40,711,63,552,-23,159,L,2,0,0
2016-01-31 00:00:00.000000,USA,Iceland,3,2,Friendly,Carson,USA,0,32,784,36,761,-4,23,W,0,1,0
2016-01-31 00:00:00.000000,Zambia,Guinea,0,0,African Nations Championship,Gisenyi,Rwanda,1,67,516,49,624,18,-108,D,1,0,0
2016-02-05 00:00:00.000000,Bahrain,Lebanon,2,0,Friendly,Riffa,Bahrain,0,130,269,140,246,-10,23,W,0,1,0
2016-02-07 00:00:00.000000,Congo DR,Mali,3,0,African Nations Championship,Kigali,Rwanda,1,57,570,68,510,-11,60,W,0,0,0
2016-02-14 00:00:00.000000,Uzbekistan,Lebanon,2,0,Friendly,Dubai,United Arab Emirates,1,71,502,140,246,-69,256,W,0,0,0
2016-02-21 00:00:00.000000,Guyana,Suriname,2,0,Friendly,Providence,Guyana,0,162,139,190,57,-28,82,W,0,1,0
2016-02-27 00:00:00.000000,Egypt,Burkina Faso,2,0,Friendly,Alexandria,Egypt,0,55,571,85,402,-30,169,W,0,1,0
2016-03-18 00:00:00.000000,Iraq,Syria,0,1,Friendly,Teheran,Iran,1,91,371,123,279,-32,92,L,2,0,0
2016-03-18 00:00:00.000000,United Arab Emirates,Bangladesh,6,1,Friendly,Abu Dhabi,United Arab Emirates,0,64,517,177,100,-113,417,W,0,1,0
2016-03-22 00:00:00.000000,Cuba,Bermuda,2,1,CFU Caribbean Cup qualification,Havana,Cuba,0,135,263,164,135,-29,128,W,0,1,0
2016-03-23 00:00:00.000000,Antigua and Barbuda,Aruba,2,1,CFU Caribbean Cup qualification,St. John's,Antigua and Barbuda,0,90,373,113,298,-23,75,W,0,1,0
2016-03-23 00:00:00.000000,Barbados,Curaçao,1,0,CFU Caribbean Cup qualification,Bridgetown,Barbados,0,143,227,151,192,-8,35,W,0,1,0
2016-03-23 00:00:00.000000,Chad,Tanzania,0,1,African Cup of Nations qualification,N'Djamena,Chad,0,127,275,125,276,2,-1,L,2,1,0
2016-03-23 00:00:00.000000,Croatia,Israel,2,0,Friendly,Osijek,Croatia,0,18,965,67,506,-49,459,W,0,1,0
2016-03-23 00:00:00.000000,Guinea-Bissau,Kenya,1,0,African Cup of Nations qualification,Bissau,Guinea-Bissau,0,147,207,103,331,44,-124,W,0,1,0
2016-03-23 00:00:00.000000,Poland,Serbia,1,0,Friendly,Poznań,Poland,0,31,789,50,596,-19,193,W,0,1,0
2016-03-23 00:00:00.000000,Romania,Lithuania,1,0,Friendly,Giurgiu,Romania,0,16,990,128,274,-112,716,W,0,1,0
2016-03-23 00:00:00.000000,South Sudan,Benin,1,2,African Cup of Nations qualification,Juba,South Sudan,0,140,246,77,464,63,-218,L,2,1,0
2016-03-23 00:00:00.000000,Zambia,Congo,1,1,African Cup of Nations qualification,Ndola,Zambia,0,78,457,59,564,19,-107,D,1,1,0
2016-03-24 00:00:00.000000,Australia,Tajikistan,7,0,FIFA World Cup qualification,Adelaide,Australia,0,67,506,150,193,-83,313,W,0,1,0
2016-03-24 00:00:00.000000,Bahrain,Yemen,3,0,FIFA World Cup qualification,Riffa,Bahrain,0,132,269,175,112,-43,157,W,0,1,0
2016-03-24 00:00:00.000000,Bolivia,Colombia,2,3,FIFA World Cup qualification,La Paz,Bolivia,0,72,499,8,1215,64,-716,L,2,1,0
2016-03-24 00:00:00.000000,Chile,Argentina,1,2,FIFA World Cup qualification,Santiago,Chile,0,5,1307,2,1457,3,-150,L,2,1,0
2016-03-24 00:00:00.000000,Comoros,Botswana,1,0,African Cup of Nations qualification,Mitsamiouli,Comoros,0,173,119,92,370,81,-251,W,0,1,0
2016-03-24 00:00:00.000000,Czech Republic,Scotland,0,1,Friendly,Prague,Czech Republic,0,25,861,45,617,-20,244,L,2,1,0
2016-03-24 00:00:00.000000,Denmark,Iceland,2,1,Friendly,Herning,Denmark,0,40,706,38,741,2,-35,W,0,1,0
2016-03-24 00:00:00.000000,Djibouti,Liberia,0,1,African Cup of Nations qualification,Djibouti,Djibouti,0,204,0,101,333,103,-333,L,2,1,0
2016-03-24 00:00:00.000000,Ecuador,Paraguay,2,2,FIFA World Cup qualification,Quito,Ecuador,0,13,1039,43,642,-30,397,D,1,1,0
2016-03-24 00:00:00.000000,Estonia,Norway,0,0,Friendly,Tallinn,Estonia,0,88,376,51,594,37,-218,D,1,1,0
2016-03-24 00:00:00.000000,Ghana,Mozambique,3,1,African Cup of Nations qualification,Accra,Ghana,0,41,656,100,337,-59,319,W,0,1,0
2016-03-24 00:00:00.000000,Greece,Montenegro,2,1,Friendly,Piraeus,Greece,0,39,718,84,409,-45,309,W,0,1,0
2016-03-24 00:00:00.000000,Iran,India,4,0,FIFA World Cup qualification,Teheran,Iran,0,44,627,160,142,-116,485,W,0,1,0
2016-03-24 00:00:00.000000,Iraq,Thailand,2,2,FIFA World Cup qualification,Teheran,Iran,1,91,371,118,288,-27,83,D,1,0,0
2016-03-24 00:00:00.000000,Italy,Spain,1,1,Friendly,Udine,Italy,0,14,999,3,1374,11,-375,D,1,1,0
2016-03-24 00:00:00.000000,Japan,Afghanistan,5,0,FIFA World Cup qualification,Saitama,Japan,0,56,575,151,192,-95,383,W,0,1,0
2016-03-24 00:00:00.000000,Jordan,Bangladesh,8,0,FIFA World Cup qualification,Amman,Jordan,0,82,414,177,100,-95,314,W,0,1,0
2016-03-24 00:00:00.000000,Korea Republic,Lebanon,1,0,FIFA World Cup qualification,Ansan,Korea Republic,0,57,566,145,215,-88,351,W,0,1,0
2016-03-24 00:00:00.000000,Madagascar,Central African Republic,1,1,African Cup of Nations qualification,Antananarivo,Madagascar,0,130,272,110,302,20,-30,D,1,1,0
2016-03-24 00:00:00.000000,Malta,Moldova,0,0,Friendly,Attard,Malta,0,161,139,156,165,5,-26,D,1,1,0
2016-03-24 00:00:00.000000,Oman,Guam,1,0,FIFA World Cup qualification,Muscat,Oman,0,97,342,154,169,-57,173,W,0,1,0
2016-03-24 00:00:00.000000,Peru,Venezuela,2,2,FIFA World Cup qualification,Lima,Peru,0,42,646,75,480,-33,166,D,1,1,0
2016-03-24 00:00:00.000000,Qatar,Hong Kong,2,0,FIFA World Cup qualification,Doha,Qatar,0,80,441,139,253,-59,188,W,0,1,0
2016-03-24 00:00:00.000000,Saudi Arabia,Malaysia,2,0,FIFA World Cup qualification,Jeddah,Saudi Arabia,0,60,562,166,129,-106,433,W,0,1,0
2016-03-24 00:00:00.000000,Solomon Islands,Papua New Guinea,2,0,Friendly,Honiara,Solomon Islands,0,200,26,202,4,-2,22,W,0,1,0
2016-03-24 00:00:00.000000,Syria,Cambodia,6,0,FIFA World Cup qualification,Seeb,Oman,1,123,279,183,79,-60,200,W,0,0,0
2016-03-24 00:00:00.000000,Turkey,Sweden,2,1,Friendly,Antalya,Turkey,0,20,943,34,769,-14,174,W,0,1,0
2016-03-24 00:00:00.000000,Ukraine,Cyprus,1,0,Friendly,Odesa,Ukraine,0,27,845,79,442,-52,403,W,0,1,0
2016-03-24 00:00:00.000000,United Arab Emirates,Palestine,2,0,FIFA World Cup qualification,Abu Dhabi,United Arab Emirates,0,64,517,117,290,-53,227,W,0,1,0
2016-03-24 00:00:00.000000,Uzbekistan,Philippines,1,0,FIFA World Cup qualification,Tashkent,Uzbekistan,0,74,484,135,263,-61,221,W,0,1,0
2016-03-24 00:00:00.000000,Wales,Northern Ireland,1,1,Friendly,Cardiff,Wales,0,17,984,28,833,-11,151,D,1,1,0
2016-03-25 00:00:00.000000,Algeria,Ethiopia,7,1,African Cup of Nations qualification,Blida,Algeria,0,37,743,120,285,-83,458,W,0,1,0
2016-03-25 00:00:00.000000,Armenia,Belarus,0,0,Friendly,Yerevan,Armenia,0,116,296,64,517,52,-221,D,1,1,0
2016-03-25 00:00:00.000000,Brazil,Uruguay,2,2,FIFA World Cup qualification,Recife,Brazil,0,6,1254,11,1082,-5,172,D,1,1,0
2016-03-25 00:00:00.000000,Canada,Mexico,0,3,FIFA World Cup qualification,Vancouver,Canada,0,87,385,22,902,65,-517,L,2,1,0
2016-03-25 00:00:00.000000,El Salvador,Honduras,2,2,FIFA World Cup qualification,San Salvador,El Salvador,0,99,340,89,375,10,-35,D,1,1,0
2016-03-25 00:00:00.000000,Gabon,Sierra Leone,2,1,Friendly,Franceville,Gabon,0,83,412,115,297,-32,115,W,0,1,0
2016-03-25 00:00:00.000000,Guatemala,USA,2,0,FIFA World Cup qualification,Guatemala,Guatemala,0,95,354,30,792,65,-438,W,0,1,0
2016-03-25 00:00:00.000000,Guinea,Malawi,0,0,African Cup of Nations qualification,Conakry,Guinea,0,63,540,104,329,-41,211,D,1,1,0
2016-03-25 00:00:00.000000,Haiti,Panama,0,0,FIFA World Cup qualification,Port-au-Prince,Haiti,0,64,517,55,576,9,-59,D,1,1,0
2016-03-25 00:00:00.000000,Jamaica,Costa Rica,1,1,FIFA World Cup qualification,Kingston,Jamaica,0,52,593,33,784,19,-191,D,1,1,0
2016-03-25 00:00:00.000000,Mali,Equatorial Guinea,1,0,African Cup of Nations qualification,Bamako,Mali,0,73,490,76,479,-3,11,W,0,1,0
2016-03-25 00:00:00.000000,Mauritania,Gambia,2,1,African Cup of Nations qualification,Nouakchott,Mauritania,0,106,320,164,135,-58,185,W,0,1,0
2016-03-25 00:00:00.000000,Netherlands,France,2,3,Friendly,Amsterdam,Netherlands,0,15,997,24,871,-9,126,L,2,1,0
2016-03-25 00:00:00.000000,Nigeria,Egypt,1,1,African Cup of Nations qualification,Kaduna,Nigeria,0,62,547,53,589,9,-42,D,1,1,0
2016-03-25 00:00:00.000000,Portugal,Bulgaria,0,1,Friendly,Leiria,Portugal,0,7,1234,70,500,-63,734,L,2,1,0
2016-03-25 00:00:00.000000,Slovakia,Latvia,0,0,Friendly,Trnava,Slovakia,0,26,858,98,341,-72,517,D,1,1,0
2016-03-25 00:00:00.000000,Swaziland,Zimbabwe,1,1,African Cup of Nations qualification,Lobamba,Swaziland,0,124,277,131,271,-7,6,D,1,1,0
2016-03-25 00:00:00.000000,Tunisia,Togo,1,0,African Cup of Nations qualification,Monastir,Tunisia,0,47,609,101,333,-54,276,W,0,1,0
2016-03-26 00:00:00.000000,Anguilla,Puerto Rico,0,4,CFU Caribbean Cup qualification,The Valley,Anguilla,0,204,0,170,127,34,-127,L,2,1,0
2016-03-26 00:00:00.000000,Aruba,St. Kitts and Nevis,0,2,CFU Caribbean Cup qualification,Oranjestad,Aruba,0,113,298,121,284,-8,14,L,2,1,0
2016-03-26 00:00:00.000000,Austria,Albania,2,1,Friendly,Vienna,Austria,0,10,1095,35,754,-25,341,W,0,1,0
2016-03-26 00:00:00.000000,Azerbaijan,Kazakhstan,0,1,Friendly,Belek,Turkey,1,112,300,125,276,-13,24,L,2,0,0
2016-03-26 00:00:00.000000,British Virgin Islands,Dominica,0,7,CFU Caribbean Cup qualification,Road Town,British Virgin Islands,0,199,27,176,109,23,-82,L,2,1,0
2016-03-26 00:00:00.000000,Burkina Faso,Uganda,1,0,African Cup of Nations qualification,Ouagadougou,Burkina Faso,0,86,392,67,506,19,-114,W,0,1,0
2016-03-26 00:00:00.000000,Burundi,Namibia,1,3,African Cup of Nations qualification,Bujumbura,Burundi,0,129,273,133,265,-4,8,L,2,1,0
2016-03-26 00:00:00.000000,Cameroon,South Africa,2,2,African Cup of Nations qualification,Limbe,Cameroon,0,61,551,70,500,-9,51,D,1,1,0
2016-03-26 00:00:00.000000,Congo DR,Angola,2,1,African Cup of Nations qualification,Kinshasa,Congo DR,0,58,565,109,306,-51,259,W,0,1,0
2016-03-26 00:00:00.000000,Curaçao,Dominican Republic,2,1,CFU Caribbean Cup qualification,Willemstad,Curaçao,0,151,192,159,150,-8,42,W,0,1,0
2016-03-26 00:00:00.000000,Germany,England,2,3,Friendly,Berlin,Germany,0,4,1355,9,1112,-5,243,L,2,1,0
2016-03-26 00:00:00.000000,Hungary,Croatia,1,1,Friendly,Budapest,Hungary,0,19,951,18,965,1,-14,D,1,1,0
2016-03-26 00:00:00.000000,Mauritius,Rwanda,1,0,African Cup of Nations qualification,Mapou,Mauritius,0,172,120,85,397,87,-277,W,0,1,0
2016-03-26 00:00:00.000000,Poland,Finland,5,0,Friendly,Wrocław,Poland,0,31,789,46,615,-15,174,W,0,1,0
2016-03-26 00:00:00.000000,Russia,Lithuania,3,0,Friendly,Moscow,Russia,0,23,892,128,274,-105,618,W,0,1,0
2016-03-26 00:00:00.000000,Senegal,Niger,2,0,African Cup of Nations qualification,Dakar,Senegal,0,48,603,108,312,-60,291,W,0,1,0
2016-03-26 00:00:00.000000,Seychelles,Lesotho,2,0,African Cup of Nations qualification,Victoria,Seychelles,0,191,56,153,186,38,-130,W,0,1,0
2016-03-27 00:00:00.000000,Benin,South Sudan,4,1,African Cup of Nations qualification,Cotonou,Benin,0,77,464,140,246,-63,218,W,0,1,0
2016-03-27 00:00:00.000000,Botswana,Comoros,2,1,African Cup of Nations qualification,Francistown,Botswana,0,92,370,173,119,-81,251,W,0,1,0
2016-03-27 00:00:00.000000,Congo,Zambia,1,1,African Cup of Nations qualification,Brazzaville,Congo,0,59,564,78,457,-19,107,D,1,1,0
2016-03-27 00:00:00.000000,Kenya,Guinea-Bissau,0,1,African Cup of Nations qualification,Nairobi,Kenya,0,103,331,147,207,-44,124,L,2,1,0
2016-03-27 00:00:00.000000,Mozambique,Ghana,0,0,African Cup of Nations qualification,Maputo,Mozambique,0,100,337,41,656,59,-319,D,1,1,0
2016-03-27 00:00:00.000000,Romania,Spain,0,0,Friendly,Cluj,Romania,0,16,990,3,1374,13,-384,D,1,1,0
2016-03-27 00:00:00.000000,Thailand,Korea Republic,0,1,Friendly,Bangkok,Thailand,0,118,288,57,566,61,-278,L,2,1,0
2016-03-28 00:00:00.000000,Andorra,Moldova,0,1,Friendly,Paola,Malta,1,201,6,156,165,45,-159,L,2,0,0
2016-03-28 00:00:00.000000,Central African Republic,Madagascar,2,1,African Cup of Nations qualification,Bangui,Central African Republic,0,110,302,130,272,-20,30,W,0,1,0
2016-03-28 00:00:00.000000,Equatorial Guinea,Mali,0,1,African Cup of Nations qualification,Malabo,Equatorial Guinea,0,76,479,73,490,3,-11,L,2,1,0
2016-03-28 00:00:00.000000,Liechtenstein,Faroe Islands,2,3,Friendly,Marbella,Spain,1,163,137,93,357,70,-220,L,2,0,0
2016-03-28 00:00:00.000000,Northern Ireland,Slovenia,1,0,Friendly,Belfast,Northern Ireland,0,28,833,54,577,-26,256,W,0,1,0
2016-03-28 00:00:00.000000,Sierra Leone,Gabon,1,0,Friendly,Freetown,Sierra Leone,0,115,297,83,412,32,-115,W,0,1,0
2016-03-28 00:00:00.000000,Ukraine,Wales,1,0,Friendly,Kyïv,Ukraine,0,27,845,17,984,10,-139,W,0,1,0
2016-03-29 00:00:00.000000,Afghanistan,Singapore,2,1,FIFA World Cup qualification,Teheran,Iran,1,151,192,148,198,3,-6,W,0,0,0
2016-03-29 00:00:00.000000,Angola,Congo DR,0,2,African Cup of Nations qualification,Luanda,Angola,0,109,306,58,565,51,-259,L,2,1,0
2016-03-29 00:00:00.000000,Argentina,Bolivia,2,0,FIFA World Cup qualification,Córdoba,Argentina,0,2,1457,72,499,-70,958,W,0,1,0
2016-03-29 00:00:00.000000,Australia,Jordan,5,1,FIFA World Cup qualification,Sydney,Australia,0,67,506,82,414,-15,92,W,0,1,0
2016-03-29 00:00:00.000000,Austria,Turkey,1,2,Friendly,Vienna,Austria,0,10,1095,20,943,-10,152,L,2,1,0
2016-03-29 00:00:00.000000,Colombia,Ecuador,3,0,FIFA World Cup qualification,Barranquilla,Colombia,0,8,1215,13,1039,-5,176,W,0,1,0
2016-03-29 00:00:00.000000,Costa Rica,Jamaica,3,0,FIFA World Cup qualification,San José,Costa Rica,0,33,784,52,593,-19,191,W,0,1,0
2016-03-29 00:00:00.000000,Dominican Republic,Barbados,2,0,CFU Caribbean Cup qualification,Santo Domingo,Dominican Republic,0,159,150,143,227,16,-77,W,0,1,0
2016-03-29 00:00:00.000000,Egypt,Nigeria,1,0,African Cup of Nations qualification,Alexandria,Egypt,0,53,589,62,547,-9,42,W,0,1,0
2016-03-29 00:00:00.000000,England,Netherlands,1,2,Friendly,London,England,0,9,1112,15,997,-6,115,L,2,1,0
2016-03-29 00:00:00.000000,Estonia,Serbia,0,1,Friendly,Tallinn,Estonia,0,88,376,50,596,38,-220,L,2,1,0
2016-03-29 00:00:00.000000,Ethiopia,Algeria,3,3,African Cup of Nations qualification,Addis Abeba,Ethiopia,0,120,285,37,743,83,-458,D,1,1,0
2016-03-29 00:00:00.000000,France,Russia,4,2,Friendly,Saint-Denis,France,0,24,871,23,892,1,-21,W,0,1,0
2016-03-29 00:00:00.000000,Gambia,Mauritania,0,0,African Cup of Nations qualification,Bakau,Gambia,0,164,135,106,320,58,-185,D,1,1,0
2016-03-29 00:00:00.000000,Georgia,Kazakhstan,1,1,Friendly,Tbilisi,Georgia,0,122,283,125,276,-3,7,D,1,1,0
2016-03-29 00:00:00.000000,Germany,Italy,4,1,Friendly,Munich,Germany,0,4,1355,14,999,-10,356,W,0,1,0
2016-03-29 00:00:00.000000,Greece,Iceland,2,3,Friendly,Piraeus,Greece,0,39,718,38,741,1,-23,L,2,1,0
2016-03-29 00:00:00.000000,Honduras,El Salvador,2,0,FIFA World Cup qualification,San Pedro Sula,Honduras,0,89,375,99,340,-10,35,W,0,1,0
2016-03-29 00:00:00.000000,India,Turkmenistan,1,2,FIFA World Cup qualification,Kochi,India,0,160,142,113,298,47,-156,L,2,1,0
2016-03-29 00:00:00.000000,Iran,Oman,2,0,FIFA World Cup qualification,Teheran,Iran,0,44,627,97,342,-53,285,W,0,1,0
2016-03-29 00:00:00.000000,Iraq,Vietnam,1,0,FIFA World Cup qualification,Teheran,Iran,1,91,371,146,210,-55,161,W,0,0,0
2016-03-29 00:00:00.000000,Japan,Syria,5,0,FIFA World Cup qualification,Saitama,Japan,0,56,575,123,279,-67,296,W,0,1,0
2016-03-29 00:00:00.000000,Lesotho,Seychelles,2,1,African Cup of Nations qualification,Maseru,Lesotho,0,153,186,191,56,-38,130,W,0,1,0
2016-03-29 00:00:00.000000,Liberia,Djibouti,5,0,African Cup of Nations qualification,Monrovia,Liberia,0,101,333,204,0,-103,333,W,0,1,0
2016-03-29 00:00:00.000000,Luxembourg,Albania,0,2,Friendly,Luxembourg,Luxembourg,0,142,233,35,754,107,-521,L,2,1,0
2016-03-29 00:00:00.000000,Malawi,Guinea,1,2,African Cup of Nations qualification,Blantyre,Malawi,0,104,329,63,540,41,-211,L,2,1,0
2016-03-29 00:00:00.000000,Malaysia,Macau,0,0,Friendly,Krubong,Malaysia,0,166,129,195,44,-29,85,D,1,1,0
2016-03-29 00:00:00.000000,Maldives,Bhutan,4,2,FIFA World Cup qualification,Malé,Maldives,0,158,161,193,49,-35,112,W,0,1,0
2016-03-29 00:00:00.000000,Mexico,Canada,2,0,FIFA World Cup qualification,Mexico City,Mexico,0,22,902,87,385,-65,517,W,0,1,0
2016-03-29 00:00:00.000000,Montenegro,Belarus,0,0,Friendly,Podgorica,Montenegro,0,84,409,64,517,20,-108,D,1,1,0
2016-03-29 00:00:00.000000,Namibia,Burundi,1,3,African Cup of Nations qualification,Windhoek,Namibia,0,133,265,129,273,4,-8,L,2,1,0
2016-03-29 00:00:00.000000,Niger,Senegal,1,2,African Cup of Nations qualification,Niamey,Niger,0,108,312,48,603,60,-291,L,2,1,0
2016-03-29 00:00:00.000000,Norway,Finland,2,0,Friendly,Oslo,Norway,0,51,594,46,615,5,-21,W,0,1,0
2016-03-29 00:00:00.000000,Panama,Haiti,1,0,FIFA World Cup qualification,Panama City,Panama,0,55,576,64,517,-9,59,W,0,1,0
2016-03-29 00:00:00.000000,Paraguay,Brazil,2,2,FIFA World Cup qualification,Asunción,Paraguay,0,43,642,6,1254,37,-612,D,1,1,0
2016-03-29 00:00:00.000000,Philippines,Korea DPR,3,2,FIFA World Cup qualification,Manila,Philippines,0,135,263,94,356,41,-93,W,0,1,0
2016-03-29 00:00:00.000000,Portugal,Belgium,2,1,Friendly,Leiria,Portugal,0,7,1234,1,1506,6,-272,W,0,1,0
2016-03-29 00:00:00.000000,Rwanda,Mauritius,5,0,African Cup of Nations qualification,Kigali,Rwanda,0,85,397,172,120,-87,277,W,0,1,0
2016-03-29 00:00:00.000000,Scotland,Denmark,1,0,Friendly,Glasgow,Scotland,0,45,617,40,706,5,-89,W,0,1,0
2016-03-29 00:00:00.000000,South Africa,Cameroon,0,0,African Cup of Nations qualification,Durban,South Africa,0,70,500,61,551,9,-51,D,1,1,0
2016-03-29 00:00:00.000000,St. Kitts and Nevis,Antigua and Barbuda,1,0,CFU Caribbean Cup qualification,Basseterre,St. Kitts and Nevis,0,121,284,90,373,31,-89,W,0,1,0
2016-03-29 00:00:00.000000,Sweden,Czech Republic,1,1,Friendly,Solna,Sweden,0,34,769,25,861,9,-92,D,1,1,0
2016-03-29 00:00:00.000000,Togo,Tunisia,0,0,African Cup of Nations qualification,Lomé,Togo,0,101,333,47,609,54,-276,D,1,1,0
2016-03-29 00:00:00.000000,Uganda,Burkina Faso,0,0,African Cup of Nations qualification,Kampala,Uganda,0,67,506,86,392,-19,114,D,1,1,0
2016-03-29 00:00:00.000000,United Arab Emirates,Saudi Arabia,1,1,FIFA World Cup qualification,Abu Dhabi,United Arab Emirates,0,64,517,60,562,4,-45,D,1,1,0
2016-03-29 00:00:00.000000,Uruguay,Peru,1,0,FIFA World Cup qualification,Montevideo,Uruguay,0,11,1082,42,646,-31,436,W,0,1,0
2016-03-29 00:00:00.000000,USA,Guatemala,4,0,FIFA World Cup qualification,Columbus,USA,0,30,792,95,354,-65,438,W,0,1,0
2016-03-29 00:00:00.000000,Uzbekistan,Bahrain,1,0,FIFA World Cup qualification,Tashkent,Uzbekistan,0,74,484,132,269,-58,215,W,0,1,0
2016-03-29 00:00:00.000000,Venezuela,Chile,1,4,FIFA World Cup qualification,Barinas,Venezuela,0,75,480,5,1307,70,-827,L,2,1,0
2016-05-21 00:00:00.000000,Botswana,Lesotho,2,1,Friendly,Serowe,Botswana,0,91,379,148,202,-57,177,W,0,1,0
2016-05-22 00:00:00.000000,England,Turkey,2,1,Friendly,Manchester,England,0,10,1069,13,983,-3,86,W,0,1,0
2016-05-22 00:00:00.000000,Puerto Rico,USA,1,3,Friendly,Bayamón,Puerto Rico,0,152,191,29,810,123,-619,L,2,1,0
2016-05-25 00:00:00.000000,Romania,Congo DR,1,1,Friendly,Como,Italy,1,19,920,51,596,-32,324,D,1,0,0
2016-05-25 00:00:00.000000,Serbia,Cyprus,2,1,Friendly,Užice,Serbia,0,56,581,80,426,-24,155,W,0,1,0
2016-05-26 00:00:00.000000,Azerbaijan,Andorra,0,0,Friendly,Bad Erlach,Austria,1,133,269,202,5,-69,264,D,1,0,0
2016-05-27 00:00:00.000000,Croatia,Moldova,1,0,Friendly,Koprivnica,Croatia,0,23,856,156,181,-133,675,W,0,1,0
2016-05-27 00:00:00.000000,Czech Republic,Malta,6,0,Friendly,Kufstein,Austria,1,29,810,165,149,-136,661,W,0,0,0
2016-05-27 00:00:00.000000,England,Australia,2,1,Friendly,Sunderland,England,0,10,1069,50,601,-40,468,W,0,1,0
2016-05-27 00:00:00.000000,Morocco,Congo,2,0,Friendly,Tangier,Morocco,0,64,555,59,562,5,-7,W,0,1,0
2016-05-27 00:00:00.000000,Nigeria,Mali,1,0,Friendly,Le Petit-Quevilly,France,1,67,540,65,551,2,-11,W,0,0,0
2016-05-27 00:00:00.000000,Northern Ireland,Belarus,3,0,Friendly,Belfast,Northern Ireland,0,26,825,77,465,-51,360,W,0,1,0
2016-05-27 00:00:00.000000,Slovakia,Georgia,3,1,Friendly,Wels,Austria,1,32,784,123,289,-91,495,W,0,0,0
2016-05-27 00:00:00.000000,Togo,Zambia,1,0,Friendly,Lomé,Togo,0,103,334,78,457,25,-123,W,0,1,0
2016-05-28 00:00:00.000000,Costa Rica,Venezuela,2,1,Friendly,San José,Costa Rica,0,25,829,74,476,-49,353,W,0,1,0
2016-05-28 00:00:00.000000,El Salvador,Peru,1,3,Friendly,Seattle,USA,1,97,347,46,631,51,-284,L,2,0,0
2016-05-28 00:00:00.000000,Gabon,Mauritania,0,2,Friendly,Cornellà de Llobregat,Spain,1,88,395,109,321,-21,74,L,2,0,0
2016-05-28 00:00:00.000000,Guatemala,Armenia,1,7,Friendly,Carson,USA,1,89,389,110,316,-21,73,L,2,0,0
2016-05-28 00:00:00.000000,Mexico,Paraguay,1,0,Friendly,Atlanta,USA,1,16,938,39,688,-23,250,W,0,0,0
2016-05-28 00:00:00.000000,New Zealand,Fiji,3,1,Oceania Nations Cup,Port Morseby,Papua New Guinea,1,161,163,183,68,-22,95,W,0,0,0
2016-05-28 00:00:00.000000,Rwanda,Senegal,0,2,Friendly,Kigali,Rwanda,0,87,401,43,651,44,-250,L,2,1,0
2016-05-28 00:00:00.000000,Switzerland,Belgium,1,2,Friendly,Geneva,Switzerland,0,14,974,2,1364,12,-390,L,2,1,0
2016-05-28 00:00:00.000000,Vanuatu,Solomon Islands,0,1,Oceania Nations Cup,Port Morseby,Papua New Guinea,1,181,72,192,46,-11,26,L,2,0,0
2016-05-29 00:00:00.000000,Albania,Qatar,3,1,Friendly,Hartberg,Austria,1,45,632,83,416,-38,216,W,0,0,0
2016-05-29 00:00:00.000000,Germany,Slovakia,1,3,Friendly,Augsburg,Germany,0,5,1309,32,784,-27,525,L,2,1,0
2016-05-29 00:00:00.000000,Italy,Scotland,1,0,Friendly,Attard,Malta,1,15,959,40,687,-25,272,W,0,0,0
2016-05-29 00:00:00.000000,Kenya,Tanzania,1,1,Friendly,Nairobi,Kenya,0,116,303,129,274,-13,29,D,1,1,0
2016-05-29 00:00:00.000000,Laos,Nepal,1,1,Friendly,Vientiane,Laos,0,176,105,180,77,-4,28,D,1,1,0
2016-05-29 00:00:00.000000,Lithuania,Estonia,2,0,Baltic Cup,Klaipėda,Lithuania,0,138,254,93,366,45,-112,W,0,1,0
2016-05-29 00:00:00.000000,Papua New Guinea,New Caledonia,1,1,Oceania Nations Cup,Port Morseby,Papua New Guinea,0,198,30,191,53,7,-23,D,1,1,0
2016-05-29 00:00:00.000000,Portugal,Norway,3,0,Friendly,Porto,Portugal,0,8,1184,49,605,-41,579,W,0,1,0
2016-05-29 00:00:00.000000,Romania,Ukraine,3,4,Friendly,Turin,Italy,1,19,920,22,880,-3,40,L,2,0,0
2016-05-29 00:00:00.000000,Tahiti,Samoa,4,0,Oceania Nations Cup,Port Morseby,Papua New Guinea,1,196,35,170,128,26,-93,W,0,0,0
2016-05-29 00:00:00.000000,Turkey,Montenegro,1,0,Friendly,Antalya,Turkey,0,13,983,94,365,-81,618,W,0,1,0
2016-05-30 00:00:00.000000,France,Cameroon,3,2,Friendly,Nantes,France,0,21,907,63,556,-42,351,W,0,1,0
2016-05-30 00:00:00.000000,Gambia,Zambia,0,0,Friendly,Bakau,Gambia,0,168,145,78,457,90,-312,D,1,1,0
2016-05-30 00:00:00.000000,Sweden,Slovenia,0,0,Friendly,Malmö,Sweden,0,36,713,61,558,-25,155,D,1,1,0
2016-05-31 00:00:00.000000,Austria,Malta,2,1,Friendly,Klagenfurt,Austria,0,11,1067,165,149,-154,918,W,0,1,0
2016-05-31 00:00:00.000000,Kenya,Sudan,1,1,Friendly,Nairobi,Kenya,0,116,303,128,276,-12,27,D,1,1,0
2016-05-31 00:00:00.000000,Luxembourg,Nigeria,1,3,Friendly,Luxembourg,Luxembourg,0,146,221,67,540,79,-319,L,2,1,0
2016-05-31 00:00:00.000000,Serbia,Israel,3,1,Friendly,Novi Sad,Serbia,0,56,581,76,467,-20,114,W,0,1,0
2016-05-31 00:00:00.000000,Solomon Islands,Fiji,0,1,Oceania Nations Cup,Port Moresby,Papua New Guinea,1,192,46,183,68,9,-22,L,2,0,0
2016-05-31 00:00:00.000000,Vanuatu,New Zealand,0,5,Oceania Nations Cup,Port Moresby,Papua New Guinea,1,181,72,161,163,20,-91,L,2,0,0
2016-05-31 00:00:00.000000,Vietnam,Syria,2,0,Friendly,Thanh Hóa,Vietnam,0,145,228,110,316,35,-88,W,0,1,0
2016-05-31 00:00:00.000000,Zimbabwe,Uganda,2,0,Friendly,Harare,Zimbabwe,0,126,280,72,491,54,-211,W,0,1,0
2016-06-02 00:00:00.000000,England,Portugal,1,0,Friendly,London,England,0,11,1069,8,1181,3,-112,W,0,1,0
2016-06-02 00:00:00.000000,Laos,India,0,1,AFC Asian Cup qualification,Vientiane,Laos,0,174,115,163,151,11,-36,L,2,1,0
2016-06-02 00:00:00.000000,Maldives,Yemen,0,2,AFC Asian Cup qualification,Malé,Maldives,0,174,115,178,102,-4,13,L,2,1,0
2016-06-02 00:00:00.000000,Seychelles,Algeria,0,2,African Cup of Nations qualification,Victoria,Seychelles,0,180,94,32,786,148,-692,L,2,1,0
2016-06-02 00:00:00.000000,Tajikistan,Bangladesh,5,0,AFC Asian Cup qualification,Dushanbe,Tajikistan,0,164,150,181,93,-17,57,W,0,1,0
2016-06-03 00:00:00.000000,Albania,Ukraine,1,3,Friendly,Bergamo,Italy,1,42,667,19,894,23,-227,L,2,0,0
2016-06-03 00:00:00.000000,Azerbaijan,Canada,1,1,Friendly,Rohrbach an der Lafnitz,Austria,1,138,252,93,363,45,-111,D,1,0,0
2016-06-03 00:00:00.000000,Djibouti,Tunisia,0,3,African Cup of Nations qualification,Djibouti,Djibouti,0,204,0,47,629,157,-629,L,2,1,0
2016-06-03 00:00:00.000000,Japan,Bulgaria,7,2,Kirin Cup,Toyota,Japan,0,53,581,69,518,-16,63,W,0,1,0
2016-06-03 00:00:00.000000,Libya,Morocco,1,1,African Cup of Nations qualification,Radès,Tunisia,1,122,293,62,555,60,-262,D,1,0,0
2016-06-03 00:00:00.000000,Mauritania,Cameroon,0,1,African Cup of Nations qualification,Nouakchott,Mauritania,0,121,294,58,566,63,-272,L,2,1,0
2016-06-03 00:00:00.000000,Romania,Georgia,5,1,Friendly,Bucharest,Romania,0,22,878,137,260,-115,618,W,0,1,0
2016-06-03 00:00:00.000000,Sierra Leone,Sudan,1,0,African Cup of Nations qualification,Freetown,Sierra Leone,0,108,317,128,278,-20,39,W,0,1,0
2016-06-03 00:00:00.000000,Switzerland,Moldova,2,1,Friendly,Lugano,Switzerland,0,15,948,159,165,-144,783,W,0,1,0
2016-06-03 00:00:00.000000,Thailand,Syria,2,2,King's Cup,Bangkok,Thailand,0,117,302,101,336,16,-34,D,1,1,0
2016-06-03 00:00:00.000000,United Arab Emirates,Jordan,1,3,King's Cup,Bangkok,Thailand,1,70,517,80,434,-10,83,L,2,0,0
2016-06-03 00:00:00.000000,USA,Colombia,0,2,Copa América,Santa Clara,USA,0,31,803,3,1328,28,-525,L,2,1,0
2016-06-03 00:00:00.000000,Vietnam,Hong Kong,2,2,Friendly,Rangoon,Burma,1,133,266,143,233,-10,33,D,1,0,0
2016-06-04 00:00:00.000000,Australia,Greece,1,0,Friendly,Sydney,Australia,0,59,563,40,678,19,-115,W,0,1,0
2016-06-04 00:00:00.000000,Austria,Netherlands,0,2,Friendly,Vienna,Austria,0,10,1077,14,959,-4,118,L,2,1,0
2016-06-04 00:00:00.000000,Botswana,Uganda,1,2,African Cup of Nations qualification,Francistown,Botswana,0,87,391,72,500,15,-109,L,2,1,0
2016-06-04 00:00:00.000000,Brazil,Ecuador,0,0,Copa América,Pasadena,USA,1,7,1257,13,978,-6,279,D,1,0,0
2016-06-04 00:00:00.000000,Costa Rica,Paraguay,0,0,Copa América,Orlando,USA,1,23,853,44,638,-21,215,D,1,0,0
2016-06-04 00:00:00.000000,Croatia,San Marino,10,0,Friendly,Rijeka,Croatia,0,27,842,200,20,-173,822,W,0,1,0
2016-06-04 00:00:00.000000,Estonia,Latvia,0,0,Baltic Cup,Tallinn,Estonia,0,94,360,104,330,-10,30,D,1,1,0
2016-06-04 00:00:00.000000,Fiji,Vanuatu,2,3,Oceania Nations Cup,Port Moresby,Papua New Guinea,1,186,68,185,72,1,-4,L,2,0,0
2016-06-04 00:00:00.000000,France,Scotland,3,0,Friendly,Metz,France,0,17,925,43,659,-26,266,W,0,1,0
2016-06-04 00:00:00.000000,Gambia,South Africa,0,4,African Cup of Nations qualification,Bakau,Gambia,0,165,145,68,529,97,-384,L,2,1,0
2016-06-04 00:00:00.000000,Germany,Hungary,2,0,Friendly,Gelsenkirchen,Germany,0,4,1310,20,886,-16,424,W,0,1,0
2016-06-04 00:00:00.000000,Haiti,Peru,0,1,Copa América,Seattle,USA,1,74,478,48,623,26,-145,L,2,0,0
2016-06-04 00:00:00.000000,New Zealand,Solomon Islands,1,0,Oceania Nations Cup,Port Moresby,Papua New Guinea,1,147,220,176,110,-29,110,W,0,0,0
2016-06-04 00:00:00.000000,Rwanda,Mozambique,2,3,African Cup of Nations qualification,Kigali,Rwanda,0,103,332,97,349,6,-17,L,2,1,0
2016-06-04 00:00:00.000000,Slovakia,Northern Ireland,0,0,Friendly,Trnava,Slovakia,0,24,852,25,851,-1,1,D,1,1,0
2016-06-04 00:00:00.000000,South Sudan,Mali,0,3,African Cup of Nations qualification,Juba,South Sudan,0,157,174,63,554,94,-380,L,2,1,0
2016-06-04 00:00:00.000000,Tanzania,Egypt,0,2,African Cup of Nations qualification,Dar es Salaam,Tanzania,0,136,261,45,631,91,-370,L,2,1,0
2016-06-05 00:00:00.000000,Belgium,Norway,3,2,Friendly,Brussels,Belgium,0,2,1384,51,593,-49,791,W,0,1,0
2016-06-05 00:00:00.000000,Central African Republic,Angola,3,0,African Cup of Nations qualification,Bangui,Central African Republic,0,96,351,123,292,-27,59,W,0,1,0
2016-06-05 00:00:00.000000,Comoros,Burkina Faso,0,1,African Cup of Nations qualification,Moroni,Comoros,0,162,158,73,479,89,-321,L,2,1,0
2016-06-05 00:00:00.000000,Czech Republic,Korea Republic,1,2,Friendly,Prague,Czech Republic,0,30,815,50,603,-20,212,L,2,1,0
2016-06-05 00:00:00.000000,Jamaica,Venezuela,0,1,Copa América,Chicago,USA,1,46,630,77,456,-31,174,L,2,0,0
2016-06-05 00:00:00.000000,Kenya,Congo,2,1,African Cup of Nations qualification,Nairobi,Kenya,0,129,276,60,560,69,-284,W,0,1,0
2016-06-05 00:00:00.000000,Lesotho,Ethiopia,1,2,African Cup of Nations qualification,Maseru,Lesotho,0,155,185,125,288,30,-103,L,2,1,0
2016-06-05 00:00:00.000000,Liberia,Togo,2,2,African Cup of Nations qualification,Monrovia,Liberia,0,123,292,95,358,28,-66,D,1,1,0
2016-06-05 00:00:00.000000,Madagascar,Congo DR,1,6,African Cup of Nations qualification,Mahajanga,Madagascar,0,108,317,52,589,56,-272,L,2,1,0
2016-06-05 00:00:00.000000,Mauritius,Ghana,0,2,African Cup of Nations qualification,Mapou,Mauritius,0,142,239,37,728,105,-489,L,2,1,0
2016-06-05 00:00:00.000000,Mexico,Uruguay,3,1,Copa América,Glendale,USA,1,16,942,9,1150,7,-208,W,0,0,0
2016-06-05 00:00:00.000000,Papua New Guinea,Samoa,8,0,Oceania Nations Cup,Port Moresby,Papua New Guinea,0,193,51,168,128,25,-77,W,0,1,0
2016-06-05 00:00:00.000000,Russia,Serbia,1,1,Friendly,Monaco,Monaco,1,29,828,54,576,-25,252,D,1,0,0
2016-06-05 00:00:00.000000,Slovenia,Turkey,0,1,Friendly,Ljubljana,Slovenia,0,57,567,18,919,39,-352,L,2,1,0
2016-06-05 00:00:00.000000,Swaziland,Guinea,1,0,African Cup of Nations qualification,Lobamba,Swaziland,0,117,302,55,573,62,-271,W,0,1,0
2016-06-05 00:00:00.000000,Sweden,Wales,3,0,Friendly,Solna,Sweden,0,35,735,26,846,9,-111,W,0,1,0
2016-06-05 00:00:00.000000,Tahiti,New Caledonia,1,1,Oceania Nations Cup,Port Moresby,Papua New Guinea,1,179,96,183,74,-4,22,D,1,0,0
2016-06-05 00:00:00.000000,Thailand,Jordan,2,0,King's Cup,Bangkok,Thailand,0,117,302,80,434,37,-132,W,0,1,0
2016-06-05 00:00:00.000000,United Arab Emirates,Syria,0,1,King's Cup,Bangkok,Thailand,1,70,517,101,336,-31,181,L,2,0,0
2016-06-05 00:00:00.000000,Zimbabwe,Malawi,3,0,African Cup of Nations qualification,Harare,Zimbabwe,0,115,303,107,320,8,-17,W,0,1,0
2016-06-06 00:00:00.000000,Argentina,Chile,2,1,Copa América,Santa Clara,USA,1,1,1503,5,1293,-4,210,W,0,0,0
2016-06-06 00:00:00.000000,Iceland,Liechtenstein,4,0,Friendly,Reykjavík,Iceland,0,34,751,168,128,-134,623,W,0,1,0
2016-06-06 00:00:00.000000,Italy,Finland,2,0,Friendly,Verona,Italy,0,12,982,67,536,-55,446,W,0,1,0
2016-06-06 00:00:00.000000,Panama,Bolivia,2,1,Copa América,Orlando,USA,1,56,572,82,420,-26,152,W,0,0,0
2016-06-06 00:00:00.000000,Poland,Lithuania,0,0,Friendly,Cracow,Poland,0,27,842,127,282,-100,560,D,1,1,0
2016-06-06 00:00:00.000000,Singapore,Vietnam,0,3,Friendly,Rangoon,Burma,1,149,207,133,266,16,-59,L,2,0,0
2016-06-07 00:00:00.000000,Australia,Greece,1,2,Friendly,Melbourne,Australia,0,59,563,40,678,19,-115,L,2,1,0
2016-06-07 00:00:00.000000,Bangladesh,Tajikistan,0,1,AFC Asian Cup qualification,Dhaka,Bangladesh,0,181,93,164,150,17,-57,L,2,1,0
2016-06-07 00:00:00.000000,Bulgaria,Denmark,0,4,Kirin Cup,Suita,Japan,1,69,518,38,697,31,-179,L,2,0,0
2016-06-07 00:00:00.000000,Canada,Uzbekistan,2,1,Friendly,Bad Waltersdorf,Austria,1,93,363,66,544,27,-181,W,0,0,0
2016-06-07 00:00:00.000000,Colombia,Paraguay,2,1,Copa América,Pasadena,USA,1,3,1328,44,638,-41,690,W,0,0,0
2016-06-07 00:00:00.000000,India,Laos,6,1,AFC Asian Cup qualification,Guwahati,India,0,163,151,174,115,-11,36,W,0,1,0
2016-06-07 00:00:00.000000,Spain,Georgia,0,1,Friendly,Getafe,Spain,0,6,1267,137,260,-131,1007,L,2,1,0
2016-06-07 00:00:00.000000,St. Vincent and the Grenadines,St. Kitts and Nevis,0,1,CFU Caribbean Cup qualification,Kingstown,St. Vincent and the Grenadines,0,148,211,92,374,56,-163,L,2,1,0
2016-06-07 00:00:00.000000,USA,Costa Rica,4,0,Copa América,Chicago,USA,0,31,803,23,853,8,-50,W,0,1,0
2016-06-07 00:00:00.000000,Yemen,Maldives,2,0,AFC Asian Cup qualification,Doha,Qatar,1,178,102,174,115,4,-13,W,0,0,0
2016-06-08 00:00:00.000000,Brazil,Haiti,7,1,Copa América,Orlando,USA,1,7,1257,74,478,-67,779,W,0,0,0
2016-06-08 00:00:00.000000,Ecuador,Peru,2,2,Copa América,Glendale,USA,1,13,978,48,623,-35,355,D,1,0,0
2016-06-08 00:00:00.000000,New Zealand,New Caledonia,1,0,Oceania Nations Cup,Port Moresby,Papua New Guinea,1,147,220,183,74,-36,146,W,0,0,0
2016-06-08 00:00:00.000000,Papua New Guinea,Solomon Islands,2,1,Oceania Nations Cup,Port Moresby,Papua New Guinea,0,193,51,176,110,17,-59,W,0,1,0
2016-06-08 00:00:00.000000,Portugal,Estonia,7,0,Friendly,Lisbon,Portugal,0,8,1181,94,360,-86,821,W,0,1,0
2016-06-09 00:00:00.000000,Mexico,Jamaica,2,0,Copa América,Pasadena,USA,1,16,942,46,630,-30,312,W,0,0,0
2016-06-09 00:00:00.000000,Uruguay,Venezuela,0,1,Copa América,Philadelphia,USA,1,9,1150,77,456,-68,694,L,2,0,0
2016-06-10 00:00:00.000000,Argentina,Panama,5,0,Copa América,Chicago,USA,1,1,1503,56,572,-55,931,W,0,0,0
2016-06-10 00:00:00.000000,Chile,Bolivia,2,1,Copa América,Foxborough,USA,1,5,1293,82,420,-77,873,W,0,0,0
2016-06-10 00:00:00.000000,France,Romania,2,1,UEFA Euro,Saint-Denis,France,0,17,925,22,878,-5,47,W,0,1,0
2016-06-11 00:00:00.000000,Albania,Switzerland,0,1,UEFA Euro,Lens,France,1,42,667,15,948,27,-281,L,2,0,0
2016-06-11 00:00:00.000000,Colombia,Costa Rica,2,3,Copa América,Houston,USA,1,3,1328,23,853,-20,475,L,2,0,0
2016-06-11 00:00:00.000000,England,Russia,1,1,UEFA Euro,Marseille,France,1,11,1069,29,828,-18,241,D,1,0,0
2016-06-11 00:00:00.000000,Papua New Guinea,New Zealand,0,0,Oceania Nations Cup,Port Moresby,Papua New Guinea,0,193,51,147,220,46,-169,D,1,1,0
2016-06-11 00:00:00.000000,Seychelles,Madagascar,0,1,COSAFA Cup,Windhoek,Namibia,1,180,94,108,317,72,-223,L,2,0,0
2016-06-11 00:00:00.000000,USA,Paraguay,1,0,Copa América,Philadelphia,USA,0,31,803,44,638,-13,165,W,0,1,0
2016-06-11 00:00:00.000000,Wales,Slovakia,2,1,UEFA Euro,Bordeaux,France,1,26,846,24,852,2,-6,W,0,0,0
2016-06-11 00:00:00.000000,Zimbabwe,Swaziland,2,2,COSAFA Cup,Windhoek,Namibia,1,115,303,117,302,-2,1,D,1,0,0
2016-06-12 00:00:00.000000,Benin,Equatorial Guinea,2,1,African Cup of Nations qualification,Cotonou,Benin,0,75,473,76,466,-1,7,W,0,1,0
2016-06-12 00:00:00.000000,Brazil,Peru,0,1,Copa América,Foxborough,USA,1,7,1257,48,623,-41,634,L,2,0,0
2016-06-12 00:00:00.000000,Ecuador,Haiti,4,0,Copa América,East Rutherford,USA,1,13,978,74,478,-61,500,W,0,0,0
2016-06-12 00:00:00.000000,Germany,Ukraine,2,0,UEFA Euro,Villeneuve-d'Ascq,France,1,4,1310,19,894,-15,416,W,0,0,0
2016-06-12 00:00:00.000000,Lesotho,Mauritius,3,0,COSAFA Cup,Windhoek,Namibia,1,155,185,142,239,13,-54,W,0,0,0
2016-06-12 00:00:00.000000,Malawi,Angola,3,0,COSAFA Cup,Windhoek,Namibia,1,107,320,123,292,-16,28,W,0,0,0
2016-06-12 00:00:00.000000,Poland,Northern Ireland,1,0,UEFA Euro,Nice,France,1,27,842,25,851,2,-9,W,0,0,0
2016-06-12 00:00:00.000000,Turkey,Croatia,0,1,UEFA Euro,Paris,France,1,18,919,27,842,-9,77,L,2,0,0
2016-06-13 00:00:00.000000,Belgium,Italy,0,2,UEFA Euro,Lyon,France,1,2,1384,12,982,-10,402,L,2,0,0
2016-06-13 00:00:00.000000,Madagascar,Zimbabwe,0,0,COSAFA Cup,Windhoek,Namibia,1,108,317,115,303,-7,14,D,1,0,0
2016-06-13 00:00:00.000000,Mexico,Venezuela,1,1,Copa América,Houston,USA,1,16,942,77,456,-61,486,D,1,0,0
2016-06-13 00:00:00.000000,Spain,Czech Republic,1,0,UEFA Euro,Toulouse,France,1,6,1267,30,815,-24,452,W,0,0,0
2016-06-13 00:00:00.000000,Swaziland,Seychelles,4,0,COSAFA Cup,Windhoek,Namibia,1,117,302,180,94,-63,208,W,0,0,0
2016-06-13 00:00:00.000000,Uruguay,Jamaica,3,0,Copa América,Santa Clara,USA,1,9,1150,46,630,-37,520,W,0,0,0
2016-06-14 00:00:00.000000,Angola,Lesotho,0,2,COSAFA Cup,Windhoek,Namibia,1,123,292,155,185,-32,107,L,2,0,0
2016-06-14 00:00:00.000000,Argentina,Bolivia,3,0,Copa América,Seattle,USA,1,1,1503,82,420,-81,1083,W,0,0,0
2016-06-14 00:00:00.000000,Austria,Hungary,0,2,UEFA Euro,Bordeaux,France,1,10,1077,20,886,-10,191,L,2,0,0
2016-06-14 00:00:00.000000,Chile,Panama,4,2,Copa América,Philadelphia,USA,1,5,1293,56,572,-51,721,W,0,0,0
2016-06-14 00:00:00.000000,Mauritius,Malawi,0,1,COSAFA Cup,Windhoek,Namibia,1,142,239,107,320,35,-81,L,2,0,0
2016-06-14 00:00:00.000000,Portugal,Iceland,1,1,UEFA Euro,Saint-Étienne,France,1,8,1181,34,751,-26,430,D,1,0,0
2016-06-15 00:00:00.000000,France,Albania,2,0,UEFA Euro,Marseille,France,0,17,925,42,667,-25,258,W,0,1,0
2016-06-15 00:00:00.000000,Romania,Switzerland,1,1,UEFA Euro,Paris,France,1,22,878,15,948,7,-70,D,1,0,0
2016-06-15 00:00:00.000000,Russia,Slovakia,1,2,UEFA Euro,Villeneuve-d'Ascq,France,1,29,828,24,852,5,-24,L,2,0,0
2016-06-15 00:00:00.000000,Swaziland,Madagascar,1,0,COSAFA Cup,Windhoek,Namibia,1,117,302,108,317,9,-15,W,0,0,0
2016-06-15 00:00:00.000000,Zimbabwe,Seychelles,5,0,COSAFA Cup,Windhoek,Namibia,1,115,303,180,94,-65,209,W,0,0,0
2016-06-16 00:00:00.000000,Angola,Mauritius,0,2,COSAFA Cup,Windhoek,Namibia,1,123,292,142,239,-19,53,L,2,0,0
2016-06-16 00:00:00.000000,England,Wales,2,1,UEFA Euro,Lens,France,1,11,1069,26,846,-15,223,W,0,0,0
2016-06-16 00:00:00.000000,Germany,Poland,0,0,UEFA Euro,Saint-Denis,France,1,4,1310,27,842,-23,468,D,1,0,0
2016-06-16 00:00:00.000000,Malawi,Lesotho,0,1,COSAFA Cup,Windhoek,Namibia,1,107,320,155,185,-48,135,L,2,0,0
2016-06-16 00:00:00.000000,Ukraine,Northern Ireland,0,2,UEFA Euro,Lyon,France,1,19,894,25,851,-6,43,L,2,0,0
2016-06-16 00:00:00.000000,USA,Ecuador,2,1,Copa América,Seattle,USA,0,31,803,13,978,18,-175,W,0,1,0
2016-06-17 00:00:00.000000,Czech Republic,Croatia,2,2,UEFA Euro,Saint-Étienne,France,1,30,815,27,842,3,-27,D,1,0,0
2016-06-17 00:00:00.000000,Italy,Sweden,1,0,UEFA Euro,Toulouse,France,1,12,982,35,735,-23,247,W,0,0,0
2016-06-17 00:00:00.000000,Peru,Colombia,0,0,Copa América,East Rutherford,USA,1,48,623,3,1328,45,-705,D,1,0,0
2016-06-17 00:00:00.000000,Spain,Turkey,3,0,UEFA Euro,Nice,France,1,6,1267,18,919,-12,348,W,0,0,0
2016-06-18 00:00:00.000000,Argentina,Venezuela,4,1,Copa América,Foxborough,USA,1,1,1503,77,456,-76,1047,W,0,0,0
2016-06-18 00:00:00.000000,Iceland,Hungary,1,1,UEFA Euro,Marseille,France,1,34,751,20,886,14,-135,D,1,0,0
2016-06-18 00:00:00.000000,Mexico,Chile,0,7,Copa América,Santa Clara,USA,1,16,942,5,1293,11,-351,L,2,0,0
2016-06-18 00:00:00.000000,Namibia,Botswana,1,1,COSAFA Cup,Windhoek,Namibia,0,135,263,87,391,48,-128,D,1,1,0
2016-06-18 00:00:00.000000,Portugal,Austria,0,0,UEFA Euro,Lyon,France,1,8,1181,10,1077,-2,104,D,1,0,0
2016-06-18 00:00:00.000000,South Africa,Lesotho,1,1,COSAFA Cup,Windhoek,Namibia,1,68,529,155,185,-87,344,D,1,0,0
2016-06-19 00:00:00.000000,Congo DR,Mozambique,1,0,COSAFA Cup,Windhoek,Namibia,1,52,589,97,349,-45,240,W,0,0,0
2016-06-19 00:00:00.000000,France,Switzerland,0,0,UEFA Euro,Villeneuve-d'Ascq,France,0,17,925,15,948,2,-23,D,1,1,0
2016-06-19 00:00:00.000000,Romania,Albania,0,1,UEFA Euro,Lyon,France,1,22,878,42,667,-20,211,L,2,0,0
2016-06-19 00:00:00.000000,Zambia,Swaziland,0,0,COSAFA Cup,Windhoek,Namibia,1,79,436,117,302,-38,134,D,1,0,0
2016-06-20 00:00:00.000000,Russia,Wales,0,3,UEFA Euro,Toulouse,France,1,29,828,26,846,3,-18,L,2,0,0
2016-06-20 00:00:00.000000,Slovakia,England,0,0,UEFA Euro,Saint-Étienne,France,1,24,852,11,1069,13,-217,D,1,0,0
2016-06-21 00:00:00.000000,Croatia,Spain,2,1,UEFA Euro,Bordeaux,France,1,27,842,6,1267,21,-425,W,0,0,0
2016-06-21 00:00:00.000000,Czech Republic,Turkey,0,2,UEFA Euro,Lens,France,1,30,815,18,919,12,-104,L,2,0,0
2016-06-21 00:00:00.000000,Lesotho,Zambia,2,3,COSAFA Cup,Windhoek,Namibia,1,155,185,79,436,76,-251,L,2,0,0
2016-06-21 00:00:00.000000,Namibia,Mozambique,3,0,COSAFA Cup,Windhoek,Namibia,0,135,263,97,349,38,-86,W,0,1,0
2016-06-21 00:00:00.000000,Northern Ireland,Germany,0,1,UEFA Euro,Paris,France,1,25,851,4,1310,21,-459,L,2,0,0
2016-06-21 00:00:00.000000,Ukraine,Poland,0,1,UEFA Euro,Marseille,France,1,19,894,27,842,-8,52,L,2,0,0
2016-06-21 00:00:00.000000,USA,Argentina,0,4,Copa América,Houston,USA,0,31,803,1,1503,30,-700,L,2,1,0
2016-06-22 00:00:00.000000,Botswana,Congo DR,0,0,COSAFA Cup,Windhoek,Namibia,1,87,391,52,589,35,-198,D,1,0,0
2016-06-22 00:00:00.000000,Colombia,Chile,0,2,Copa América,Chicago,USA,1,3,1328,5,1293,-2,35,L,2,0,0
2016-06-22 00:00:00.000000,Hungary,Portugal,3,3,UEFA Euro,Lyon,France,1,20,886,8,1181,12,-295,D,1,0,0
2016-06-22 00:00:00.000000,Iceland,Austria,2,1,UEFA Euro,Saint-Denis,France,1,34,751,10,1077,24,-326,W,0,0,0
2016-06-22 00:00:00.000000,New Caledonia,Malaysia,1,2,Friendly,Nouméa,New Caledonia,0,183,74,173,116,10,-42,L,2,1,0
2016-06-22 00:00:00.000000,South Africa,Swaziland,5,1,COSAFA Cup,Windhoek,Namibia,1,68,529,117,302,-49,227,W,0,0,0
2016-06-22 00:00:00.000000,Sweden,Belgium,0,1,UEFA Euro,Nice,France,1,35,735,2,1384,33,-649,L,2,0,0
2016-06-24 00:00:00.000000,Namibia,Zambia,1,0,COSAFA Cup,Windhoek,Namibia,0,135,263,79,436,56,-173,W,0,1,0
2016-06-25 00:00:00.000000,Croatia,Portugal,0,1,UEFA Euro,Lens,France,1,27,842,8,1181,19,-339,L,2,0,0
2016-06-25 00:00:00.000000,South Africa,Botswana,3,2,COSAFA Cup,Windhoek,Namibia,1,68,529,87,391,-19,138,W,0,0,0
2016-06-25 00:00:00.000000,Swaziland,Congo DR,1,0,COSAFA Cup,Windhoek,Namibia,1,117,302,52,589,65,-287,W,0,0,0
2016-06-25 00:00:00.000000,Switzerland,Poland,1,1,UEFA Euro,Saint-Étienne,France,1,15,948,27,842,-12,106,D,1,0,0
2016-06-25 00:00:00.000000,USA,Colombia,0,1,Copa América,Glendale,USA,0,31,803,3,1328,28,-525,L,2,1,0
2016-06-25 00:00:00.000000,Wales,Northern Ireland,1,0,UEFA Euro,Paris,France,1,26,846,25,851,1,-5,W,0,0,0
2016-06-26 00:00:00.000000,Argentina,Chile,0,0,Copa América,East Rutherford,USA,1,1,1503,5,1293,-4,210,D,1,0,0
2016-06-26 00:00:00.000000,Fiji,Malaysia,1,1,Friendly,Nadi,Fiji,0,186,68,173,116,13,-48,D,1,1,0
2016-06-26 00:00:00.000000,Germany,Slovakia,3,0,UEFA Euro,Villeneuve-d'Ascq,France,1,4,1310,24,852,-20,458,W,0,0,0
2016-06-26 00:00:00.000000,Hungary,Belgium,0,4,UEFA Euro,Toulouse,France,1,20,886,2,1384,18,-498,L,2,0,0
2016-06-27 00:00:00.000000,England,Iceland,1,2,UEFA Euro,Nice,France,1,11,1069,34,751,-23,318,L,2,0,0
2016-06-27 00:00:00.000000,Italy,Spain,2,0,UEFA Euro,Saint-Denis,France,1,12,982,6,1267,6,-285,W,0,0,0
2016-06-30 00:00:00.000000,Macau,Mongolia,2,2,EAFF Championship,Dededo,Guam,1,196,42,203,4,-7,38,D,1,0,0
2016-06-30 00:00:00.000000,Poland,Portugal,1,1,UEFA Euro,Marseille,France,1,27,842,8,1181,19,-339,D,1,0,0
2016-07-01 00:00:00.000000,Wales,Belgium,3,1,UEFA Euro,Villeneuve-d'Ascq,France,1,26,846,2,1384,24,-538,W,0,0,0
2016-07-02 00:00:00.000000,Germany,Italy,1,1,UEFA Euro,Bordeaux,France,1,4,1310,12,982,-8,328,D,1,0,0
2016-07-03 00:00:00.000000,France,Iceland,5,2,UEFA Euro,Saint-Denis,France,0,17,925,34,751,-17,174,W,0,1,0
2016-07-06 00:00:00.000000,Portugal,Wales,2,0,UEFA Euro,Lyon,France,1,8,1181,26,846,-18,335,W,0,0,0
2016-07-07 00:00:00.000000,France,Germany,2,0,UEFA Euro,Marseille,France,0,17,925,4,1310,13,-385,W,0,1,0
2016-07-10 00:00:00.000000,France,Portugal,0,1,UEFA Euro,Saint-Denis,France,0,17,925,8,1181,9,-256,L,2,1,0
2016-07-24 00:00:00.000000,Uzbekistan,Iraq,2,1,Friendly,Tashkent,Uzbekistan,0,56,569,99,354,-43,215,W,0,1,0
2016-07-28 00:00:00.000000,Cambodia,Singapore,2,1,Friendly,Phnom Penh,Cambodia,0,180,95,158,175,22,-80,W,0,1,0
2016-08-08 00:00:00.000000,Oman,Turkmenistan,1,0,Friendly,Muscat,Oman,0,106,340,120,312,-14,28,W,0,1,0
2016-08-08 00:00:00.000000,Qatar,Iraq,2,1,Friendly,Doha,Qatar,0,79,425,99,354,-20,71,W,0,1,0
2016-08-13 00:00:00.000000,Bhutan,India,0,3,Friendly,Thimphu,Bhutan,0,192,64,152,200,40,-136,L,2,1,0
2016-08-18 00:00:00.000000,Jordan,Qatar,2,3,Friendly,Lucerne,Switzerland,1,79,437,80,425,-1,12,L,2,0,0
2016-08-21 00:00:00.000000,Iraq,Korea DPR,1,1,Friendly,Paroi,Malaysia,1,113,337,99,354,14,-17,D,1,0,0
2016-08-24 00:00:00.000000,Honduras,Nicaragua,1,0,Friendly,San Pedro Sula,Honduras,0,84,390,107,340,-23,50,W,0,1,0
2016-08-24 00:00:00.000000,Korea DPR,United Arab Emirates,2,0,Friendly,Shanghai,China,1,99,354,74,484,25,-130,W,0,0,0
2016-08-24 00:00:00.000000,Saudi Arabia,Laos,4,0,Friendly,Doha,Qatar,1,61,540,177,107,-116,433,W,0,0,0
2016-08-24 00:00:00.000000,Uzbekistan,Burkina Faso,1,0,Friendly,Tashkent,Uzbekistan,0,55,560,73,486,-18,74,W,0,1,0
2016-08-27 00:00:00.000000,Tajikistan,Syria,0,0,Friendly,Khujand,Tajikistan,0,144,222,105,341,39,-119,D,1,1,0
2016-08-28 00:00:00.000000,Dominican Republic,Puerto Rico,5,0,Friendly,San Cristóbal,Dominican Republic,0,138,243,114,332,24,-89,W,0,1,0
2016-08-30 00:00:00.000000,Egypt,Guinea,1,1,Friendly,Alexandria,Egypt,0,43,632,66,521,-23,111,D,1,1,0
2016-08-30 00:00:00.000000,Uganda,Kenya,0,0,Friendly,Kampala,Uganda,0,65,525,88,381,-23,144,D,1,1,0
2016-08-31 00:00:00.000000,Albania,Morocco,0,0,Friendly,Shkodër,Albania,0,37,739,53,574,-16,165,D,1,1,0
2016-08-31 00:00:00.000000,Czech Republic,Armenia,3,0,Friendly,Mladá Boleslav,Czech Republic,0,34,768,102,348,-68,420,W,0,1,0
2016-08-31 00:00:00.000000,Denmark,Liechtenstein,5,0,Friendly,Horsens,Denmark,0,44,630,182,89,-138,541,W,0,1,0
2016-08-31 00:00:00.000000,Estonia,Malta,1,1,Friendly,Pärnu,Estonia,0,117,323,176,109,-59,214,D,1,1,0
2016-08-31 00:00:00.000000,Germany,Finland,2,0,Friendly,Mönchengladbach,Germany,0,4,1319,61,540,-57,779,W,0,1,0
2016-08-31 00:00:00.000000,Lebanon,Jordan,1,1,Friendly,Beirut,Lebanon,0,149,208,79,437,70,-229,D,1,1,0
2016-08-31 00:00:00.000000,Norway,Belarus,0,1,Friendly,Oslo,Norway,0,50,588,70,507,-20,81,L,2,1,0
2016-08-31 00:00:00.000000,Turkey,Russia,0,0,Friendly,Antalya,Turkey,0,19,915,38,728,-19,187,D,1,1,0
2016-09-01 00:00:00.000000,Argentina,Uruguay,1,0,FIFA World Cup qualification,Mendoza,Argentina,0,1,1585,12,1130,-11,455,W,0,1,0
2016-09-01 00:00:00.000000,Australia,Iraq,2,0,FIFA World Cup qualification,Perth,Australia,0,57,549,113,337,-56,212,W,0,1,0
2016-09-01 00:00:00.000000,Bahrain,Singapore,3,1,Friendly,Riffa,Bahrain,0,126,289,159,167,-33,122,W,0,1,0
2016-09-01 00:00:00.000000,Belgium,Spain,0,2,Friendly,Brussels,Belgium,0,2,1401,8,1165,-6,236,L,2,1,0
2016-09-01 00:00:00.000000,Bolivia,Peru,0,3,FIFA World Cup qualification,La Paz,Bolivia,0,110,338,33,777,77,-439,L,2,1,0
2016-09-01 00:00:00.000000,Colombia,Venezuela,2,0,FIFA World Cup qualification,Barranquilla,Colombia,0,3,1331,46,621,-43,710,W,0,1,0
2016-09-01 00:00:00.000000,Ecuador,Brazil,0,3,FIFA World Cup qualification,Quito,Ecuador,0,17,1002,9,1156,8,-154,L,2,1,0
2016-09-01 00:00:00.000000,Hong Kong,Cambodia,4,2,Friendly,Kowloon,Hong Kong,0,147,213,180,100,-33,113,W,0,1,0
2016-09-01 00:00:00.000000,Iran,Qatar,2,0,FIFA World Cup qualification,Teheran,Iran,0,39,674,80,425,-41,249,W,0,1,0
2016-09-01 00:00:00.000000,Italy,France,1,3,Friendly,Bari,Italy,0,10,1155,7,1189,3,-34,L,2,1,0
2016-09-01 00:00:00.000000,Japan,United Arab Emirates,1,2,FIFA World Cup qualification,Saitama,Japan,0,49,595,74,484,-25,111,L,2,1,0
2016-09-01 00:00:00.000000,Maldives,Bangladesh,5,0,Friendly,Malé,Maldives,0,174,115,183,85,-9,30,W,0,1,0
2016-09-01 00:00:00.000000,Netherlands,Greece,1,2,Friendly,Eindhoven,Netherlands,0,26,848,52,579,-26,269,L,2,1,0
2016-09-01 00:00:00.000000,Paraguay,Chile,2,1,FIFA World Cup qualification,Asunción,Paraguay,0,42,636,5,1316,37,-680,W,0,1,0
2016-09-01 00:00:00.000000,Saudi Arabia,Thailand,1,0,FIFA World Cup qualification,Riyadh,Saudi Arabia,0,61,540,120,305,-59,235,W,0,1,0
2016-09-01 00:00:00.000000,Uzbekistan,Syria,1,0,FIFA World Cup qualification,Tashkent,Uzbekistan,0,55,560,105,341,-50,219,W,0,1,0
2016-09-02 00:00:00.000000,El Salvador,Mexico,1,3,FIFA World Cup qualification,San Salvador,El Salvador,0,137,244,14,1042,123,-798,L,2,1,0
2016-09-02 00:00:00.000000,Haiti,Costa Rica,0,1,FIFA World Cup qualification,Port-au-Prince,Haiti,0,101,349,21,883,80,-534,L,2,1,0
2016-09-02 00:00:00.000000,Honduras,Canada,2,1,FIFA World Cup qualification,San Pedro Sula,Honduras,0,84,390,100,350,-16,40,W,0,1,0
2016-09-02 00:00:00.000000,Latvia,Luxembourg,3,1,Friendly,Riga,Latvia,0,110,338,145,219,-35,119,W,0,1,0
2016-09-02 00:00:00.000000,Panama,Jamaica,2,0,FIFA World Cup qualification,Panama City,Panama,0,69,508,71,492,-2,16,W,0,1,0
2016-09-02 00:00:00.000000,South Africa,Mauritania,1,1,African Cup of Nations qualification,Nelspruit,South Africa,0,64,529,104,343,-40,186,D,1,1,0
2016-09-02 00:00:00.000000,St. Vincent and the Grenadines,USA,0,6,FIFA World Cup qualification,Kingstown,St. Vincent and the Grenadines,0,156,182,26,848,130,-666,L,2,1,0
2016-09-02 00:00:00.000000,Sudan,Gabon,1,2,Friendly,Khartoum,Sudan,0,141,231,96,359,45,-128,L,2,1,0
2016-09-02 00:00:00.000000,Trinidad and Tobago,Guatemala,2,2,FIFA World Cup qualification,Port of Spain,Trinidad and Tobago,0,68,511,82,394,-14,117,D,1,1,0
2016-09-03 00:00:00.000000,Angola,Madagascar,1,1,African Cup of Nations qualification,Luanda,Angola,0,132,259,129,273,3,-14,D,1,1,0
2016-09-03 00:00:00.000000,Cameroon,Gambia,2,0,African Cup of Nations qualification,Limbe,Cameroon,0,54,571,163,154,-109,417,W,0,1,0
2016-09-03 00:00:00.000000,Ethiopia,Seychelles,2,1,African Cup of Nations qualification,Hawassa,Ethiopia,0,130,270,183,85,-53,185,W,0,1,0
2016-09-03 00:00:00.000000,Ghana,Rwanda,1,1,African Cup of Nations qualification,Accra,Ghana,0,35,749,121,303,-86,446,D,1,1,0
2016-09-03 00:00:00.000000,India,Puerto Rico,4,1,Friendly,Bombay,India,0,152,200,114,332,38,-132,W,0,1,0
2016-09-03 00:00:00.000000,Mozambique,Mauritius,1,0,African Cup of Nations qualification,Maputo,Mozambique,0,98,357,142,225,-44,132,W,0,1,0
2016-09-03 00:00:00.000000,Nigeria,Tanzania,1,0,African Cup of Nations qualification,Uyo,Nigeria,0,67,513,124,295,-57,218,W,0,1,0
2016-09-03 00:00:00.000000,Senegal,Namibia,2,0,African Cup of Nations qualification,Dakar,Senegal,0,41,654,121,303,-80,351,W,0,1,0
2016-09-04 00:00:00.000000,Algeria,Lesotho,6,0,African Cup of Nations qualification,Blida,Algeria,0,32,781,146,214,-114,567,W,0,1,0
2016-09-04 00:00:00.000000,Bahrain,Jordan,0,0,Friendly,Isa Town,Bahrain,0,126,289,79,437,47,-148,D,1,1,0
2016-09-04 00:00:00.000000,Burkina Faso,Botswana,2,1,African Cup of Nations qualification,Ouagadougou,Burkina Faso,0,73,486,90,378,-17,108,W,0,1,0
2016-09-04 00:00:00.000000,Congo,Guinea-Bissau,1,0,African Cup of Nations qualification,Brazzaville,Congo,0,63,533,75,474,-12,59,W,0,1,0
2016-09-04 00:00:00.000000,Congo DR,Central African Republic,4,1,African Cup of Nations qualification,Kinshasa,Congo DR,0,56,554,87,386,-31,168,W,0,1,0
2016-09-04 00:00:00.000000,Czech Republic,Northern Ireland,0,0,FIFA World Cup qualification,Prague,Czech Republic,0,34,768,28,822,6,-54,D,1,1,0
2016-09-04 00:00:00.000000,Denmark,Armenia,1,0,FIFA World Cup qualification,Copenhagen,Denmark,0,44,630,102,348,-58,282,W,0,1,0
2016-09-04 00:00:00.000000,Equatorial Guinea,South Sudan,4,0,African Cup of Nations qualification,Malabo,Equatorial Guinea,0,85,389,153,197,-68,192,W,0,1,0
2016-09-04 00:00:00.000000,Kazakhstan,Poland,2,2,FIFA World Cup qualification,Astana,Kazakhstan,0,96,359,16,1011,80,-652,D,1,1,0
2016-09-04 00:00:00.000000,Lithuania,Slovenia,2,2,FIFA World Cup qualification,Vilnius,Lithuania,0,125,293,59,542,66,-249,D,1,1,0
2016-09-04 00:00:00.000000,Malawi,Swaziland,1,0,African Cup of Nations qualification,Blantyre,Malawi,0,127,286,103,344,24,-58,W,0,1,0
2016-09-04 00:00:00.000000,Malta,Scotland,1,5,FIFA World Cup qualification,Attard,Malta,0,176,109,51,584,125,-475,L,2,1,0
2016-09-04 00:00:00.000000,Norway,Germany,0,3,FIFA World Cup qualification,Oslo,Norway,0,50,588,4,1319,46,-731,L,2,1,0
2016-09-04 00:00:00.000000,Romania,Montenegro,1,1,FIFA World Cup qualification,Cluj,Romania,0,25,856,95,365,-70,491,D,1,1,0
2016-09-04 00:00:00.000000,San Marino,Azerbaijan,0,1,FIFA World Cup qualification,Serravalle,San Marino,0,200,20,136,253,64,-233,L,2,1,0
2016-09-04 00:00:00.000000,Slovakia,England,0,1,FIFA World Cup qualification,Trnava,Slovakia,0,24,867,13,1107,11,-240,L,2,1,0
2016-09-04 00:00:00.000000,Tunisia,Liberia,4,1,African Cup of Nations qualification,Monastir,Tunisia,0,45,627,92,370,-47,257,W,0,1,0
2016-09-04 00:00:00.000000,Uganda,Comoros,1,0,African Cup of Nations qualification,Kampala,Uganda,0,65,525,155,191,-90,334,W,0,1,0
2016-09-04 00:00:00.000000,Zambia,Kenya,1,1,African Cup of Nations qualification,Ndola,Zambia,0,91,376,88,381,3,-5,D,1,1,0
2016-09-05 00:00:00.000000,Croatia,Turkey,1,1,FIFA World Cup qualification,Zagreb,Croatia,0,15,1022,19,915,-4,107,D,1,1,0
2016-09-05 00:00:00.000000,Finland,Kosovo,1,1,FIFA World Cup qualification,Turku,Finland,0,61,540,190,66,-129,474,D,1,1,0
2016-09-05 00:00:00.000000,Georgia,Austria,1,2,FIFA World Cup qualification,Tbilisi,Georgia,0,118,318,22,875,96,-557,L,2,1,0
2016-09-05 00:00:00.000000,Israel,Italy,1,3,FIFA World Cup qualification,Haifa,Israel,0,76,471,10,1155,66,-684,L,2,1,0
2016-09-05 00:00:00.000000,Lebanon,Afghanistan,2,0,Friendly,Beirut,Lebanon,0,149,208,150,206,-1,2,W,0,1,0
2016-09-05 00:00:00.000000,Spain,Liechtenstein,8,0,FIFA World Cup qualification,León,Spain,0,8,1165,182,89,-174,1076,W,0,1,0
2016-09-05 00:00:00.000000,Ukraine,Iceland,1,1,FIFA World Cup qualification,Kyïv,Ukraine,0,30,801,23,871,7,-70,D,1,1,0
2016-09-05 00:00:00.000000,Wales,Moldova,4,0,FIFA World Cup qualification,Cardiff,Wales,0,11,1137,165,151,-154,986,W,0,1,0
2016-09-06 00:00:00.000000,Andorra,Latvia,0,1,FIFA World Cup qualification,Sant Julià de Lòria,Andorra,0,203,12,110,338,93,-326,L,2,1,0
2016-09-06 00:00:00.000000,Bangladesh,Bhutan,0,0,AFC Asian Cup qualification,Dhaka,Bangladesh,0,183,85,192,64,-9,21,D,1,1,0
2016-09-06 00:00:00.000000,Belarus,France,0,0,FIFA World Cup qualification,Barysaw,Belarus,0,70,507,7,1189,63,-682,D,1,1,0
2016-09-06 00:00:00.000000,Brazil,Colombia,2,1,FIFA World Cup qualification,Manaus,Brazil,0,9,1156,3,1331,6,-175,W,0,1,0
2016-09-06 00:00:00.000000,Bulgaria,Luxembourg,4,3,FIFA World Cup qualification,Sofia,Bulgaria,0,77,446,145,219,-68,227,W,0,1,0
2016-09-06 00:00:00.000000,Cameroon,Gabon,2,1,Friendly,Limbe,Cameroon,0,54,571,96,359,-42,212,W,0,1,0
2016-09-06 00:00:00.000000,Canada,El Salvador,3,1,FIFA World Cup qualification,Vancouver,Canada,0,100,350,137,244,-37,106,W,0,1,0
2016-09-06 00:00:00.000000,Chile,Bolivia,3,0,FIFA World Cup qualification,Santiago,Chile,0,5,1316,110,338,-105,978,W,0,1,0
2016-09-06 00:00:00.000000,Costa Rica,Panama,3,1,FIFA World Cup qualification,San José,Costa Rica,0,21,883,69,508,-48,375,W,0,1,0
2016-09-06 00:00:00.000000,Cyprus,Belgium,0,3,FIFA World Cup qualification,Nicosia,Cyprus,0,86,387,2,1401,84,-1014,L,2,1,0
2016-09-06 00:00:00.000000,Faroe Islands,Hungary,0,0,FIFA World Cup qualification,Tórshavn,Faroe Islands,0,135,254,19,915,116,-661,D,1,1,0
2016-09-06 00:00:00.000000,Indonesia,Malaysia,3,0,Friendly,Surakarta,Indonesia,0,191,65,167,148,24,-83,W,0,1,0
2016-09-06 00:00:00.000000,Iraq,Saudi Arabia,1,2,FIFA World Cup qualification,Shah Alam,Malaysia,1,113,337,61,540,52,-203,L,2,0,0
2016-09-06 00:00:00.000000,Jamaica,Haiti,0,2,FIFA World Cup qualification,Kingston,Jamaica,0,71,492,101,349,-30,143,L,2,1,0
2016-09-06 00:00:00.000000,Maldives,Laos,4,0,AFC Asian Cup qualification,Malé,Maldives,0,174,115,177,107,-3,8,W,0,1,0
2016-09-06 00:00:00.000000,Mexico,Honduras,0,0,FIFA World Cup qualification,Mexico City,Mexico,0,14,1042,84,390,-70,652,D,1,1,0
2016-09-06 00:00:00.000000,Palestine,Tajikistan,1,1,Friendly,Hebron,Palestine,0,115,326,144,222,-29,104,D,1,1,0
2016-09-06 00:00:00.000000,Peru,Ecuador,2,1,FIFA World Cup qualification,Lima,Peru,0,33,777,17,1002,16,-225,W,0,1,0
2016-09-06 00:00:00.000000,Qatar,Uzbekistan,0,1,FIFA World Cup qualification,Doha,Qatar,0,80,425,55,560,25,-135,L,2,1,0
2016-09-06 00:00:00.000000,Russia,Ghana,1,0,Friendly,Moscow,Russia,0,38,728,35,749,3,-21,W,0,1,0
2016-09-06 00:00:00.000000,South Africa,Egypt,1,0,Friendly,Johannesburg,South Africa,0,64,529,43,632,21,-103,W,0,1,0
2016-09-06 00:00:00.000000,Sweden,Netherlands,1,1,FIFA World Cup qualification,Solna,Sweden,0,40,656,26,848,14,-192,D,1,1,0
2016-09-06 00:00:00.000000,Switzerland,Portugal,2,0,FIFA World Cup qualification,Basel,Switzerland,0,18,957,6,1266,12,-309,W,0,1,0
2016-09-06 00:00:00.000000,Syria,Korea Republic,0,0,FIFA World Cup qualification,Paroi,Malaysia,1,105,341,48,609,57,-268,D,1,0,0
2016-09-06 00:00:00.000000,Thailand,Japan,0,2,FIFA World Cup qualification,Bangkok,Thailand,0,120,305,49,595,71,-290,L,2,1,0
2016-09-06 00:00:00.000000,United Arab Emirates,Australia,0,1,FIFA World Cup qualification,Abu Dhabi,United Arab Emirates,0,74,484,57,549,17,-65,L,2,1,0
2016-09-06 00:00:00.000000,Uruguay,Paraguay,4,0,FIFA World Cup qualification,Montevideo,Uruguay,0,12,1130,42,636,-30,494,W,0,1,0
2016-09-06 00:00:00.000000,USA,Trinidad and Tobago,4,0,FIFA World Cup qualification,Jacksonville,USA,0,26,848,68,511,-42,337,W,0,1,0
2016-09-06 00:00:00.000000,Venezuela,Argentina,2,2,FIFA World Cup qualification,Mérida,Venezuela,0,46,621,1,1585,45,-964,D,1,1,0
2016-09-29 00:00:00.000000,Qatar,Serbia,3,0,Friendly,Doha,Qatar,0,85,389,50,602,35,-213,W,0,1,0
2016-09-30 00:00:00.000000,Botswana,Angola,1,1,Friendly,Gaborone,Botswana,0,97,348,134,247,-37,101,D,1,1,0
2016-10-04 00:00:00.000000,Congo DR,Kenya,0,1,Friendly,Kinshasa,Congo DR,0,51,589,91,378,-40,211,L,2,1,0
2016-10-04 00:00:00.000000,Togo,Uganda,1,0,Friendly,Lomé,Togo,0,100,334,65,509,35,-175,W,0,1,0
2016-10-05 00:00:00.000000,Curaçao,Antigua and Barbuda,3,0,CFU Caribbean Cup qualification,Willemstad,Curaçao,0,122,299,89,381,33,-82,W,0,1,0
2016-10-05 00:00:00.000000,Solomon Islands,New Caledonia,0,3,Friendly,Honiara,Solomon Islands,0,186,74,162,152,24,-78,L,2,1,0
2016-10-05 00:00:00.000000,Tajikistan,Palestine,3,3,Friendly,Dushanbe,Tajikistan,0,144,215,118,302,26,-87,D,1,1,0
2016-10-05 00:00:00.000000,Trinidad and Tobago,Dominican Republic,4,0,CFU Caribbean Cup qualification,Couva,Trinidad and Tobago,0,69,490,114,315,-45,175,W,0,1,0
2016-10-06 00:00:00.000000,Austria,Wales,2,2,FIFA World Cup qualification,Vienna,Austria,0,26,839,10,1161,16,-322,D,1,1,0
2016-10-06 00:00:00.000000,Brazil,Bolivia,5,0,FIFA World Cup qualification,Natal,Brazil,0,4,1323,75,468,-71,855,W,0,1,0
2016-10-06 00:00:00.000000,Cambodia,Hong Kong,0,2,Friendly,Phnom Penh,Cambodia,0,173,103,142,221,31,-118,L,2,1,0
2016-10-06 00:00:00.000000,Ecuador,Chile,3,0,FIFA World Cup qualification,Quito,Ecuador,0,19,917,6,1284,13,-367,W,0,1,0
2016-10-06 00:00:00.000000,Iceland,Finland,3,2,FIFA World Cup qualification,Reykjavík,Iceland,0,27,829,84,409,-57,420,W,0,1,0
2016-10-06 00:00:00.000000,Italy,Spain,1,1,FIFA World Cup qualification,Turin,Italy,0,13,1124,11,1141,2,-17,D,1,1,0
2016-10-06 00:00:00.000000,Japan,Iraq,2,1,FIFA World Cup qualification,Saitama,Japan,0,56,574,128,279,-72,295,W,0,1,0
2016-10-06 00:00:00.000000,Korea Republic,Qatar,3,2,FIFA World Cup qualification,Suwon,Korea Republic,0,47,634,85,389,-38,245,W,0,1,0
2016-10-06 00:00:00.000000,Kosovo,Croatia,0,6,FIFA World Cup qualification,Shkodër,Albania,1,168,135,14,1059,154,-924,L,2,0,0
2016-10-06 00:00:00.000000,Liechtenstein,Albania,0,2,FIFA World Cup qualification,Vaduz,Liechtenstein,0,182,86,40,678,142,-592,L,2,1,0
2016-10-06 00:00:00.000000,Mauritania,Canada,0,4,Friendly,Marrakech,Morocco,1,96,349,103,329,-7,20,L,2,0,0
2016-10-06 00:00:00.000000,Moldova,Serbia,0,3,FIFA World Cup qualification,Chișinău,Moldova,0,161,154,50,602,111,-448,L,2,1,0
2016-10-06 00:00:00.000000,Paraguay,Colombia,0,1,FIFA World Cup qualification,Asunción,Paraguay,0,36,720,4,1323,32,-603,L,2,1,0
2016-10-06 00:00:00.000000,Peru,Argentina,2,2,FIFA World Cup qualification,Lima,Peru,0,25,841,1,1646,24,-805,D,1,1,0
2016-10-06 00:00:00.000000,Saudi Arabia,Australia,2,2,FIFA World Cup qualification,Jeddah,Saudi Arabia,0,52,588,45,643,7,-55,D,1,1,0
2016-10-06 00:00:00.000000,Turkey,Ukraine,2,2,FIFA World Cup qualification,Konya,Turkey,0,21,885,29,799,-8,86,D,1,1,0
2016-10-06 00:00:00.000000,United Arab Emirates,Thailand,3,1,FIFA World Cup qualification,Abu Dhabi,United Arab Emirates,0,66,504,135,246,-69,258,W,0,1,0
2016-10-06 00:00:00.000000,Uruguay,Venezuela,3,0,FIFA World Cup qualification,Montevideo,Uruguay,0,9,1173,60,562,-51,611,W,0,1,0
2016-10-06 00:00:00.000000,Uzbekistan,Iran,0,1,FIFA World Cup qualification,Tashkent,Uzbekistan,0,49,621,37,712,12,-91,L,2,1,0
2016-10-06 00:00:00.000000,Vietnam,Korea DPR,5,2,Friendly,Ho Chi Minh City,Vietnam,0,141,225,118,302,23,-77,W,0,1,0
2016-10-07 00:00:00.000000,Cuba,USA,0,2,Friendly,Havana,Cuba,0,139,229,22,874,117,-645,L,2,1,0
2016-10-07 00:00:00.000000,Estonia,Gibraltar,4,0,FIFA World Cup qualification,Tallinn,Estonia,0,130,274,205,0,-75,274,W,0,1,0
2016-10-07 00:00:00.000000,France,Bulgaria,4,1,FIFA World Cup qualification,Saint-Denis,France,0,8,1188,74,470,-66,718,W,0,1,0
2016-10-07 00:00:00.000000,Ghana,Uganda,0,0,FIFA World Cup qualification,Tamale,Ghana,0,43,658,65,509,-22,149,D,1,1,0
2016-10-07 00:00:00.000000,Greece,Cyprus,2,0,FIFA World Cup qualification,Piraeus,Greece,0,48,622,87,384,-39,238,W,0,1,0
2016-10-07 00:00:00.000000,Hungary,Switzerland,2,3,FIFA World Cup qualification,Budapest,Hungary,0,20,913,16,1020,4,-107,L,2,1,0
2016-10-07 00:00:00.000000,Latvia,Faroe Islands,0,2,FIFA World Cup qualification,Riga,Latvia,0,95,357,111,319,-16,38,L,2,1,0
2016-10-07 00:00:00.000000,Luxembourg,Sweden,0,1,FIFA World Cup qualification,Luxembourg,Luxembourg,0,145,213,41,677,104,-464,L,2,1,0
2016-10-07 00:00:00.000000,Netherlands,Belarus,4,1,FIFA World Cup qualification,Rotterdam,Netherlands,0,24,861,57,573,-33,288,W,0,1,0
2016-10-07 00:00:00.000000,Oman,Jordan,1,1,Friendly,Muscat,Oman,0,110,323,86,387,24,-64,D,1,1,0
2016-10-07 00:00:00.000000,Philippines,Bahrain,1,3,Friendly,Manila,Philippines,0,125,297,126,284,-1,13,L,2,1,0
2016-10-07 00:00:00.000000,Portugal,Andorra,6,0,FIFA World Cup qualification,Aveiro,Portugal,0,7,1228,203,11,-196,1217,W,0,1,0
2016-10-07 00:00:00.000000,Singapore,Malaysia,0,0,Friendly,Kallang,Singapore,0,155,176,158,158,-3,18,D,1,1,0
2016-10-08 00:00:00.000000,Armenia,Romania,0,5,FIFA World Cup qualification,Yerevan,Armenia,0,112,317,32,773,80,-456,L,2,1,0
2016-10-08 00:00:00.000000,Azerbaijan,Norway,1,0,FIFA World Cup qualification,Baku,Azerbaijan,0,133,252,70,487,63,-235,W,0,1,0
2016-10-08 00:00:00.000000,Belize,Honduras,1,2,Friendly,Belmopan,Belize,0,166,141,82,421,84,-280,L,2,1,0
2016-10-08 00:00:00.000000,Burkina Faso,South Africa,1,1,FIFA World Cup qualification,Ouagadougou,Burkina Faso,0,67,502,62,539,5,-37,D,1,1,0
2016-10-08 00:00:00.000000,Congo DR,Libya,4,0,FIFA World Cup qualification,Kinshasa,Congo DR,0,51,589,76,466,-25,123,W,0,1,0
2016-10-08 00:00:00.000000,England,Malta,2,0,FIFA World Cup qualification,London,England,0,12,1130,176,99,-164,1031,W,0,1,0
2016-10-08 00:00:00.000000,Gabon,Morocco,0,0,FIFA World Cup qualification,Franceville,Gabon,0,108,324,58,570,50,-246,D,1,1,0
2016-10-08 00:00:00.000000,Germany,Czech Republic,3,0,FIFA World Cup qualification,Hamburg,Germany,0,3,1347,33,762,-30,585,W,0,1,0
2016-10-08 00:00:00.000000,Mexico,New Zealand,2,1,Friendly,Nashville,USA,1,15,1057,88,382,-73,675,W,0,0,0
2016-10-08 00:00:00.000000,Montenegro,Kazakhstan,5,0,FIFA World Cup qualification,Podgorica,Montenegro,0,105,326,83,411,22,-85,W,0,1,0
2016-10-08 00:00:00.000000,Northern Ireland,San Marino,4,0,FIFA World Cup qualification,Belfast,Northern Ireland,0,30,798,201,17,-171,781,W,0,1,0
2016-10-08 00:00:00.000000,Poland,Denmark,3,2,FIFA World Cup qualification,Warsaw,Poland,0,17,984,46,637,-29,347,W,0,1,0
2016-10-08 00:00:00.000000,Scotland,Lithuania,1,1,FIFA World Cup qualification,Glasgow,Scotland,0,44,652,117,311,-73,341,D,1,1,0
2016-10-08 00:00:00.000000,Slovenia,Slovakia,1,0,FIFA World Cup qualification,Ljubljana,Slovenia,0,67,502,28,820,39,-318,W,0,1,0
2016-10-08 00:00:00.000000,Solomon Islands,New Caledonia,0,1,Friendly,Honiara,Solomon Islands,0,186,74,162,152,24,-78,L,2,1,0
2016-10-08 00:00:00.000000,Suriname,Guyana,3,2,CFU Caribbean Cup qualification,Paramaribo,Suriname,0,175,100,118,302,57,-202,W,0,1,0
2016-10-09 00:00:00.000000,Albania,Spain,0,2,FIFA World Cup qualification,Shkodër,Albania,0,40,678,11,1141,29,-463,L,2,1,0
2016-10-09 00:00:00.000000,Algeria,Cameroon,1,1,FIFA World Cup qualification,Blida,Algeria,0,35,749,59,565,-24,184,D,1,1,0
2016-10-09 00:00:00.000000,Cambodia,Sri Lanka,4,0,Friendly,Phnom Penh,Cambodia,0,173,103,193,52,-20,51,W,0,1,0
2016-10-09 00:00:00.000000,Congo,Egypt,1,2,FIFA World Cup qualification,Brazzaville,Congo,0,54,585,53,587,1,-2,L,2,1,0
2016-10-09 00:00:00.000000,Finland,Croatia,0,1,FIFA World Cup qualification,Tampere,Finland,0,84,409,14,1059,70,-650,L,2,1,0
2016-10-09 00:00:00.000000,Iceland,Turkey,2,0,FIFA World Cup qualification,Reykjavík,Iceland,0,27,829,21,885,6,-56,W,0,1,0
2016-10-09 00:00:00.000000,Indonesia,Vietnam,2,2,Friendly,Sleman,Indonesia,0,181,89,141,225,40,-136,D,1,1,0
2016-10-09 00:00:00.000000,Israel,Liechtenstein,2,1,FIFA World Cup qualification,Jerusalem,Israel,0,98,346,182,86,-84,260,W,0,1,0
2016-10-09 00:00:00.000000,Russia,Costa Rica,3,4,Friendly,Krasnodar,Russia,0,38,685,18,943,20,-258,L,2,1,0
2016-10-09 00:00:00.000000,Serbia,Austria,3,2,FIFA World Cup qualification,Belgrade,Serbia,0,50,602,26,839,24,-237,W,0,1,0
2016-10-09 00:00:00.000000,Togo,Mozambique,2,0,Friendly,Lomé,Togo,0,100,334,89,381,11,-47,W,0,1,0
2016-10-09 00:00:00.000000,Tunisia,Guinea,2,0,FIFA World Cup qualification,Monastir,Tunisia,0,42,662,61,549,-19,113,W,0,1,0
2016-10-09 00:00:00.000000,Ukraine,Kosovo,3,0,FIFA World Cup qualification,Cracow,Poland,1,29,799,168,135,-139,664,W,0,0,0
2016-10-09 00:00:00.000000,Wales,Georgia,1,1,FIFA World Cup qualification,Cardiff,Wales,0,10,1161,137,240,-127,921,D,1,1,0
2016-10-09 00:00:00.000000,Zambia,Nigeria,1,2,FIFA World Cup qualification,Ndola,Zambia,0,92,377,64,534,28,-157,L,2,1,0
2016-10-10 00:00:00.000000,Andorra,Switzerland,1,2,FIFA World Cup qualification,Sant Julià de Lòria,Andorra,0,203,11,16,1020,187,-1009,L,2,1,0
2016-10-10 00:00:00.000000,Belarus,Luxembourg,1,1,FIFA World Cup qualification,Barysaw,Belarus,0,57,573,145,213,-88,360,D,1,1,0
2016-10-10 00:00:00.000000,Bhutan,Bangladesh,3,1,AFC Asian Cup qualification,Thimphu,Bhutan,0,189,65,185,75,4,-10,W,0,1,0
2016-10-10 00:00:00.000000,Estonia,Greece,0,2,FIFA World Cup qualification,Tallinn,Estonia,0,130,274,48,622,82,-348,L,2,1,0
2016-10-10 00:00:00.000000,Faroe Islands,Portugal,0,6,FIFA World Cup qualification,Tórshavn,Faroe Islands,0,111,319,7,1228,104,-909,L,2,1,0
2016-10-10 00:00:00.000000,Gibraltar,Belgium,0,6,FIFA World Cup qualification,Faro,Portugal,1,205,0,2,1369,203,-1369,L,2,0,0
2016-10-10 00:00:00.000000,Latvia,Hungary,0,2,FIFA World Cup qualification,Riga,Latvia,0,95,357,20,913,75,-556,L,2,1,0
2016-10-10 00:00:00.000000,Netherlands,France,0,1,FIFA World Cup qualification,Amsterdam,Netherlands,0,24,861,8,1188,16,-327,L,2,1,0
2016-10-10 00:00:00.000000,Philippines,Korea DPR,1,3,Friendly,Manila,Philippines,0,125,297,118,302,7,-5,L,2,1,0
2016-10-10 00:00:00.000000,Sweden,Bulgaria,3,0,FIFA World Cup qualification,Solna,Sweden,0,41,677,74,470,-33,207,W,0,1,0
2016-10-11 00:00:00.000000,Argentina,Paraguay,0,1,FIFA World Cup qualification,Córdoba,Argentina,0,1,1646,36,720,-35,926,L,2,1,0
2016-10-11 00:00:00.000000,Australia,Japan,1,1,FIFA World Cup qualification,Melbourne,Australia,0,45,643,56,574,-11,69,D,1,1,0
2016-10-11 00:00:00.000000,Bolivia,Ecuador,2,2,FIFA World Cup qualification,La Paz,Bolivia,0,75,468,19,917,56,-449,D,1,1,0
2016-10-11 00:00:00.000000,Chile,Peru,2,1,FIFA World Cup qualification,Santiago,Chile,0,6,1284,25,841,-19,443,W,0,1,0
2016-10-11 00:00:00.000000,Colombia,Uruguay,2,2,FIFA World Cup qualification,Barranquilla,Colombia,0,4,1323,9,1173,-5,150,D,1,1,0
2016-10-11 00:00:00.000000,Czech Republic,Azerbaijan,0,0,FIFA World Cup qualification,Ostrava,Czech Republic,0,33,762,133,252,-100,510,D,1,1,0
2016-10-11 00:00:00.000000,Denmark,Montenegro,0,1,FIFA World Cup qualification,Copenhagen,Denmark,0,46,637,105,326,-59,311,L,2,1,0
2016-10-11 00:00:00.000000,Germany,Northern Ireland,2,0,FIFA World Cup qualification,Hanover,Germany,0,3,1347,30,798,-27,549,W,0,1,0
2016-10-11 00:00:00.000000,Hong Kong,Singapore,2,0,Friendly,Kowloon,Hong Kong,0,142,221,155,176,-13,45,W,0,1,0
2016-10-11 00:00:00.000000,Iran,Korea Republic,1,0,FIFA World Cup qualification,Teheran,Iran,0,37,712,47,634,-10,78,W,0,1,0
2016-10-11 00:00:00.000000,Iraq,Thailand,4,0,FIFA World Cup qualification,Teheran,Iran,1,128,279,135,246,-7,33,W,0,0,0
2016-10-11 00:00:00.000000,Kazakhstan,Romania,0,0,FIFA World Cup qualification,Astana,Kazakhstan,0,83,411,32,773,51,-362,D,1,1,0
2016-10-11 00:00:00.000000,Laos,Maldives,1,1,AFC Asian Cup qualification,Vientiane,Laos,0,176,99,165,147,11,-48,D,1,1,0
2016-10-11 00:00:00.000000,Lebanon,Equatorial Guinea,1,1,Friendly,Beirut,Lebanon,0,143,218,81,424,62,-206,D,1,1,0
2016-10-11 00:00:00.000000,Lithuania,Malta,2,0,FIFA World Cup qualification,Vilnius,Lithuania,0,117,311,176,99,-59,212,W,0,1,0
2016-10-11 00:00:00.000000,Malaysia,Afghanistan,1,1,Friendly,Shah Alam,Malaysia,0,158,158,149,201,9,-43,D,1,1,0
2016-10-11 00:00:00.000000,Mexico,Panama,1,0,Friendly,Bridgeview,USA,1,15,1057,62,539,-47,518,W,0,0,0
2016-10-11 00:00:00.000000,Morocco,Canada,4,0,Friendly,Marrakech,Morocco,0,58,570,103,329,-45,241,W,0,1,0
2016-10-11 00:00:00.000000,Norway,San Marino,4,1,FIFA World Cup qualification,Oslo,Norway,0,70,487,201,17,-131,470,W,0,1,0
2016-10-11 00:00:00.000000,Oman,Bahrain,2,2,Friendly,Muscat,Oman,0,110,323,126,284,-16,39,D,1,1,0
2016-10-11 00:00:00.000000,Poland,Armenia,2,1,FIFA World Cup qualification,Warsaw,Poland,0,17,984,112,317,-95,667,W,0,1,0
2016-10-11 00:00:00.000000,Puerto Rico,Curaçao,2,4,CFU Caribbean Cup qualification,Bayamón,Puerto Rico,0,138,234,122,299,16,-65,L,2,1,0
2016-10-11 00:00:00.000000,Qatar,Syria,1,0,FIFA World Cup qualification,Doha,Qatar,0,85,389,114,315,-29,74,W,0,1,0
2016-10-11 00:00:00.000000,Saudi Arabia,United Arab Emirates,3,0,FIFA World Cup qualification,Jeddah,Saudi Arabia,0,52,588,66,504,-14,84,W,0,1,0
2016-10-11 00:00:00.000000,Slovakia,Scotland,3,0,FIFA World Cup qualification,Trnava,Slovakia,0,28,820,44,652,-16,168,W,0,1,0
2016-10-11 00:00:00.000000,Slovenia,England,0,0,FIFA World Cup qualification,Ljubljana,Slovenia,0,67,502,12,1130,55,-628,D,1,1,0
2016-10-11 00:00:00.000000,South Africa,Ghana,1,1,Friendly,Durban,South Africa,0,62,539,43,658,19,-119,D,1,1,0
2016-10-11 00:00:00.000000,Venezuela,Brazil,0,2,FIFA World Cup qualification,Mérida,Venezuela,0,60,562,4,1323,56,-761,L,2,1,0
2016-10-15 00:00:00.000000,Cambodia,Laos,2,1,AFF Championship,Phnom Penh,Cambodia,0,173,103,176,99,-3,4,W,0,1,0
2016-11-03 00:00:00.000000,Macau,Mongolia,2,1,AFC Challenge Cup,Kuching,Malaysia,1,196,40,202,13,-6,27,W,0,0,0
2016-11-03 00:00:00.000000,Sri Lanka,Laos,1,2,AFC Challenge Cup,Kuching,Malaysia,1,194,48,175,107,19,-59,L,2,0,0
2016-11-05 00:00:00.000000,Zimbabwe,Zambia,1,0,Friendly,Harare,Zimbabwe,0,110,323,94,374,16,-51,W,0,1,0
2016-11-06 00:00:00.000000,Hong Kong,Guam,3,2,EAFF Championship,Kowloon,Hong Kong,0,140,227,182,86,-42,141,W,0,1,0
2016-11-06 00:00:00.000000,Jordan,Iraq,0,0,Friendly,Amman,Jordan,0,104,332,113,314,-9,18,D,1,1,0
2016-11-06 00:00:00.000000,Laos,Macau,1,4,AFC Challenge Cup,Kuching,Malaysia,1,175,107,196,40,-21,67,L,2,0,0
2016-11-06 00:00:00.000000,Mongolia,Sri Lanka,2,0,AFC Challenge Cup,Kuching,Malaysia,1,202,13,194,48,8,-35,W,0,0,0
2016-11-07 00:00:00.000000,Tahiti,Solomon Islands,3,0,FIFA World Cup qualification,Pirae,French Polynesia,1,172,120,193,56,-21,64,W,0,0,0
2016-11-08 00:00:00.000000,Uganda,Zambia,0,1,Friendly,Kampala,Uganda,0,72,500,94,374,-22,126,L,2,1,0
2016-11-08 00:00:00.000000,Vietnam,Indonesia,3,2,Friendly,Hanoi,Vietnam,0,136,231,179,93,-43,138,W,0,1,0
2016-11-09 00:00:00.000000,Greece,Belarus,0,1,Friendly,Piraeus,Greece,0,42,656,77,452,-35,204,L,2,1,0
2016-11-09 00:00:00.000000,Guam,Korea DPR,0,2,EAFF Championship,Kowloon,Hong Kong,1,182,86,126,267,56,-181,L,2,0,0
2016-11-09 00:00:00.000000,Mongolia,Laos,0,3,AFC Challenge Cup,Kuching,Malaysia,1,202,13,175,107,27,-94,L,2,0,0
2016-11-09 00:00:00.000000,Netherlands,Belgium,1,1,Friendly,Amsterdam,Netherlands,0,20,901,4,1382,16,-481,D,1,1,0
2016-11-09 00:00:00.000000,Sri Lanka,Macau,1,1,AFC Challenge Cup,Kuching,Malaysia,1,194,48,196,40,-2,8,D,1,0,0
2016-11-09 00:00:00.000000,Syria,Singapore,2,0,Friendly,Paroi,Malaysia,1,96,357,171,122,-75,235,W,0,0,0
2016-11-09 00:00:00.000000,Tajikistan,Turkmenistan,3,0,Friendly,Dushanbe,Tajikistan,0,140,227,114,309,26,-82,W,0,1,0
2016-11-09 00:00:00.000000,United Arab Emirates,Bahrain,2,0,Friendly,al-Ain,United Arab Emirates,0,70,513,123,272,-53,241,W,0,1,0
2016-11-10 00:00:00.000000,Brazil,Argentina,3,0,FIFA World Cup qualification,Belo Horizonte,Brazil,0,3,1410,1,1621,2,-211,W,0,1,0
2016-11-10 00:00:00.000000,Colombia,Chile,0,0,FIFA World Cup qualification,Barranquilla,Colombia,0,5,1361,6,1273,-1,88,D,1,1,0
2016-11-10 00:00:00.000000,Iran,Papua New Guinea,8,1,Friendly,Shah Alam,Malaysia,1,27,837,159,152,-132,685,W,0,0,0
2016-11-10 00:00:00.000000,Lebanon,Palestine,1,1,Friendly,Beirut,Lebanon,0,149,202,120,285,29,-83,D,1,1,0
2016-11-10 00:00:00.000000,Paraguay,Peru,1,4,FIFA World Cup qualification,Asunción,Paraguay,0,37,738,23,865,14,-127,L,2,1,0
2016-11-10 00:00:00.000000,Qatar,Russia,2,1,Friendly,Doha,Qatar,0,91,385,53,594,38,-209,W,0,1,0
2016-11-10 00:00:00.000000,Uruguay,Ecuador,2,1,FIFA World Cup qualification,Montevideo,Uruguay,0,9,1175,19,932,-10,243,W,0,1,0
2016-11-10 00:00:00.000000,Uzbekistan,Jordan,1,0,Friendly,Tashkent,Uzbekistan,0,48,617,104,332,-56,285,W,0,1,0
2016-11-10 00:00:00.000000,Venezuela,Bolivia,5,0,FIFA World Cup qualification,Maturín,Venezuela,0,68,516,80,444,-12,72,W,0,1,0
2016-11-11 00:00:00.000000,Armenia,Montenegro,3,2,FIFA World Cup qualification,Yerevan,Armenia,0,125,270,56,570,69,-300,W,0,1,0
2016-11-11 00:00:00.000000,Czech Republic,Norway,2,1,FIFA World Cup qualification,Prague,Czech Republic,0,40,663,81,438,-41,225,W,0,1,0
2016-11-11 00:00:00.000000,Denmark,Kazakhstan,4,1,FIFA World Cup qualification,Copenhagen,Denmark,0,50,606,90,386,-40,220,W,0,1,0
2016-11-11 00:00:00.000000,England,Scotland,3,0,FIFA World Cup qualification,London,England,0,12,1090,57,569,-45,521,W,0,1,0
2016-11-11 00:00:00.000000,France,Sweden,2,1,FIFA World Cup qualification,Saint-Denis,France,0,7,1271,39,715,-32,556,W,0,1,0
2016-11-11 00:00:00.000000,Honduras,Panama,0,1,FIFA World Cup qualification,San Pedro Sula,Honduras,0,86,411,63,551,23,-140,L,2,1,0
2016-11-11 00:00:00.000000,Japan,Oman,4,0,Friendly,Kashima,Japan,0,51,601,129,260,-78,341,W,0,1,0
2016-11-11 00:00:00.000000,Korea Republic,Canada,2,0,Friendly,Cheonan,Korea Republic,0,44,640,110,323,-66,317,W,0,1,0
2016-11-11 00:00:00.000000,Libya,Tunisia,0,1,FIFA World Cup qualification,Algiers,Algeria,1,76,461,38,721,38,-260,L,2,0,0
2016-11-11 00:00:00.000000,Malta,Slovenia,0,1,FIFA World Cup qualification,Attard,Malta,0,178,97,52,595,126,-498,L,2,1,0
2016-11-11 00:00:00.000000,Northern Ireland,Azerbaijan,4,0,FIFA World Cup qualification,Belfast,Northern Ireland,0,36,739,88,404,-52,335,W,0,1,0
2016-11-11 00:00:00.000000,Romania,Poland,0,3,FIFA World Cup qualification,Bucharest,Romania,0,34,746,15,1029,19,-283,L,2,1,0
2016-11-11 00:00:00.000000,San Marino,Germany,0,8,FIFA World Cup qualification,Serravalle,San Marino,0,201,17,2,1465,199,-1448,L,2,1,0
2016-11-11 00:00:00.000000,Slovakia,Lithuania,4,0,FIFA World Cup qualification,Trnava,Slovakia,0,26,840,98,347,-72,493,W,0,1,0
2016-11-11 00:00:00.000000,Togo,Comoros,2,2,Friendly,Tunis,Tunisia,1,93,375,143,223,-50,152,D,1,0,0
2016-11-12 00:00:00.000000,Albania,Israel,0,3,FIFA World Cup qualification,Elbasan,Albania,0,47,619,79,450,-32,169,L,2,1,0
2016-11-12 00:00:00.000000,Cameroon,Zambia,1,1,FIFA World Cup qualification,Limbe,Cameroon,0,59,567,94,374,-35,193,D,1,1,0
2016-11-12 00:00:00.000000,Croatia,Iceland,2,0,FIFA World Cup qualification,Zagreb,Croatia,0,16,1027,21,898,-5,129,W,0,1,0
2016-11-12 00:00:00.000000,Georgia,Moldova,1,1,FIFA World Cup qualification,Tbilisi,Georgia,0,122,276,173,119,-51,157,D,1,1,0
2016-11-12 00:00:00.000000,Hong Kong,Korea DPR,0,1,EAFF Championship,Kowloon,Hong Kong,0,140,227,126,267,14,-40,L,2,1,0
2016-11-12 00:00:00.000000,Kenya,Mozambique,1,0,Friendly,Nairobi,Kenya,0,85,416,95,359,-10,57,W,0,1,0
2016-11-12 00:00:00.000000,Liechtenstein,Italy,0,4,FIFA World Cup qualification,Vaduz,Liechtenstein,0,183,81,13,1082,170,-1001,L,2,1,0
2016-11-12 00:00:00.000000,Mali,Gabon,0,0,FIFA World Cup qualification,Bamako,Mali,0,58,568,110,323,-52,245,D,1,1,0
2016-11-12 00:00:00.000000,Nepal,Laos,2,2,AFC Challenge Cup,Kuching,Malaysia,1,186,74,175,107,11,-33,D,1,0,0
2016-11-12 00:00:00.000000,New Zealand,New Caledonia,2,0,FIFA World Cup qualification,Auckland,New Zealand,0,116,306,166,128,-50,178,W,0,1,0
2016-11-12 00:00:00.000000,Nigeria,Algeria,3,1,FIFA World Cup qualification,Uyo,Nigeria,0,60,562,35,741,25,-179,W,0,1,0
2016-11-12 00:00:00.000000,Turkey,Kosovo,2,0,FIFA World Cup qualification,Antalya,Turkey,0,25,843,164,135,-139,708,W,0,1,0
2016-11-12 00:00:00.000000,Uganda,Congo,1,0,FIFA World Cup qualification,Kampala,Uganda,0,72,500,55,575,17,-75,W,0,1,0
2016-11-12 00:00:00.000000,Ukraine,Finland,1,0,FIFA World Cup qualification,Odesa,Ukraine,0,29,803,101,337,-72,466,W,0,1,0
2016-11-12 00:00:00.000000,Wales,Serbia,1,1,FIFA World Cup qualification,Cardiff,Wales,0,11,1113,43,650,-32,463,D,1,1,0
2016-11-13 00:00:00.000000,Belgium,Estonia,8,1,FIFA World Cup qualification,Brussels,Belgium,0,4,1382,119,299,-115,1083,W,0,1,0
2016-11-13 00:00:00.000000,Bulgaria,Belarus,1,0,FIFA World Cup qualification,Sofia,Bulgaria,0,89,395,77,452,12,-57,W,0,1,0
2016-11-13 00:00:00.000000,Cyprus,Gibraltar,3,1,FIFA World Cup qualification,Nicosia,Cyprus,0,139,228,205,0,-66,228,W,0,1,0
2016-11-13 00:00:00.000000,Egypt,Ghana,2,0,FIFA World Cup qualification,Alexandria,Egypt,0,46,626,45,628,1,-2,W,0,1,0
2016-11-13 00:00:00.000000,Guinea,Congo DR,1,2,FIFA World Cup qualification,Conakry,Guinea,0,64,539,49,609,15,-70,L,2,1,0
2016-11-13 00:00:00.000000,Hungary,Andorra,4,0,FIFA World Cup qualification,Budapest,Hungary,0,22,891,203,11,-181,880,W,0,1,0
2016-11-13 00:00:00.000000,Jamaica,Suriname,1,0,CFU Caribbean Cup qualification,Kingston,Jamaica,0,75,464,147,205,-72,259,W,0,1,0
2016-11-13 00:00:00.000000,Luxembourg,Netherlands,1,3,FIFA World Cup qualification,Luxembourg,Luxembourg,0,130,252,20,901,110,-649,L,2,1,0
2016-11-13 00:00:00.000000,Portugal,Latvia,4,1,FIFA World Cup qualification,Faro,Portugal,0,8,1231,116,306,-108,925,W,0,1,0
2016-11-13 00:00:00.000000,Singapore,Cambodia,1,0,Friendly,Bishan,Singapore,0,171,122,167,123,4,-1,W,0,1,0
2016-11-13 00:00:00.000000,Solomon Islands,Tahiti,1,0,FIFA World Cup qualification,Honiara,Solomon Islands,0,193,56,172,120,21,-64,W,0,1,0
2016-11-13 00:00:00.000000,St. Kitts and Nevis,Haiti,0,2,CFU Caribbean Cup qualification,Basseterre,St. Kitts and Nevis,0,73,472,87,405,-14,67,L,2,1,0
2016-11-13 00:00:00.000000,Switzerland,Faroe Islands,2,0,FIFA World Cup qualification,Lucerne,Switzerland,0,14,1071,74,469,-60,602,W,0,1,0
2016-11-13 00:00:00.000000,Tajikistan,Afghanistan,1,0,Friendly,Dushanbe,Tajikistan,0,140,227,145,208,-5,19,W,0,1,0
2016-11-13 00:00:00.000000,Zimbabwe,Tanzania,3,0,Friendly,Harare,Zimbabwe,0,110,323,144,212,-34,111,W,0,1,0
2016-11-14 00:00:00.000000,Malaysia,Papua New Guinea,2,1,Friendly,Shah Alam,Malaysia,0,164,135,159,152,5,-17,W,0,1,0
2016-11-14 00:00:00.000000,Poland,Slovenia,1,1,Friendly,Wrocław,Poland,0,15,1029,52,595,-37,434,D,1,1,0
2016-11-15 00:00:00.000000,Argentina,Colombia,3,0,FIFA World Cup qualification,San Juan,Argentina,0,1,1621,5,1361,-4,260,W,0,1,0
2016-11-15 00:00:00.000000,Austria,Slovakia,0,0,Friendly,Vienna,Austria,0,30,792,26,840,4,-48,D,1,1,0
2016-11-15 00:00:00.000000,Bolivia,Paraguay,1,0,FIFA World Cup qualification,La Paz,Bolivia,0,80,444,37,738,43,-294,W,0,1,0
2016-11-15 00:00:00.000000,Chile,Uruguay,3,1,FIFA World Cup qualification,Santiago,Chile,0,6,1273,9,1175,-3,98,W,0,1,0
2016-11-15 00:00:00.000000,Costa Rica,USA,4,0,FIFA World Cup qualification,San José,Costa Rica,0,18,971,24,852,-6,119,W,0,1,0
2016-11-15 00:00:00.000000,Czech Republic,Denmark,1,1,Friendly,Mladá Boleslav,Czech Republic,0,40,663,50,606,-10,57,D,1,1,0
2016-11-15 00:00:00.000000,Ecuador,Venezuela,3,0,FIFA World Cup qualification,Quito,Ecuador,0,19,932,68,516,-49,416,W,0,1,0
2016-11-15 00:00:00.000000,England,Spain,2,2,Friendly,London,England,0,12,1090,10,1168,2,-78,D,1,1,0
2016-11-15 00:00:00.000000,Gabon,Comoros,1,1,Friendly,Tunis,Tunisia,1,110,323,143,223,-33,100,D,1,0,0
2016-11-15 00:00:00.000000,Honduras,Trinidad and Tobago,3,1,FIFA World Cup qualification,San Pedro Sula,Honduras,0,86,411,65,533,21,-122,W,0,1,0
2016-11-15 00:00:00.000000,Italy,Germany,0,0,Friendly,Milan,Italy,0,13,1082,2,1465,11,-383,D,1,1,0
2016-11-15 00:00:00.000000,Japan,Saudi Arabia,2,1,FIFA World Cup qualification,Saitama,Japan,0,51,601,54,593,-3,8,W,0,1,0
2016-11-15 00:00:00.000000,Jordan,Lebanon,0,0,Friendly,Amman,Jordan,0,104,332,149,202,-45,130,D,1,1,0
2016-11-15 00:00:00.000000,Kenya,Liberia,1,0,Friendly,Nairobi,Kenya,0,85,416,104,332,-19,84,W,0,1,0
2016-11-15 00:00:00.000000,Korea Republic,Uzbekistan,2,1,FIFA World Cup qualification,Seoul,Korea Republic,0,44,640,48,617,-4,23,W,0,1,0
2016-11-15 00:00:00.000000,Malta,Iceland,0,2,Friendly,Attard,Malta,0,178,97,21,898,157,-801,L,2,1,0
2016-11-15 00:00:00.000000,Morocco,Togo,2,1,Friendly,Marrakech,Morocco,0,60,562,93,375,-33,187,W,0,1,0
2016-11-15 00:00:00.000000,Mozambique,South Africa,1,1,Friendly,Maputo,Mozambique,0,95,359,62,559,33,-200,D,1,1,0
2016-11-15 00:00:00.000000,Nepal,Macau,1,0,AFC Challenge Cup,Kuching,Malaysia,1,186,74,196,40,-10,34,W,0,0,0
2016-11-15 00:00:00.000000,New Caledonia,New Zealand,0,0,FIFA World Cup qualification,Koné,New Caledonia,0,166,128,116,306,50,-178,D,1,1,0
2016-11-15 00:00:00.000000,Northern Ireland,Croatia,0,3,Friendly,Belfast,Northern Ireland,0,36,739,16,1027,20,-288,L,2,1,0
2016-11-15 00:00:00.000000,Panama,Mexico,0,0,FIFA World Cup qualification,Panama City,Panama,0,63,551,17,1001,46,-450,D,1,1,0
2016-11-15 00:00:00.000000,Peru,Brazil,0,2,FIFA World Cup qualification,Lima,Peru,0,23,865,3,1410,20,-545,L,2,1,0
2016-11-15 00:00:00.000000,Russia,Romania,1,0,Friendly,Groznyy,Russia,0,53,594,34,746,19,-152,W,0,1,0
2016-11-15 00:00:00.000000,Syria,Iran,0,0,FIFA World Cup qualification,Paroi,Malaysia,1,96,357,27,837,69,-480,D,1,0,0
2016-11-15 00:00:00.000000,Thailand,Australia,2,2,FIFA World Cup qualification,Bangkok,Thailand,0,146,207,40,663,106,-456,D,1,1,0
2016-11-15 00:00:00.000000,Tunisia,Mauritania,0,0,Friendly,Gabès,Tunisia,0,38,721,115,308,-77,413,D,1,1,0
2016-11-15 00:00:00.000000,Ukraine,Serbia,2,0,Friendly,Kharkiv,Ukraine,0,29,803,43,650,-14,153,W,0,1,0
2016-11-15 00:00:00.000000,United Arab Emirates,Iraq,2,0,FIFA World Cup qualification,Abu Dhabi,United Arab Emirates,0,70,513,113,314,-43,199,W,0,1,0
2016-11-19 00:00:00.000000,Philippines,Singapore,0,0,AFF Championship,Bocaue,Philippines,0,124,271,171,122,-47,149,D,1,1,0
2016-11-19 00:00:00.000000,St. Kitts and Nevis,Estonia,1,1,Friendly,Basseterre,St. Kitts and Nevis,0,73,472,119,299,-46,173,D,1,1,0
2016-11-19 00:00:00.000000,Thailand,Indonesia,4,2,AFF Championship,Bocaue,Philippines,1,146,207,179,93,-33,114,W,0,0,0
2016-11-20 00:00:00.000000,Malaysia,Cambodia,3,2,AFF Championship,Rangoon,Burma,1,164,135,167,123,-3,12,W,0,0,0
2016-11-22 00:00:00.000000,Antigua and Barbuda,Estonia,0,1,Friendly,St. John's,Antigua and Barbuda,0,82,435,119,299,-37,136,L,2,1,0
2016-11-22 00:00:00.000000,Philippines,Indonesia,2,2,AFF Championship,Bocaue,Philippines,0,124,271,179,93,-55,178,D,1,1,0
2016-11-22 00:00:00.000000,Thailand,Singapore,1,0,AFF Championship,Bocaue,Philippines,1,146,207,171,122,-25,85,W,0,0,0
2016-11-23 00:00:00.000000,Malaysia,Vietnam,0,1,AFF Championship,Rangoon,Burma,1,164,135,136,231,28,-96,L,2,0,0
2016-11-25 00:00:00.000000,Philippines,Thailand,0,1,AFF Championship,Bocaue,Philippines,0,124,271,146,207,-22,64,L,2,1,0
2016-11-25 00:00:00.000000,Singapore,Indonesia,1,2,AFF Championship,Manila,Philippines,1,171,122,179,93,-8,29,L,2,0,0
2016-11-26 00:00:00.000000,Vietnam,Cambodia,2,1,AFF Championship,Naypyidaw,Burma,1,136,231,167,123,-31,108,W,0,0,0
2016-12-03 00:00:00.000000,Indonesia,Vietnam,2,1,AFF Championship,Bogor,Indonesia,0,179,93,136,231,43,-138,W,0,1,0
2016-12-07 00:00:00.000000,Vietnam,Indonesia,2,2,AFF Championship,Hanoi,Vietnam,0,136,231,179,93,-43,138,D,1,1,0
2016-12-14 00:00:00.000000,Indonesia,Thailand,2,1,AFF Championship,Bogor,Indonesia,0,179,93,146,207,33,-114,W,0,1,0
2016-12-17 00:00:00.000000,Thailand,Indonesia,2,0,AFF Championship,Bangkok,Thailand,0,146,207,179,93,-33,114,W,0,1,0
2016-12-27 00:00:00.000000,Nicaragua,Trinidad and Tobago,2,1,Friendly,Managua,Nicaragua,0,107,325,65,533,42,-208,W,0,1,0
2016-12-30 00:00:00.000000,Nicaragua,Trinidad and Tobago,1,3,Friendly,Managua,Nicaragua,0,107,325,65,533,42,-208,L,2,1,0
2017-01-04 00:00:00.000000,Trinidad and Tobago,Suriname,1,2,CFU Caribbean Cup qualification,Couva,Trinidad and Tobago,0,65,533,147,205,-82,328,L,2,1,0
2017-01-04 00:00:00.000000,Tunisia,Uganda,2,0,Friendly,Tunis,Tunisia,0,38,721,72,500,-34,221,W,0,1,0
2017-01-05 00:00:00.000000,Cameroon,Congo DR,2,0,Friendly,Yaoundé,Cameroon,0,59,567,49,609,10,-42,W,0,1,0
2017-01-06 00:00:00.000000,Suriname,Haiti,2,4,CFU Caribbean Cup qualification,Couva,Trinidad and Tobago,1,147,205,87,405,60,-200,L,2,0,0
2017-01-07 00:00:00.000000,Algeria,Mauritania,3,1,Friendly,Blida,Algeria,0,35,741,115,308,-80,433,W,0,1,0
2017-01-07 00:00:00.000000,Burkina Faso,Mali,2,1,Friendly,Marrakech,Morocco,1,67,519,58,568,9,-49,W,0,0,0
2017-01-08 00:00:00.000000,Egypt,Tunisia,1,0,Friendly,Cairo,Egypt,0,46,626,38,721,8,-95,W,0,1,0
2017-01-08 00:00:00.000000,Libya,Senegal,1,2,Friendly,Brazzaville,Congo,1,76,461,32,783,44,-322,L,2,0,0
2017-01-08 00:00:00.000000,Trinidad and Tobago,Haiti,3,4,CFU Caribbean Cup qualification,Couva,Trinidad and Tobago,0,65,533,87,405,-22,128,L,2,1,0
2017-01-09 00:00:00.000000,Morocco,Finland,0,1,Friendly,al-Ain,United Arab Emirates,1,60,562,101,337,-41,225,L,2,0,0
2017-01-10 00:00:00.000000,Algeria,Mauritania,6,0,Friendly,Sidi Moussa,Algeria,0,35,741,115,308,-80,433,W,0,1,0
2017-01-10 00:00:00.000000,Cameroon,Zimbabwe,1,1,Friendly,Yaoundé,Cameroon,0,59,567,110,323,-51,244,D,1,1,0
2017-01-11 00:00:00.000000,Chile,Croatia,1,1,Friendly,Nanning,China,1,6,1273,16,1027,-10,246,D,1,0,0
2017-01-11 00:00:00.000000,Congo,Senegal,0,2,Friendly,Brazzaville,Congo,0,55,575,32,783,23,-208,L,2,1,0
2017-01-13 00:00:00.000000,Honduras,Nicaragua,2,1,UNCAF Cup,Panama City,Panama,1,86,411,107,325,-21,86,W,0,0,0
2017-01-14 00:00:00.000000,Burkina Faso,Cameroon,1,1,African Cup of Nations,Libreville,Gabon,1,67,519,59,567,8,-48,D,1,0,0
2017-01-14 00:00:00.000000,Cambodia,Saudi Arabia,2,7,Friendly,Abu Dhabi,United Arab Emirates,1,167,123,54,593,113,-470,L,2,0,0
2017-01-14 00:00:00.000000,Gabon,Guinea-Bissau,1,1,African Cup of Nations,Libreville,Gabon,0,110,323,69,515,41,-192,D,1,1,0
2017-01-15 00:00:00.000000,Algeria,Zimbabwe,2,2,African Cup of Nations,Franceville,Gabon,1,35,741,110,323,-75,418,D,1,0,0
2017-01-15 00:00:00.000000,Belize,Costa Rica,0,3,UNCAF Cup,Panama City,Panama,1,163,141,18,971,145,-830,L,2,0,0
2017-01-15 00:00:00.000000,El Salvador,Honduras,1,2,UNCAF Cup,Panama City,Panama,1,135,232,86,411,49,-179,L,2,0,0
2017-01-15 00:00:00.000000,Iceland,Chile,0,1,Friendly,Nanning,China,1,21,898,6,1273,15,-375,L,2,0,0
2017-01-15 00:00:00.000000,Tunisia,Senegal,0,2,African Cup of Nations,Franceville,Gabon,1,38,721,32,783,6,-62,L,2,0,0
2017-01-16 00:00:00.000000,Congo DR,Morocco,1,0,African Cup of Nations,Oyem,Gabon,1,49,609,60,562,-11,47,W,0,0,0
2017-01-17 00:00:00.000000,El Salvador,Belize,3,1,UNCAF Cup,Panama City,Panama,1,135,232,163,141,-28,91,W,0,0,0
2017-01-17 00:00:00.000000,Ghana,Uganda,1,0,African Cup of Nations,Port-Gentil,Gabon,1,45,628,72,500,-27,128,W,0,0,0
2017-01-17 00:00:00.000000,Mali,Egypt,0,0,African Cup of Nations,Port-Gentil,Gabon,1,58,568,46,626,12,-58,D,1,0,0
2017-01-17 00:00:00.000000,Qatar,Moldova,1,1,Friendly,Doha,Qatar,0,91,385,173,119,-82,266,D,1,1,0
2017-01-18 00:00:00.000000,Cameroon,Guinea-Bissau,2,1,African Cup of Nations,Libreville,Gabon,1,59,567,69,515,-10,52,W,0,0,0
2017-01-18 00:00:00.000000,Gabon,Burkina Faso,1,1,African Cup of Nations,Libreville,Gabon,0,110,323,67,519,43,-196,D,1,1,0
2017-01-19 00:00:00.000000,Algeria,Tunisia,1,2,African Cup of Nations,Franceville,Gabon,1,35,741,38,721,-3,20,L,2,0,0
2017-01-19 00:00:00.000000,Senegal,Zimbabwe,2,0,African Cup of Nations,Franceville,Gabon,1,32,783,110,323,-78,460,W,0,0,0
2017-01-20 00:00:00.000000,Morocco,Togo,3,1,African Cup of Nations,Oyem,Gabon,1,60,562,93,375,-33,187,W,0,0,0
2017-01-20 00:00:00.000000,Nicaragua,Belize,3,1,UNCAF Cup,Panama City,Panama,1,107,325,163,141,-56,184,W,0,0,0
2017-01-21 00:00:00.000000,Egypt,Uganda,1,0,African Cup of Nations,Port-Gentil,Gabon,1,46,626,72,500,-26,126,W,0,0,0
2017-01-21 00:00:00.000000,Ghana,Mali,1,0,African Cup of Nations,Port-Gentil,Gabon,1,45,628,58,568,-13,60,W,0,0,0
2017-01-22 00:00:00.000000,Belize,Honduras,0,1,UNCAF Cup,Panama City,Panama,1,163,141,86,411,77,-270,L,2,0,0
2017-01-22 00:00:00.000000,Bermuda,Canada,2,4,Friendly,Hamilton,Bermuda,0,185,77,110,323,75,-246,L,2,1,0
2017-01-22 00:00:00.000000,El Salvador,Nicaragua,1,0,UNCAF Cup,Panama City,Panama,1,135,232,107,325,28,-93,W,0,0,0
2017-01-22 00:00:00.000000,Gabon,Cameroon,0,0,African Cup of Nations,Libreville,Gabon,0,110,323,59,567,51,-244,D,1,1,0
2017-01-22 00:00:00.000000,Guinea-Bissau,Burkina Faso,0,2,African Cup of Nations,Franceville,Gabon,1,69,515,67,519,2,-4,L,2,0,0
2017-01-22 00:00:00.000000,Panama,Costa Rica,1,0,UNCAF Cup,Panama City,Panama,0,63,551,18,971,45,-420,W,0,1,0
2017-01-23 00:00:00.000000,Senegal,Algeria,2,2,African Cup of Nations,Franceville,Gabon,1,32,783,35,741,-3,42,D,1,0,0
2017-01-23 00:00:00.000000,Uzbekistan,Georgia,2,2,Friendly,Dubai,United Arab Emirates,1,48,617,122,276,-74,341,D,1,0,0
2017-01-23 00:00:00.000000,Zimbabwe,Tunisia,2,4,African Cup of Nations,Libreville,Gabon,1,110,323,38,721,72,-398,L,2,0,0
2017-01-24 00:00:00.000000,Togo,Congo DR,1,3,African Cup of Nations,Port-Gentil,Gabon,1,93,375,49,609,44,-234,L,2,0,0
2017-01-25 00:00:00.000000,Egypt,Ghana,1,0,African Cup of Nations,Port-Gentil,Gabon,1,46,626,45,628,1,-2,W,0,0,0
2017-01-25 00:00:00.000000,Jordan,Georgia,1,0,Friendly,Dubai,United Arab Emirates,1,104,332,122,276,-18,56,W,0,0,0
2017-01-25 00:00:00.000000,Uganda,Mali,1,1,African Cup of Nations,Oyem,Gabon,1,72,500,58,568,14,-68,D,1,0,0
2017-01-26 00:00:00.000000,Brazil,Colombia,1,0,Friendly,Rio de Janeiro,Brazil,0,3,1410,5,1361,-2,49,W,0,1,0
2017-01-28 00:00:00.000000,Burkina Faso,Tunisia,2,0,African Cup of Nations,Libreville,Gabon,1,67,519,38,721,29,-202,W,0,0,0
2017-01-28 00:00:00.000000,Senegal,Cameroon,0,0,African Cup of Nations,Franceville,Gabon,1,32,783,59,567,-27,216,D,1,0,0
2017-01-29 00:00:00.000000,Congo DR,Ghana,1,2,African Cup of Nations,Oyem,Gabon,1,49,609,45,628,4,-19,L,2,0,0
2017-01-29 00:00:00.000000,Egypt,Morocco,1,0,African Cup of Nations,Port-Gentil,Gabon,1,46,626,60,562,-14,64,W,0,0,0
2017-01-29 00:00:00.000000,USA,Serbia,0,0,Friendly,San Diego,USA,0,24,852,43,650,-19,202,D,1,1,0
2017-02-01 00:00:00.000000,Burkina Faso,Egypt,1,1,African Cup of Nations,Libreville,Gabon,1,67,519,46,626,21,-107,D,1,0,0
2017-02-02 00:00:00.000000,Cameroon,Ghana,2,0,African Cup of Nations,Franceville,Gabon,1,59,567,45,628,14,-61,W,0,0,0
2017-02-04 00:00:00.000000,Burkina Faso,Ghana,1,0,African Cup of Nations,Port-Gentil,Gabon,1,67,519,45,628,22,-109,W,0,0,0
2017-02-05 00:00:00.000000,Egypt,Cameroon,1,2,African Cup of Nations,Libreville,Gabon,1,46,626,59,567,-13,59,L,2,0,0
2017-02-08 00:00:00.000000,Mexico,Iceland,1,0,Friendly,Las Vegas,USA,1,17,1001,21,898,-4,103,W,0,0,0
2017-02-22 00:00:00.000000,Ecuador,Honduras,3,1,Friendly,Guayaquil,Ecuador,0,19,932,86,411,-67,521,W,0,1,0
2017-03-09 00:00:00.000000,Qatar,Azerbaijan,1,2,Friendly,Doha,Qatar,0,91,385,88,404,3,-19,L,2,1,0
2017-03-10 00:00:00.000000,Trinidad and Tobago,Barbados,2,0,Friendly,Couva,Trinidad and Tobago,0,65,533,157,163,-92,370,W,0,1,0
2017-03-11 00:00:00.000000,Burundi,Djibouti,7,0,Friendly,Bujumbura,Burundi,0,138,229,205,0,-67,229,W,0,1,0
2017-03-13 00:00:00.000000,Burundi,Djibouti,1,0,Friendly,Bujumbura,Burundi,0,138,229,205,0,-67,229,W,0,1,0
2017-03-16 00:00:00.000000,Honduras,Nicaragua,2,0,Friendly,San Pedro Sula,Honduras,0,86,411,107,325,-21,86,W,0,1,0
2017-03-18 00:00:00.000000,Iran,Iraq,0,1,Friendly,Teheran,Iran,0,27,837,113,314,-86,523,L,2,1,0
2017-03-19 00:00:00.000000,San Marino,Moldova,0,2,Friendly,Serravalle,San Marino,0,201,17,173,119,28,-102,L,2,1,0
2017-03-22 00:00:00.000000,Cambodia,India,2,3,Friendly,Phnom Penh,Cambodia,0,167,123,137,230,30,-107,L,2,1,0
2017-03-22 00:00:00.000000,Curaçao,El Salvador,1,1,Friendly,Willemstad,Curaçao,0,77,452,135,232,-58,220,D,1,1,0
2017-03-22 00:00:00.000000,Cyprus,Kazakhstan,3,1,Friendly,Larnaca,Cyprus,0,139,228,90,386,49,-158,W,0,1,0
2017-03-22 00:00:00.000000,Czech Republic,Lithuania,3,0,Friendly,Ústí nad Labem,Czech Republic,0,40,663,98,347,-58,316,W,0,1,0
2017-03-22 00:00:00.000000,Djibouti,South Sudan,2,0,African Cup of Nations qualification,Djibouti,Djibouti,0,205,0,167,123,38,-123,W,0,1,0
2017-03-22 00:00:00.000000,Germany,England,1,0,Friendly,Dortmund,Germany,0,2,1465,12,1090,-10,375,W,0,1,0
2017-03-22 00:00:00.000000,Philippines,Malaysia,0,0,Friendly,Manila,Philippines,0,124,271,164,135,-40,136,D,1,1,0
2017-03-22 00:00:00.000000,Scotland,Canada,1,1,Friendly,Edinburgh,Scotland,0,57,569,110,323,-53,246,D,1,1,0
2017-03-22 00:00:00.000000,Yemen,Palestine,0,1,Friendly,al-Wakrah,Qatar,1,132,244,120,285,12,-41,L,2,0,0
2017-03-23 00:00:00.000000,Afghanistan,Singapore,2,1,Friendly,al-Wakrah,Qatar,1,145,208,171,122,-26,86,W,0,0,0
2017-03-23 00:00:00.000000,Argentina,Chile,1,0,FIFA World Cup qualification,Buenos Aires,Argentina,0,1,1621,6,1273,-5,348,W,0,1,0
2017-03-23 00:00:00.000000,Bahrain,Tajikistan,1,1,Friendly,Riffa,Bahrain,0,123,272,140,227,-17,45,D,1,1,0
2017-03-23 00:00:00.000000,Colombia,Bolivia,1,0,FIFA World Cup qualification,Barranquilla,Colombia,0,5,1361,80,444,-75,917,W,0,1,0
2017-03-23 00:00:00.000000,Iraq,Australia,1,1,FIFA World Cup qualification,Teheran,Iran,1,113,314,40,663,73,-349,D,1,0,0
2017-03-23 00:00:00.000000,Jordan,Hong Kong,4,0,Friendly,Amman,Jordan,0,104,332,140,227,-36,105,W,0,1,0
2017-03-23 00:00:00.000000,Kenya,Uganda,1,1,Friendly,Machakos,Kenya,0,85,416,72,500,13,-84,D,1,1,0
2017-03-23 00:00:00.000000,Nigeria,Senegal,1,1,Friendly,London,England,1,60,562,32,783,28,-221,D,1,0,0
2017-03-23 00:00:00.000000,Papua New Guinea,Tahiti,1,3,FIFA World Cup qualification,Port Moresby,Papua New Guinea,0,159,152,172,120,-13,32,L,2,1,0
2017-03-23 00:00:00.000000,Paraguay,Ecuador,2,1,FIFA World Cup qualification,Asunción,Paraguay,0,37,738,19,932,18,-194,W,0,1,0
2017-03-23 00:00:00.000000,Qatar,Iran,0,1,FIFA World Cup qualification,Doha,Qatar,0,91,385,27,837,64,-452,L,2,1,0
2017-03-23 00:00:00.000000,Syria,Uzbekistan,1,0,FIFA World Cup qualification,Paya Rumput,Malaysia,1,96,357,48,617,48,-260,W,0,0,0
2017-03-23 00:00:00.000000,Thailand,Saudi Arabia,0,3,FIFA World Cup qualification,Bangkok,Thailand,0,146,207,54,593,92,-386,L,2,1,0
2017-03-23 00:00:00.000000,United Arab Emirates,Japan,0,2,FIFA World Cup qualification,al-Ain,United Arab Emirates,0,70,513,51,601,19,-88,L,2,1,0
2017-03-23 00:00:00.000000,Uruguay,Brazil,1,4,FIFA World Cup qualification,Montevideo,Uruguay,0,9,1175,3,1410,6,-235,L,2,1,0
2017-03-23 00:00:00.000000,Venezuela,Peru,2,2,FIFA World Cup qualification,Maturín,Venezuela,0,68,516,23,865,45,-349,D,1,1,0
2017-03-24 00:00:00.000000,Austria,Moldova,2,0,FIFA World Cup qualification,Vienna,Austria,0,30,792,173,119,-143,673,W,0,1,0
2017-03-24 00:00:00.000000,Comoros,Mauritius,2,0,African Cup of Nations qualification,Mitsamiouli,Comoros,0,143,223,151,194,-8,29,W,0,1,0
2017-03-24 00:00:00.000000,Croatia,Ukraine,1,0,FIFA World Cup qualification,Zagreb,Croatia,0,16,1027,29,803,-13,224,W,0,1,0
2017-03-24 00:00:00.000000,Georgia,Serbia,1,2,FIFA World Cup qualification,Tbilisi,Georgia,0,122,276,43,650,79,-374,L,2,1,0
2017-03-24 00:00:00.000000,Guinea,Gabon,2,2,Friendly,Le Havre,France,1,64,539,110,323,-46,216,D,1,0,0
2017-03-24 00:00:00.000000,Italy,Albania,2,0,FIFA World Cup qualification,Palermo,Italy,0,13,1082,47,619,-34,463,W,0,1,0
2017-03-24 00:00:00.000000,Kosovo,Iceland,1,2,FIFA World Cup qualification,Shkodër,Albania,1,164,135,21,898,143,-763,L,2,0,0
2017-03-24 00:00:00.000000,Libya,Togo,0,0,Friendly,Alexandria,Egypt,1,76,461,93,375,-17,86,D,1,0,0
2017-03-24 00:00:00.000000,Mauritania,Benin,1,0,Friendly,Nouakchott,Mauritania,0,115,308,66,525,49,-217,W,0,1,0
2017-03-24 00:00:00.000000,Mexico,Costa Rica,2,0,FIFA World Cup qualification,Mexico City,Mexico,0,17,1001,18,971,-1,30,W,0,1,0
2017-03-24 00:00:00.000000,Morocco,Burkina Faso,2,0,Friendly,Marrakech,Morocco,0,60,562,67,519,-7,43,W,0,1,0
2017-03-24 00:00:00.000000,Spain,Israel,4,1,FIFA World Cup qualification,Gijón,Spain,0,10,1168,79,450,-69,718,W,0,1,0
2017-03-24 00:00:00.000000,Trinidad and Tobago,Panama,1,0,FIFA World Cup qualification,Port of Spain,Trinidad and Tobago,0,65,533,63,551,2,-18,W,0,1,0
2017-03-24 00:00:00.000000,Tunisia,Cameroon,0,1,Friendly,Monastir,Tunisia,0,38,721,59,567,-21,154,L,2,1,0
2017-03-24 00:00:00.000000,Turkey,Finland,2,0,FIFA World Cup qualification,Antalya,Turkey,0,25,843,101,337,-76,506,W,0,1,0
2017-03-24 00:00:00.000000,USA,Honduras,6,0,FIFA World Cup qualification,San Jose,USA,0,24,852,86,411,-62,441,W,0,1,0
2017-03-25 00:00:00.000000,Andorra,Faroe Islands,0,0,FIFA World Cup qualification,Sant Julià de Lòria,Andorra,0,203,11,74,469,129,-458,D,1,1,0
2017-03-25 00:00:00.000000,Belgium,Greece,1,1,FIFA World Cup qualification,Brussels,Belgium,0,4,1382,42,656,-38,726,D,1,1,0
2017-03-25 00:00:00.000000,Bulgaria,Netherlands,2,0,FIFA World Cup qualification,Sofia,Bulgaria,0,89,395,20,901,69,-506,W,0,1,0
2017-03-25 00:00:00.000000,Cyprus,Estonia,0,0,FIFA World Cup qualification,Nicosia,Cyprus,0,139,228,119,299,20,-71,D,1,1,0
2017-03-25 00:00:00.000000,Fiji,New Zealand,0,2,FIFA World Cup qualification,Lautoka,Fiji,0,179,93,116,306,63,-213,L,2,1,0
2017-03-25 00:00:00.000000,Luxembourg,France,1,3,FIFA World Cup qualification,Luxembourg,Luxembourg,0,130,252,7,1271,123,-1019,L,2,1,0
2017-03-25 00:00:00.000000,Mozambique,Angola,2,0,Friendly,Maputo,Mozambique,0,95,359,134,236,-39,123,W,0,1,0
2017-03-25 00:00:00.000000,Portugal,Hungary,3,0,FIFA World Cup qualification,Lisbon,Portugal,0,8,1231,22,891,-14,340,W,0,1,0
2017-03-25 00:00:00.000000,South Africa,Guinea-Bissau,3,1,Friendly,Durban,South Africa,0,62,559,69,515,-7,44,W,0,1,0
2017-03-25 00:00:00.000000,Sweden,Belarus,4,0,FIFA World Cup qualification,Solna,Sweden,0,39,715,77,452,-38,263,W,0,1,0
2017-03-25 00:00:00.000000,Switzerland,Latvia,1,0,FIFA World Cup qualification,Geneva,Switzerland,0,14,1071,116,306,-102,765,W,0,1,0
2017-03-25 00:00:00.000000,Tanzania,Botswana,2,0,Friendly,Dar es Salaam,Tanzania,0,144,212,101,337,43,-125,W,0,1,0
2017-03-26 00:00:00.000000,Armenia,Kazakhstan,2,0,FIFA World Cup qualification,Yerevan,Armenia,0,125,270,90,386,35,-116,W,0,1,0
2017-03-26 00:00:00.000000,Azerbaijan,Germany,1,4,FIFA World Cup qualification,Baku,Azerbaijan,0,88,404,2,1465,86,-1061,L,2,1,0
2017-03-26 00:00:00.000000,England,Lithuania,2,0,FIFA World Cup qualification,London,England,0,12,1090,98,347,-86,743,W,0,1,0
2017-03-26 00:00:00.000000,Kenya,Congo DR,2,1,Friendly,Machakos,Kenya,0,85,416,49,609,36,-193,W,0,1,0
2017-03-26 00:00:00.000000,Malta,Slovakia,1,3,FIFA World Cup qualification,Attard,Malta,0,178,97,26,840,152,-743,L,2,1,0
2017-03-26 00:00:00.000000,Montenegro,Poland,1,2,FIFA World Cup qualification,Podgorica,Montenegro,0,56,570,15,1029,41,-459,L,2,1,0
2017-03-26 00:00:00.000000,Northern Ireland,Norway,2,0,FIFA World Cup qualification,Belfast,Northern Ireland,0,36,739,81,438,-45,301,W,0,1,0
2017-03-26 00:00:00.000000,Romania,Denmark,0,0,FIFA World Cup qualification,Cluj,Romania,0,34,746,50,606,-16,140,D,1,1,0
2017-03-26 00:00:00.000000,San Marino,Czech Republic,0,6,FIFA World Cup qualification,Serravalle,San Marino,0,201,17,40,663,161,-646,L,2,1,0
2017-03-26 00:00:00.000000,Scotland,Slovenia,1,0,FIFA World Cup qualification,Glasgow,Scotland,0,57,569,52,595,5,-26,W,0,1,0
2017-03-26 00:00:00.000000,Zimbabwe,Zambia,0,0,Friendly,Harare,Zimbabwe,0,110,323,94,374,16,-51,D,1,1,0
2017-03-27 00:00:00.000000,Central African Republic,Gambia,1,2,Friendly,Rabat,Morocco,1,107,325,176,106,-69,219,L,2,0,0
2017-03-27 00:00:00.000000,Mauritania,Congo,2,1,Friendly,Nouakchott,Mauritania,0,115,308,55,575,60,-267,W,0,1,0
2017-03-27 00:00:00.000000,Turkey,Moldova,3,1,Friendly,Eskişehir,Turkey,0,25,843,173,119,-148,724,W,0,1,0
2017-03-28 00:00:00.000000,Afghanistan,Vietnam,1,1,AFC Asian Cup qualification,Dushanbe,Tajikistan,1,145,208,136,231,9,-23,D,1,0,0
2017-03-28 00:00:00.000000,Australia,United Arab Emirates,2,0,FIFA World Cup qualification,Sydney,Australia,0,40,663,70,513,-30,150,W,0,1,0
2017-03-28 00:00:00.000000,Austria,Finland,1,1,Friendly,Innsbruck,Austria,0,30,792,101,337,-71,455,D,1,1,0
2017-03-28 00:00:00.000000,Bahrain,Singapore,0,0,AFC Asian Cup qualification,Riffa,Bahrain,0,123,272,171,122,-48,150,D,1,1,0
2017-03-28 00:00:00.000000,Bolivia,Argentina,2,0,FIFA World Cup qualification,La Paz,Bolivia,0,80,444,1,1621,79,-1177,W,0,1,0
2017-03-28 00:00:00.000000,Brazil,Paraguay,3,0,FIFA World Cup qualification,São Paulo,Brazil,0,3,1410,37,738,-34,672,W,0,1,0
2017-03-28 00:00:00.000000,Cameroon,Guinea,1,2,Friendly,Molenbeek,Belgium,1,59,567,64,539,-5,28,L,2,0,0
2017-03-28 00:00:00.000000,Chile,Venezuela,3,1,FIFA World Cup qualification,Santiago,Chile,0,6,1273,68,516,-62,757,W,0,1,0
2017-03-28 00:00:00.000000,Ecuador,Colombia,0,2,FIFA World Cup qualification,Quito,Ecuador,0,19,932,5,1361,14,-429,L,2,1,0
2017-03-28 00:00:00.000000,Egypt,Togo,3,0,Friendly,Alexandria,Egypt,0,46,626,93,375,-47,251,W,0,1,0
2017-03-28 00:00:00.000000,Estonia,Croatia,3,0,Friendly,Tallinn,Estonia,0,119,299,16,1027,103,-728,W,0,1,0
2017-03-28 00:00:00.000000,France,Spain,0,2,Friendly,Saint-Denis,France,0,7,1271,10,1168,-3,103,L,2,1,0
2017-03-28 00:00:00.000000,Georgia,Latvia,5,0,Friendly,Tbilisi,Georgia,0,122,276,116,306,6,-30,W,0,1,0
2017-03-28 00:00:00.000000,Honduras,Costa Rica,1,1,FIFA World Cup qualification,San Pedro Sula,Honduras,0,86,411,18,971,68,-560,D,1,1,0
2017-03-28 00:00:00.000000,Japan,Thailand,4,0,FIFA World Cup qualification,Saitama,Japan,0,51,601,146,207,-95,394,W,0,1,0
2017-03-28 00:00:00.000000,Jordan,Cambodia,7,0,AFC Asian Cup qualification,Amman,Jordan,0,104,332,167,123,-63,209,W,0,1,0
2017-03-28 00:00:00.000000,Korea Republic,Syria,1,0,FIFA World Cup qualification,Seoul,Korea Republic,0,44,640,96,357,-52,283,W,0,1,0
2017-03-28 00:00:00.000000,Lebanon,Hong Kong,2,0,AFC Asian Cup qualification,Beirut,Lebanon,0,149,202,140,227,9,-25,W,0,1,0
2017-03-28 00:00:00.000000,Maldives,Palestine,0,3,AFC Asian Cup qualification,Malé,Maldives,0,158,161,120,285,38,-124,L,2,1,0
2017-03-28 00:00:00.000000,Mauritius,Comoros,1,1,African Cup of Nations qualification,Mapou,Mauritius,0,151,194,143,223,8,-29,D,1,1,0
2017-03-28 00:00:00.000000,Morocco,Tunisia,1,0,Friendly,Marrakech,Morocco,0,60,562,38,721,22,-159,W,0,1,0
2017-03-28 00:00:00.000000,Mozambique,Lesotho,1,0,Friendly,Beira,Mozambique,0,95,359,150,201,-55,158,W,0,1,0
2017-03-28 00:00:00.000000,Netherlands,Italy,1,2,Friendly,Amsterdam,Netherlands,0,20,901,13,1082,7,-181,L,2,1,0
2017-03-28 00:00:00.000000,New Zealand,Fiji,2,0,FIFA World Cup qualification,Wellington,New Zealand,0,116,306,179,93,-63,213,W,0,1,0
2017-03-28 00:00:00.000000,Oman,Bhutan,14,0,AFC Asian Cup qualification,Muscat,Oman,0,129,260,179,93,-50,167,W,0,1,0
2017-03-28 00:00:00.000000,Panama,USA,1,1,FIFA World Cup qualification,Panama City,Panama,0,63,551,24,852,39,-301,D,1,1,0
2017-03-28 00:00:00.000000,Peru,Uruguay,2,1,FIFA World Cup qualification,Lima,Peru,0,23,865,9,1175,14,-310,W,0,1,0
2017-03-28 00:00:00.000000,Philippines,Nepal,4,1,AFC Asian Cup qualification,Manila,Philippines,0,124,271,186,74,-62,197,W,0,1,0
2017-03-28 00:00:00.000000,Portugal,Sweden,2,3,Friendly,Funchal,Portugal,0,8,1231,39,715,-31,516,L,2,1,0
2017-03-28 00:00:00.000000,Russia,Belgium,3,3,Friendly,Sochi,Russia,0,53,594,4,1382,49,-788,D,1,1,0
2017-03-28 00:00:00.000000,Saudi Arabia,Iraq,1,0,FIFA World Cup qualification,Jeddah,Saudi Arabia,0,54,593,113,314,-59,279,W,0,1,0
2017-03-28 00:00:00.000000,South Africa,Angola,0,0,Friendly,East London,South Africa,0,62,559,134,236,-72,323,D,1,1,0
2017-03-28 00:00:00.000000,South Sudan,Djibouti,6,0,African Cup of Nations qualification,Juba,South Sudan,0,167,123,205,0,-38,123,W,0,1,0
2017-03-28 00:00:00.000000,Tanzania,Burundi,2,1,Friendly,Dar es Salaam,Tanzania,0,144,212,138,229,6,-17,W,0,1,0
2017-03-28 00:00:00.000000,Trinidad and Tobago,Mexico,0,1,FIFA World Cup qualification,Port of Spain,Trinidad and Tobago,0,65,533,17,1001,48,-468,L,2,1,0
2017-03-28 00:00:00.000000,Uzbekistan,Qatar,1,0,FIFA World Cup qualification,Tashkent,Uzbekistan,0,48,617,91,385,-43,232,W,0,1,0
2017-03-28 00:00:00.000000,Yemen,Tajikistan,2,1,AFC Asian Cup qualification,Doha,Qatar,1,132,244,140,227,-8,17,W,0,0,0
2017-05-04 00:00:00.000000,Burkina Faso,Benin,1,1,Friendly,Ouagadougou,Burkina Faso,0,67,519,66,525,1,-6,D,1,1,0
2017-05-07 00:00:00.000000,St. Kitts and Nevis,Barbados,2,1,Friendly,Basseterre,St. Kitts and Nevis,0,73,472,157,163,-84,309,W,0,1,0
2017-05-11 00:00:00.000000,Senegal,Mauritania,2,0,Friendly,Dakar,Senegal,0,32,783,115,308,-83,475,W,0,1,0
2017-05-13 00:00:00.000000,Egypt,Libya,1,0,Friendly,Cairo,Egypt,0,46,626,76,461,-30,165,W,0,1,0
2017-05-21 00:00:00.000000,Benin,Burkina Faso,2,2,Friendly,Cotonou,Benin,0,66,525,67,519,-1,6,D,1,1,0
2017-05-25 00:00:00.000000,Fiji,Solomon Islands,1,1,Friendly,Suva,Fiji,0,179,93,193,56,-14,37,D,1,1,0
2017-05-25 00:00:00.000000,Ghana,Benin,1,1,Friendly,Accra,Ghana,0,45,628,66,525,-21,103,D,1,1,0
2017-05-28 00:00:00.000000,El Salvador,Honduras,2,2,Friendly,Washington,USA,1,135,232,86,411,49,-179,D,1,0,0
2017-05-28 00:00:00.000000,Fiji,Solomon Islands,1,0,Friendly,Lautoka,Fiji,0,179,93,193,56,-14,37,W,0,1,0
2017-05-28 00:00:00.000000,Mexico,Croatia,1,2,Friendly,Los Angeles,USA,1,17,1001,16,1027,1,-26,L,2,0,0
2017-05-31 00:00:00.000000,Italy,San Marino,8,0,Friendly,Empoli,Italy,0,13,1082,201,17,-188,1065,W,0,1,0
2017-05-31 00:00:00.000000,Morocco,Netherlands,1,2,Friendly,Agadir,Morocco,0,60,562,20,901,40,-339,L,2,1,0
2017-06-01 00:00:00.000000,Iraq,Jordan,1,0,Friendly,Basra,Iraq,0,113,314,104,332,9,-18,W,0,1,0
2017-06-01 00:00:00.000000,Nigeria,Togo,3,0,Friendly,Saint-Leu-la-Forêt,France,1,60,562,93,375,-33,187,W,0,0,0
2017-06-01 00:00:00.000000,Switzerland,Belarus,1,0,Friendly,Neuchâtel,Switzerland,0,14,1071,77,452,-63,619,W,0,1,0
2017-06-02 00:00:00.000000,Chile,Burkina Faso,3,0,Friendly,Santiago,Chile,0,6,1273,67,519,-61,754,W,0,1,0
2017-06-02 00:00:00.000000,France,Paraguay,5,0,Friendly,Rennes,France,0,7,1271,37,738,-30,533,W,0,1,0
2017-06-02 00:00:00.000000,Nicaragua,Bolivia,0,1,Friendly,Managua,Nicaragua,0,107,325,80,444,27,-119,L,2,1,0
2017-06-02 00:00:00.000000,Northern Ireland,New Zealand,1,0,Friendly,Belfast,Northern Ireland,0,36,739,116,306,-80,433,W,0,1,0
2017-06-02 00:00:00.000000,Oman,Syria,1,1,Friendly,Muscat,Oman,0,129,260,96,357,33,-97,D,1,1,0
2017-06-03 00:00:00.000000,Ethiopia,Uganda,0,0,Friendly,Hawassa,Ethiopia,0,126,267,72,500,54,-233,D,1,1,0
2017-06-03 00:00:00.000000,Portugal,Cyprus,4,0,Friendly,Estoril,Portugal,0,8,1231,139,228,-131,1003,W,0,1,0
2017-06-03 00:00:00.000000,USA,Venezuela,1,1,Friendly,Sandy,USA,0,24,852,68,516,-44,336,D,1,1,0
2017-06-04 00:00:00.000000,Armenia,St. Kitts and Nevis,5,0,Friendly,Yerevan,Armenia,0,125,270,73,472,52,-202,W,0,1,0
2017-06-04 00:00:00.000000,Gabon,Zambia,0,0,Friendly,Libreville,Gabon,0,110,323,94,374,16,-51,D,1,1,0
2017-06-04 00:00:00.000000,Lesotho,Mauritania,1,0,Friendly,Pretoria,South Africa,1,150,201,115,308,35,-107,W,0,0,0
2017-06-04 00:00:00.000000,Luxembourg,Albania,2,1,Friendly,Luxembourg,Luxembourg,0,130,252,47,619,83,-367,W,0,1,0
2017-06-04 00:00:00.000000,Montenegro,Iran,1,2,Friendly,Podgorica,Montenegro,0,56,570,27,837,29,-267,L,2,1,0
2017-06-04 00:00:00.000000,Togo,Comoros,2,0,Friendly,Marseille,France,1,93,375,143,223,-50,152,W,0,0,0
2017-06-05 00:00:00.000000,Belgium,Czech Republic,2,1,Friendly,Brussels,Belgium,0,4,1382,40,663,-36,719,W,0,1,0
2017-06-05 00:00:00.000000,Congo DR,Botswana,2,0,Friendly,Salé,Morocco,1,49,609,101,337,-52,272,W,0,0,0
2017-06-05 00:00:00.000000,Egypt,Libya,1,0,Friendly,New Cairo,Egypt,0,46,626,76,461,-30,165,W,0,1,0
2017-06-05 00:00:00.000000,Hungary,Russia,0,3,Friendly,Budapest,Hungary,0,22,891,53,594,-31,297,L,2,1,0
2017-06-05 00:00:00.000000,Senegal,Uganda,0,0,Friendly,Dakar,Senegal,0,32,783,72,500,-40,283,D,1,1,0
2017-06-06 00:00:00.000000,Afghanistan,Maldives,2,1,Friendly,Dubai,United Arab Emirates,1,145,208,158,161,-13,47,W,0,0,0
2017-06-06 00:00:00.000000,Algeria,Guinea,2,1,Friendly,Blida,Algeria,0,35,741,64,539,-29,202,W,0,1,0
2017-06-06 00:00:00.000000,Bahrain,Palestine,0,2,Friendly,Riffa,Bahrain,0,123,272,120,285,3,-13,L,2,1,0
2017-06-06 00:00:00.000000,Denmark,Germany,1,1,Friendly,Brøndby,Denmark,0,50,606,2,1465,48,-859,D,1,1,0
2017-06-06 00:00:00.000000,India,Nepal,2,0,Friendly,Bombay,India,0,137,230,186,74,-49,156,W,0,1,0
2017-06-06 00:00:00.000000,Israel,Moldova,1,1,Friendly,Netanya,Israel,0,79,450,173,119,-94,331,D,1,1,0
2017-06-06 00:00:00.000000,Malta,Ukraine,1,0,Friendly,Graz,Austria,1,178,97,29,803,149,-706,W,0,0,0
2017-06-06 00:00:00.000000,Qatar,Korea DPR,2,2,Friendly,Doha,Qatar,0,91,385,126,267,-35,118,D,1,1,0
2017-06-06 00:00:00.000000,Uzbekistan,Thailand,2,0,Friendly,Tashkent,Uzbekistan,0,48,617,146,207,-98,410,W,0,1,0
2017-06-07 00:00:00.000000,Bolivia,Nicaragua,3,2,Friendly,Yacuiba,Bolivia,0,80,444,107,325,-27,119,W,0,1,0
2017-06-07 00:00:00.000000,Fiji,New Caledonia,2,2,FIFA World Cup qualification,Lautoka,Fiji,0,179,93,166,128,13,-35,D,1,1,0
2017-06-07 00:00:00.000000,Finland,Liechtenstein,1,1,Friendly,Turku,Finland,0,101,337,183,81,-82,256,D,1,1,0
2017-06-07 00:00:00.000000,Georgia,St. Kitts and Nevis,3,0,Friendly,Tbilisi,Georgia,0,122,276,73,472,49,-196,W,0,1,0
2017-06-07 00:00:00.000000,Hong Kong,Jordan,0,0,Friendly,Kowloon,Hong Kong,0,140,227,104,332,36,-105,D,1,1,0
2017-06-07 00:00:00.000000,Iraq,Korea Republic,0,0,Friendly,Ras al-Khaimah,United Arab Emirates,1,113,314,44,640,69,-326,D,1,0,0
2017-06-07 00:00:00.000000,Italy,Uruguay,3,0,Friendly,Nice,France,1,13,1082,9,1175,4,-93,W,0,0,0
2017-06-07 00:00:00.000000,Japan,Syria,1,1,Friendly,Chōfu,Japan,0,51,601,96,357,-45,244,D,1,1,0
2017-06-07 00:00:00.000000,Spain,Colombia,2,2,Friendly,Murcia,Spain,0,10,1168,5,1361,5,-193,D,1,1,0
2017-06-07 00:00:00.000000,United Arab Emirates,Laos,4,0,Friendly,Shah Alam,Malaysia,1,70,513,175,107,-105,406,W,0,0,0
2017-06-08 00:00:00.000000,Australia,Saudi Arabia,3,2,FIFA World Cup qualification,Adelaide,Australia,0,40,663,54,593,-14,70,W,0,1,0
2017-06-08 00:00:00.000000,Cambodia,Indonesia,0,2,Friendly,Phnom Penh,Cambodia,0,167,123,179,93,-12,30,L,2,1,0
2017-06-08 00:00:00.000000,Costa Rica,Panama,0,0,FIFA World Cup qualification,San José,Costa Rica,0,18,971,63,551,-45,420,D,1,1,0
2017-06-08 00:00:00.000000,Ecuador,Venezuela,1,1,Friendly,Boca Raton,USA,1,19,932,68,516,-49,416,D,1,0,0
2017-06-08 00:00:00.000000,Mexico,Honduras,3,0,FIFA World Cup qualification,Mexico City,Mexico,0,17,1001,86,411,-69,590,W,0,1,0
2017-06-08 00:00:00.000000,Peru,Paraguay,1,0,Friendly,Trujillo,Peru,0,23,865,37,738,-14,127,W,0,1,0
2017-06-08 00:00:00.000000,USA,Trinidad and Tobago,2,0,FIFA World Cup qualification,Commerce City,USA,0,24,852,65,533,-41,319,W,0,1,0
2017-06-09 00:00:00.000000,Andorra,Hungary,1,0,FIFA World Cup qualification,Sant Julià de Lòria,Andorra,0,203,11,22,891,181,-880,W,0,1,0
2017-06-09 00:00:00.000000,Argentina,Brazil,1,0,Friendly,Melbourne,Australia,1,1,1621,3,1410,-2,211,W,0,0,0
2017-06-09 00:00:00.000000,Belarus,Bulgaria,2,1,FIFA World Cup qualification,Barysaw,Belarus,0,77,452,89,395,-12,57,W,0,1,0
2017-06-09 00:00:00.000000,Estonia,Belgium,0,2,FIFA World Cup qualification,Tallinn,Estonia,0,119,299,4,1382,115,-1083,L,2,1,0
2017-06-09 00:00:00.000000,Faroe Islands,Switzerland,0,2,FIFA World Cup qualification,Tórshavn,Faroe Islands,0,74,469,14,1071,60,-602,L,2,1,0
2017-06-09 00:00:00.000000,Gibraltar,Cyprus,1,2,FIFA World Cup qualification,Faro,Portugal,1,205,0,139,228,66,-228,L,2,0,0
2017-06-09 00:00:00.000000,Latvia,Portugal,0,3,FIFA World Cup qualification,Riga,Latvia,0,116,306,8,1231,108,-925,L,2,1,0
2017-06-09 00:00:00.000000,Libya,Seychelles,5,1,African Cup of Nations qualification,New Cairo,Egypt,1,76,461,184,79,-108,382,W,0,0,0
2017-06-09 00:00:00.000000,Netherlands,Luxembourg,5,0,FIFA World Cup qualification,Rotterdam,Netherlands,0,20,901,130,252,-110,649,W,0,1,0
2017-06-09 00:00:00.000000,Russia,Chile,1,1,Friendly,Moscow,Russia,0,53,594,6,1273,47,-679,D,1,1,0
2017-06-09 00:00:00.000000,Solomon Islands,Papua New Guinea,3,2,FIFA World Cup qualification,Honiara,Solomon Islands,0,193,56,159,152,34,-96,W,0,1,0
2017-06-09 00:00:00.000000,Sudan,Madagascar,1,3,African Cup of Nations qualification,al-Ubayyid,Sudan,0,148,204,133,243,15,-39,L,2,1,0
2017-06-09 00:00:00.000000,Sweden,France,2,1,FIFA World Cup qualification,Solna,Sweden,0,39,715,7,1271,32,-556,W,0,1,0
2017-06-10 00:00:00.000000,Azerbaijan,Northern Ireland,0,1,FIFA World Cup qualification,Baku,Azerbaijan,0,88,404,36,739,52,-335,L,2,1,0
2017-06-10 00:00:00.000000,Burkina Faso,Angola,3,1,African Cup of Nations qualification,Ouagadougou,Burkina Faso,0,67,519,134,236,-67,283,W,0,1,0
2017-06-10 00:00:00.000000,Burundi,South Sudan,3,0,African Cup of Nations qualification,Bujumbura,Burundi,0,138,229,167,123,-29,106,W,0,1,0
2017-06-10 00:00:00.000000,Cameroon,Morocco,1,0,African Cup of Nations qualification,Yaoundé,Cameroon,0,59,567,60,562,-1,5,W,0,1,0
2017-06-10 00:00:00.000000,Congo DR,Congo,3,1,African Cup of Nations qualification,Kinshasa,Congo DR,0,49,609,55,575,-6,34,W,0,1,0
2017-06-10 00:00:00.000000,Germany,San Marino,7,0,FIFA World Cup qualification,Nuremberg,Germany,0,2,1465,201,17,-199,1448,W,0,1,0
2017-06-10 00:00:00.000000,Grenada,Bermuda,1,2,Friendly,St. George's,Grenada,0,154,172,185,77,-31,95,L,2,1,0
2017-06-10 00:00:00.000000,Guinea-Bissau,Namibia,1,0,African Cup of Nations qualification,Bissau,Guinea-Bissau,0,69,515,118,300,-49,215,W,0,1,0
2017-06-10 00:00:00.000000,Kazakhstan,Denmark,1,3,FIFA World Cup qualification,Almaty,Kazakhstan,0,90,386,50,606,40,-220,L,2,1,0
2017-06-10 00:00:00.000000,Lithuania,Slovakia,1,2,FIFA World Cup qualification,Vilnius,Lithuania,0,98,347,26,840,72,-493,L,2,1,0
2017-06-10 00:00:00.000000,Malawi,Comoros,1,0,African Cup of Nations qualification,Lilongwe,Malawi,0,100,338,143,223,-43,115,W,0,1,0
2017-06-10 00:00:00.000000,Mali,Gabon,2,1,African Cup of Nations qualification,Bamako,Mali,0,58,568,110,323,-52,245,W,0,1,0
2017-06-10 00:00:00.000000,Montenegro,Armenia,4,1,FIFA World Cup qualification,Podgorica,Montenegro,0,56,570,125,270,-69,300,W,0,1,0
2017-06-10 00:00:00.000000,Niger,Swaziland,0,0,African Cup of Nations qualification,Niamey,Niger,0,128,262,106,330,22,-68,D,1,1,0
2017-06-10 00:00:00.000000,Nigeria,South Africa,0,2,African Cup of Nations qualification,Uyo,Nigeria,0,60,562,62,559,-2,3,L,2,1,0
2017-06-10 00:00:00.000000,Norway,Czech Republic,1,1,FIFA World Cup qualification,Oslo,Norway,0,81,438,40,663,41,-225,D,1,1,0
2017-06-10 00:00:00.000000,Poland,Romania,3,1,FIFA World Cup qualification,Warsaw,Poland,0,15,1029,34,746,-19,283,W,0,1,0
2017-06-10 00:00:00.000000,Scotland,England,2,2,FIFA World Cup qualification,Glasgow,Scotland,0,57,569,12,1090,45,-521,D,1,1,0
2017-06-10 00:00:00.000000,Senegal,Equatorial Guinea,3,0,African Cup of Nations qualification,Dakar,Senegal,0,32,783,92,380,-60,403,W,0,1,0
2017-06-10 00:00:00.000000,Sierra Leone,Kenya,2,1,African Cup of Nations qualification,Freetown,Sierra Leone,0,97,352,85,416,12,-64,W,0,1,0
2017-06-10 00:00:00.000000,Slovenia,Malta,2,0,FIFA World Cup qualification,Ljubljana,Slovenia,0,52,595,178,97,-126,498,W,0,1,0
2017-06-10 00:00:00.000000,Tanzania,Lesotho,1,1,African Cup of Nations qualification,Dar es Salaam,Tanzania,0,144,212,150,201,-6,11,D,1,1,0
2017-06-10 00:00:00.000000,Zambia,Mozambique,0,1,African Cup of Nations qualification,Ndola,Zambia,0,94,374,95,359,-1,15,L,2,1,0
2017-06-11 00:00:00.000000,Algeria,Togo,1,0,African Cup of Nations qualification,Blida,Algeria,0,35,741,93,375,-58,366,W,0,1,0
2017-06-11 00:00:00.000000,Benin,Gambia,1,0,African Cup of Nations qualification,Cotonou,Benin,0,66,525,176,106,-110,419,W,0,1,0
2017-06-11 00:00:00.000000,Central African Republic,Rwanda,2,1,African Cup of Nations qualification,Bangui,Central African Republic,0,107,325,107,325,0,0,W,0,1,0
2017-06-11 00:00:00.000000,Finland,Ukraine,1,2,FIFA World Cup qualification,Tampere,Finland,0,101,337,29,803,72,-466,L,2,1,0
2017-06-11 00:00:00.000000,Ghana,Ethiopia,5,0,African Cup of Nations qualification,Kumasi,Ghana,0,45,628,126,267,-81,361,W,0,1,0
2017-06-11 00:00:00.000000,Iceland,Croatia,1,0,FIFA World Cup qualification,Reykjavík,Iceland,0,21,898,16,1027,5,-129,W,0,1,0
2017-06-11 00:00:00.000000,Israel,Albania,0,3,FIFA World Cup qualification,Haifa,Israel,0,79,450,47,619,32,-169,L,2,1,0
2017-06-11 00:00:00.000000,Italy,Liechtenstein,5,0,FIFA World Cup qualification,Udine,Italy,0,13,1082,183,81,-170,1001,W,0,1,0
2017-06-11 00:00:00.000000,Kosovo,Turkey,1,4,FIFA World Cup qualification,Shkodër,Albania,1,164,135,25,843,139,-708,L,2,0,0
2017-06-11 00:00:00.000000,Mexico,USA,1,1,FIFA World Cup qualification,Mexico City,Mexico,0,17,1001,24,852,-7,149,D,1,1,0
2017-06-11 00:00:00.000000,Moldova,Georgia,2,2,FIFA World Cup qualification,Chișinău,Moldova,0,173,119,122,276,51,-157,D,1,1,0
2017-06-11 00:00:00.000000,New Caledonia,Fiji,2,1,FIFA World Cup qualification,Nouméa,New Caledonia,0,166,128,179,93,-13,35,W,0,1,0
2017-06-11 00:00:00.000000,Serbia,Wales,1,1,FIFA World Cup qualification,Belgrade,Serbia,0,43,650,11,1113,32,-463,D,1,1,0
2017-06-11 00:00:00.000000,Zimbabwe,Liberia,3,0,African Cup of Nations qualification,Harare,Zimbabwe,0,110,323,104,332,6,-9,W,0,1,0
2017-06-12 00:00:00.000000,Belarus,New Zealand,1,0,Friendly,Minsk,Belarus,0,77,452,116,306,-39,146,W,0,1,0
2017-06-12 00:00:00.000000,Iran,Uzbekistan,2,0,FIFA World Cup qualification,Teheran,Iran,0,27,837,48,617,-21,220,W,0,1,0
2017-06-12 00:00:00.000000,Latvia,Estonia,1,2,Friendly,Riga,Latvia,0,116,306,119,299,-3,7,L,2,1,0
2017-06-13 00:00:00.000000,Australia,Brazil,0,4,Friendly,Melbourne,Australia,0,40,663,3,1410,37,-747,L,2,1,0
2017-06-13 00:00:00.000000,Bhutan,Maldives,0,2,AFC Asian Cup qualification,Thimphu,Bhutan,0,179,93,158,161,21,-68,L,2,1,0
2017-06-13 00:00:00.000000,Cambodia,Afghanistan,1,0,AFC Asian Cup qualification,Phnom Penh,Cambodia,0,167,123,145,208,22,-85,W,0,1,0
2017-06-13 00:00:00.000000,Cameroon,Colombia,0,4,Friendly,Getafe,Spain,1,59,567,5,1361,54,-794,L,2,0,0
2017-06-13 00:00:00.000000,Canada,Curaçao,2,1,Friendly,Montréal,Canada,0,110,323,77,452,33,-129,W,0,1,0
2017-06-13 00:00:00.000000,Costa Rica,Trinidad and Tobago,2,1,FIFA World Cup qualification,San José,Costa Rica,0,18,971,65,533,-47,438,W,0,1,0
2017-06-13 00:00:00.000000,El Salvador,Ecuador,0,3,Friendly,Harrison,USA,1,135,232,19,932,116,-700,L,2,0,0
2017-06-13 00:00:00.000000,France,England,3,2,Friendly,Saint-Denis,France,0,7,1271,12,1090,-5,181,W,0,1,0
2017-06-13 00:00:00.000000,Hong Kong,Korea DPR,1,1,AFC Asian Cup qualification,So Kon Po,Hong Kong,0,140,227,126,267,14,-40,D,1,1,0
2017-06-13 00:00:00.000000,Indonesia,Puerto Rico,0,0,Friendly,Sleman,Indonesia,0,179,93,151,194,28,-101,D,1,1,0
2017-06-13 00:00:00.000000,Iraq,Japan,1,1,FIFA World Cup qualification,Teheran,Iran,1,113,314,51,601,62,-287,D,1,0,0
2017-06-13 00:00:00.000000,Malaysia,Lebanon,1,2,AFC Asian Cup qualification,Johor Bahru,Malaysia,0,164,135,149,202,15,-67,L,2,1,0
2017-06-13 00:00:00.000000,Nepal,Yemen,0,0,AFC Asian Cup qualification,Kathmandu,Nepal,0,186,74,132,244,54,-170,D,1,1,0
2017-06-13 00:00:00.000000,Norway,Sweden,1,1,Friendly,Oslo,Norway,0,81,438,39,715,42,-277,D,1,1,0
2017-06-13 00:00:00.000000,Palestine,Oman,2,1,AFC Asian Cup qualification,al-Ram,Palestine,0,120,285,129,260,-9,25,W,0,1,0
2017-06-13 00:00:00.000000,Panama,Honduras,2,2,FIFA World Cup qualification,Panama City,Panama,0,63,551,86,411,-23,140,D,1,1,0
2017-06-13 00:00:00.000000,Papua New Guinea,Solomon Islands,1,2,FIFA World Cup qualification,Port Moresby,Papua New Guinea,0,159,152,193,56,-34,96,L,2,1,0
2017-06-13 00:00:00.000000,Qatar,Korea Republic,3,2,FIFA World Cup qualification,Doha,Qatar,0,91,385,44,640,47,-255,W,0,1,0
2017-06-13 00:00:00.000000,Romania,Chile,3,2,Friendly,Cluj,Romania,0,34,746,6,1273,28,-527,W,0,1,0
2017-06-13 00:00:00.000000,Singapore,Argentina,0,6,Friendly,Kallang,Singapore,0,171,122,1,1621,170,-1499,L,2,1,0
2017-06-13 00:00:00.000000,South Africa,Zambia,1,2,Friendly,Moruleng,South Africa,0,62,559,94,374,-32,185,L,2,1,0
2017-06-13 00:00:00.000000,Tajikistan,Philippines,3,4,AFC Asian Cup qualification,Dushanbe,Tajikistan,0,140,227,124,271,16,-44,L,2,1,0
2017-06-13 00:00:00.000000,Thailand,United Arab Emirates,1,1,FIFA World Cup qualification,Bangkok,Thailand,0,146,207,70,513,76,-306,D,1,1,0
2017-06-13 00:00:00.000000,Turkmenistan,Bahrain,1,2,AFC Asian Cup qualification,Daşoguz,Turkmenistan,0,114,309,123,272,-9,37,L,2,1,0
2017-06-13 00:00:00.000000,Vietnam,Jordan,0,0,AFC Asian Cup qualification,Ho Chi Minh City,Vietnam,0,136,231,104,332,32,-101,D,1,1,0
2017-06-17 00:00:00.000000,Curaçao,Nicaragua,0,0,Friendly,Willemstad,Curaçao,0,77,452,107,325,-30,127,D,1,1,0
2017-06-17 00:00:00.000000,Russia,New Zealand,2,0,Confederations Cup,St. Petersburg,Russia,0,53,594,116,306,-63,288,W,0,1,0
2017-06-18 00:00:00.000000,Cameroon,Chile,0,2,Confederations Cup,Moscow,Russia,1,59,567,6,1273,53,-706,L,2,0,0
2017-06-18 00:00:00.000000,Portugal,Mexico,2,2,Confederations Cup,Kazan,Russia,1,8,1231,17,1001,-9,230,D,1,0,0
2017-06-19 00:00:00.000000,Australia,Germany,2,3,Confederations Cup,Sochi,Russia,1,40,663,2,1465,38,-802,L,2,0,0
2017-06-21 00:00:00.000000,Mexico,New Zealand,2,1,Confederations Cup,Sochi,Russia,1,17,1001,116,306,-99,695,W,0,0,0
2017-06-21 00:00:00.000000,Russia,Portugal,0,1,Confederations Cup,Moscow,Russia,0,53,594,8,1231,45,-637,L,2,1,0
2017-06-22 00:00:00.000000,Cameroon,Australia,1,1,Confederations Cup,St. Petersburg,Russia,1,59,567,40,663,19,-96,D,1,0,0
2017-06-22 00:00:00.000000,Germany,Chile,1,1,Confederations Cup,Kazan,Russia,1,2,1465,6,1273,-4,192,D,1,0,0
2017-06-24 00:00:00.000000,New Zealand,Portugal,0,4,Confederations Cup,St. Petersburg,Russia,1,116,306,8,1231,108,-925,L,2,0,0
2017-06-24 00:00:00.000000,Russia,Mexico,1,2,Confederations Cup,Kazan,Russia,0,53,594,17,1001,36,-407,L,2,1,0
2017-06-25 00:00:00.000000,Chile,Australia,1,1,Confederations Cup,Moscow,Russia,1,6,1273,40,663,-34,610,D,1,0,0
2017-06-25 00:00:00.000000,Germany,Cameroon,3,1,Confederations Cup,Sochi,Russia,1,2,1465,59,567,-57,898,W,0,0,0
2017-06-25 00:00:00.000000,Jamaica,Curaçao,1,2,CFU Caribbean Cup,Fort-de-France,Martinique,1,75,464,77,452,-2,12,L,2,0,0
2017-06-25 00:00:00.000000,Mauritius,Angola,0,1,COSAFA Cup,Moruleng,South Africa,1,151,194,134,236,17,-42,L,2,0,0
2017-06-25 00:00:00.000000,Tanzania,Malawi,2,0,COSAFA Cup,Moruleng,South Africa,1,144,212,100,338,44,-126,W,0,0,0
2017-06-26 00:00:00.000000,Madagascar,Seychelles,2,0,COSAFA Cup,Moruleng,South Africa,1,133,243,184,79,-51,164,W,0,0,0
2017-06-26 00:00:00.000000,Mozambique,Zimbabwe,0,4,COSAFA Cup,Moruleng,South Africa,1,95,359,110,323,-15,36,L,2,0,0
2017-06-27 00:00:00.000000,Angola,Tanzania,0,0,COSAFA Cup,Rustenburg,South Africa,1,134,236,144,212,-10,24,D,1,0,0
2017-06-27 00:00:00.000000,Malawi,Mauritius,0,0,COSAFA Cup,Rustenburg,South Africa,1,100,338,151,194,-51,144,D,1,0,0
2017-06-28 00:00:00.000000,Portugal,Chile,0,0,Confederations Cup,Kazan,Russia,1,8,1231,6,1273,2,-42,D,1,0,0
2017-06-28 00:00:00.000000,Seychelles,Mozambique,1,2,COSAFA Cup,Rustenburg,South Africa,1,184,79,95,359,89,-280,L,2,0,0
2017-06-28 00:00:00.000000,St. Lucia,St. Vincent and the Grenadines,2,1,Windward Islands Tournament,St. George's,Grenada,1,167,123,162,142,5,-19,W,0,0,0
2017-06-28 00:00:00.000000,Zimbabwe,Madagascar,0,0,COSAFA Cup,Rustenburg,South Africa,1,110,323,133,243,-23,80,D,1,0,0
2017-06-29 00:00:00.000000,Germany,Mexico,4,1,Confederations Cup,Sochi,Russia,1,2,1465,17,1001,-15,464,W,0,0,0
2017-06-29 00:00:00.000000,Malawi,Angola,0,0,COSAFA Cup,Rustenburg,South Africa,1,100,338,134,236,-34,102,D,1,0,0
2017-06-29 00:00:00.000000,Tanzania,Mauritius,1,1,COSAFA Cup,Moruleng,South Africa,1,144,212,151,194,-7,18,D,1,0,0
2017-06-30 00:00:00.000000,Dominica,Barbados,2,1,Windward Islands Tournament,Sauteurs,Grenada,1,174,110,157,163,17,-53,W,0,0,0
2017-06-30 00:00:00.000000,Mozambique,Madagascar,1,4,COSAFA Cup,Moruleng,South Africa,1,95,359,133,243,-38,116,L,2,0,0
2017-06-30 00:00:00.000000,Zimbabwe,Seychelles,6,0,COSAFA Cup,Rustenburg,South Africa,1,110,323,184,79,-74,244,W,0,0,0
2017-07-01 00:00:00.000000,Botswana,Zambia,1,2,COSAFA Cup,Rustenburg,South Africa,1,101,337,94,374,7,-37,L,2,0,0
2017-07-01 00:00:00.000000,Gambia,Guinea-Bissau,0,0,Friendly,Bakau,Gambia,0,176,106,69,515,107,-409,D,1,1,0
2017-07-01 00:00:00.000000,Mexico,Paraguay,2,1,Friendly,Seattle,USA,1,17,1001,37,738,-20,263,W,0,0,0
2017-07-01 00:00:00.000000,Namibia,Lesotho,0,0,COSAFA Cup,Rustenburg,South Africa,1,118,300,150,201,-32,99,D,1,0,0
2017-07-01 00:00:00.000000,USA,Ghana,2,1,Friendly,East Hartford,USA,0,24,852,45,628,-21,224,W,0,1,0
2017-07-02 00:00:00.000000,Chile,Germany,0,1,Confederations Cup,St. Petersburg,Russia,1,6,1273,2,1465,4,-192,L,2,0,0
2017-07-02 00:00:00.000000,Portugal,Mexico,2,1,Confederations Cup,Moscow,Russia,1,8,1231,17,1001,-9,230,W,0,0,0
2017-07-02 00:00:00.000000,South Africa,Tanzania,0,1,COSAFA Cup,Rustenburg,South Africa,0,62,559,144,212,-82,347,L,2,1,0
2017-07-02 00:00:00.000000,Swaziland,Zimbabwe,1,2,COSAFA Cup,Rustenburg,South Africa,1,106,330,110,323,-4,7,L,2,0,0
2017-07-03 00:00:00.000000,Barbados,St. Lucia,1,1,Windward Islands Tournament,St. George's,Grenada,1,157,163,167,123,-10,40,D,1,0,0
2017-07-03 00:00:00.000000,Grenada,St. Vincent and the Grenadines,4,3,Friendly,St. George's,Grenada,0,154,172,162,142,-8,30,W,0,1,0
2017-07-04 00:00:00.000000,Namibia,Swaziland,1,0,COSAFA Cup,Moruleng,South Africa,1,118,300,106,330,12,-30,W,0,0,0
2017-07-04 00:00:00.000000,South Africa,Botswana,2,0,COSAFA Cup,Moruleng,South Africa,0,62,559,101,337,-39,222,W,0,1,0
2017-07-04 00:00:00.000000,St. Lucia,Dominica,0,0,Windward Islands Tournament,St. George's,Grenada,1,167,123,174,110,-7,13,D,1,0,0
2017-07-04 00:00:00.000000,St. Vincent and the Grenadines,Barbados,4,2,Friendly,St. George's,Grenada,1,162,142,157,163,5,-21,W,0,0,0
2017-07-06 00:00:00.000000,Dominica,St. Vincent and the Grenadines,2,2,Windward Islands Tournament,St. George's,Grenada,1,177,90,179,88,-2,2,D,1,0,0
2017-07-06 00:00:00.000000,Grenada,Barbados,0,2,Windward Islands Tournament,St. George's,Grenada,0,163,128,181,84,-18,44,L,2,1,0
2017-07-07 00:00:00.000000,Honduras,Costa Rica,0,1,Gold Cup,Harrison,USA,1,72,499,26,839,46,-340,L,2,0,0
2017-07-07 00:00:00.000000,South Africa,Namibia,1,0,COSAFA Cup,Moruleng,South Africa,0,64,581,156,159,-92,422,W,0,1,0
2017-07-07 00:00:00.000000,Tanzania,Lesotho,0,0,COSAFA Cup,Moruleng,South Africa,1,114,287,138,204,-24,83,D,1,0,0
2017-07-08 00:00:00.000000,Guinea-Bissau,Gambia,0,1,Friendly,Bissau,Guinea-Bissau,0,85,407,161,132,-76,275,L,2,1,0
2017-07-08 00:00:00.000000,USA,Panama,1,1,Gold Cup,Nashville,USA,0,35,752,52,653,-17,99,D,1,1,0
2017-07-09 00:00:00.000000,Curaçao,Jamaica,0,2,Gold Cup,San Diego,USA,1,68,531,76,442,-8,89,L,2,0,0
2017-07-09 00:00:00.000000,Mexico,El Salvador,3,1,Gold Cup,San Diego,USA,1,16,1003,103,319,-87,684,W,0,0,0
2017-07-09 00:00:00.000000,Zambia,Zimbabwe,1,3,COSAFA Cup,Rustenburg,South Africa,1,92,369,101,324,-9,45,L,2,0,0
2017-07-11 00:00:00.000000,Costa Rica,Canada,1,1,Gold Cup,Houston,USA,1,26,839,100,331,-74,508,D,1,0,0
2017-07-12 00:00:00.000000,Panama,Nicaragua,2,1,Gold Cup,Tampa,USA,1,52,653,105,312,-53,341,W,0,0,0
2017-07-13 00:00:00.000000,El Salvador,Curaçao,2,0,Gold Cup,Denver,USA,1,103,319,68,531,35,-212,W,0,0,0
2017-07-13 00:00:00.000000,Mexico,Jamaica,0,0,Gold Cup,Denver,USA,1,16,1003,76,442,-60,561,D,1,0,0
2017-07-14 00:00:00.000000,Canada,Honduras,0,0,Gold Cup,Frisco,USA,1,100,331,72,499,28,-168,D,1,0,0
2017-07-14 00:00:00.000000,Thailand,Korea DPR,3,0,King's Cup,Bangkok,Thailand,0,131,235,113,288,18,-53,W,0,1,0
2017-07-15 00:00:00.000000,USA,Nicaragua,3,0,Gold Cup,Cleveland,USA,0,35,752,105,312,-70,440,W,0,1,0
2017-07-16 00:00:00.000000,Burkina Faso,Korea DPR,3,3,King's Cup,Bangkok,Thailand,1,44,698,113,288,-69,410,D,1,0,0
2017-07-16 00:00:00.000000,Curaçao,Mexico,0,2,Gold Cup,San Antonio,USA,1,68,531,16,1003,52,-472,L,2,0,0
2017-07-16 00:00:00.000000,Jamaica,El Salvador,1,1,Gold Cup,San Antonio,USA,1,76,442,103,319,-27,123,D,1,0,0
2017-07-19 00:00:00.000000,Costa Rica,Panama,1,0,Gold Cup,Philadelphia,USA,1,26,839,52,653,-26,186,W,0,0,0
2017-07-19 00:00:00.000000,USA,El Salvador,2,0,Gold Cup,Philadelphia,USA,0,35,752,103,319,-68,433,W,0,1,0
2017-07-20 00:00:00.000000,Jamaica,Canada,2,1,Gold Cup,Glendale,USA,1,76,442,100,331,-24,111,W,0,0,0
2017-07-20 00:00:00.000000,Mexico,Honduras,1,0,Gold Cup,Glendale,USA,1,16,1003,72,499,-56,504,W,0,0,0
2017-07-22 00:00:00.000000,USA,Costa Rica,2,0,Gold Cup,Arlington,USA,0,35,752,26,839,9,-87,W,0,1,0
2017-07-23 00:00:00.000000,Mexico,Jamaica,0,1,Gold Cup,Pasadena,USA,1,16,1003,76,442,-60,561,L,2,0,0
2017-07-26 00:00:00.000000,Ecuador,Trinidad and Tobago,3,1,Friendly,Guayaquil,Ecuador,0,31,791,78,436,-47,355,W,0,1,0
2017-07-26 00:00:00.000000,USA,Jamaica,2,1,Gold Cup,Santa Clara,USA,0,35,752,76,442,-41,310,W,0,1,0
2017-08-05 00:00:00.000000,Zambia,Ethiopia,0,0,Friendly,Lusaka,Zambia,0,92,369,136,215,-44,154,D,1,1,0
2017-08-07 00:00:00.000000,Rwanda,Sudan,2,1,Friendly,Kigali,Rwanda,0,127,248,164,123,-37,125,W,0,1,0
2017-08-16 00:00:00.000000,Andorra,Qatar,0,1,Friendly,Burton on Trent,England,1,129,246,78,433,51,-187,L,2,0,0
2017-08-19 00:00:00.000000,India,Mauritius,2,1,Friendly,Bombay,India,0,97,341,160,150,-63,191,W,0,1,0
2017-08-22 00:00:00.000000,Malaysia,Syria,1,2,Friendly,Paya Rumput,Malaysia,0,166,119,80,423,86,-304,L,2,1,0
2017-08-22 00:00:00.000000,Mauritius,St. Kitts and Nevis,1,1,Friendly,Bombay,India,1,160,150,125,255,35,-105,D,1,0,0
2017-08-23 00:00:00.000000,Qatar,Turkmenistan,2,1,Friendly,al-Rayyan,Qatar,0,78,433,141,200,-63,233,W,0,1,0
2017-08-24 00:00:00.000000,India,St. Kitts and Nevis,1,1,Friendly,Bombay,India,0,97,341,125,255,-28,86,D,1,1,0
2017-08-24 00:00:00.000000,Trinidad and Tobago,Jamaica,1,2,Friendly,Port of Spain,Trinidad and Tobago,0,83,399,57,614,26,-215,L,2,1,0
2017-08-26 00:00:00.000000,Iraq,Syria,1,1,Friendly,Paya Rumput,Malaysia,1,102,324,80,423,22,-99,D,1,0,0
2017-08-29 00:00:00.000000,Bahrain,Jordan,0,0,Friendly,Isa Town,Bahrain,0,124,257,108,299,16,-42,D,1,1,0
2017-08-29 00:00:00.000000,United Arab Emirates,Saudi Arabia,2,1,FIFA World Cup qualification,al-Ain,United Arab Emirates,0,74,459,59,601,15,-142,W,0,1,0
2017-08-30 00:00:00.000000,Oman,Afghanistan,2,0,Friendly,Muscat,Oman,0,120,259,156,160,-36,99,W,0,1,0
2017-08-31 00:00:00.000000,Belgium,Gibraltar,9,0,FIFA World Cup qualification,Liège,Belgium,0,9,1194,206,0,-197,1194,W,0,1,0
2017-08-31 00:00:00.000000,Brazil,Ecuador,2,0,FIFA World Cup qualification,Porto Alegre,Brazil,0,1,1604,32,791,-31,813,W,0,1,0
2017-08-31 00:00:00.000000,Bulgaria,Sweden,3,2,FIFA World Cup qualification,Sofia,Bulgaria,0,52,643,19,933,33,-290,W,0,1,0
2017-08-31 00:00:00.000000,Chile,Paraguay,0,3,FIFA World Cup qualification,Santiago,Chile,0,7,1250,40,714,-33,536,L,2,1,0
2017-08-31 00:00:00.000000,France,Netherlands,4,0,FIFA World Cup qualification,Saint-Denis,France,0,10,1157,36,734,-26,423,W,0,1,0
2017-08-31 00:00:00.000000,Greece,Estonia,0,0,FIFA World Cup qualification,Piraeus,Greece,0,38,716,98,334,-60,382,D,1,1,0
2017-08-31 00:00:00.000000,Guinea,Libya,3,2,FIFA World Cup qualification,Conakry,Guinea,0,66,536,83,399,-17,137,W,0,1,0
2017-08-31 00:00:00.000000,Hungary,Latvia,3,1,FIFA World Cup qualification,Budapest,Hungary,0,56,616,131,242,-75,374,W,0,1,0
2017-08-31 00:00:00.000000,Japan,Australia,2,0,FIFA World Cup qualification,Saitama,Japan,0,44,696,45,691,-1,5,W,0,1,0
2017-08-31 00:00:00.000000,Kenya,Mauritania,1,1,Friendly,Agadir,Morocco,1,82,412,86,384,-4,28,D,1,0,0
2017-08-31 00:00:00.000000,Korea Republic,Iran,0,0,FIFA World Cup qualification,Seoul,Korea Republic,0,49,674,24,893,25,-219,D,1,1,0
2017-08-31 00:00:00.000000,Luxembourg,Belarus,1,0,FIFA World Cup qualification,Luxembourg,Luxembourg,0,136,223,71,503,65,-280,W,0,1,0
2017-08-31 00:00:00.000000,Niger,Togo,0,2,Friendly,Agadir,Morocco,1,116,272,113,289,3,-17,L,2,0,0
2017-08-31 00:00:00.000000,Peru,Bolivia,2,1,FIFA World Cup qualification,Lima,Peru,0,15,1023,68,532,-53,491,W,0,1,0
2017-08-31 00:00:00.000000,Portugal,Faroe Islands,5,1,FIFA World Cup qualification,Porto,Portugal,0,6,1267,89,376,-83,891,W,0,1,0
2017-08-31 00:00:00.000000,Singapore,Hong Kong,1,1,Friendly,Kallang,Singapore,0,171,116,146,192,25,-76,D,1,1,0
2017-08-31 00:00:00.000000,Switzerland,Andorra,3,0,FIFA World Cup qualification,St. Gallen,Switzerland,0,4,1329,129,246,-125,1083,W,0,1,0
2017-08-31 00:00:00.000000,Syria,Qatar,3,1,FIFA World Cup qualification,Paya Rumput,Malaysia,1,80,423,78,433,2,-10,W,0,0,0
2017-08-31 00:00:00.000000,Thailand,Iraq,1,2,FIFA World Cup qualification,Bangkok,Thailand,0,130,243,102,324,28,-81,L,2,1,0
2017-08-31 00:00:00.000000,Uganda,Egypt,1,0,FIFA World Cup qualification,Kampala,Uganda,0,73,464,25,866,48,-402,W,0,1,0
2017-08-31 00:00:00.000000,Uruguay,Argentina,0,0,FIFA World Cup qualification,Montevideo,Uruguay,0,17,995,3,1399,14,-404,D,1,1,0
2017-08-31 00:00:00.000000,Venezuela,Colombia,0,0,FIFA World Cup qualification,San Cristóbal,Venezuela,0,69,521,8,1208,61,-687,D,1,1,0
2017-09-01 00:00:00.000000,Czech Republic,Germany,1,2,FIFA World Cup qualification,Prague,Czech Republic,0,40,714,2,1549,38,-835,L,2,1,0
2017-09-01 00:00:00.000000,Denmark,Poland,4,0,FIFA World Cup qualification,Copenhagen,Denmark,0,46,683,5,1319,41,-636,W,0,1,0
2017-09-01 00:00:00.000000,Ghana,Congo,1,1,FIFA World Cup qualification,Kumasi,Ghana,0,50,665,81,413,-31,252,D,1,1,0
2017-09-01 00:00:00.000000,Kazakhstan,Montenegro,0,3,FIFA World Cup qualification,Astana,Kazakhstan,0,105,308,52,643,53,-335,L,2,1,0
2017-09-01 00:00:00.000000,Lithuania,Scotland,0,3,FIFA World Cup qualification,Vilnius,Lithuania,0,99,333,58,612,41,-279,L,2,1,0
2017-09-01 00:00:00.000000,Malta,England,0,4,FIFA World Cup qualification,Attard,Malta,0,190,56,13,1051,177,-995,L,2,1,0
2017-09-01 00:00:00.000000,Mexico,Panama,1,0,FIFA World Cup qualification,Mexico City,Mexico,0,14,1046,61,592,-47,454,W,0,1,0
2017-09-01 00:00:00.000000,Morocco,Mali,6,0,FIFA World Cup qualification,Rabat,Morocco,0,60,600,65,545,-5,55,W,0,1,0
2017-09-01 00:00:00.000000,New Zealand,Solomon Islands,6,1,FIFA World Cup qualification,Auckland,New Zealand,0,123,258,155,162,-32,96,W,0,1,0
2017-09-01 00:00:00.000000,Nigeria,Cameroon,4,0,FIFA World Cup qualification,Uyo,Nigeria,0,38,716,35,737,3,-21,W,0,1,0
2017-09-01 00:00:00.000000,Norway,Azerbaijan,2,0,FIFA World Cup qualification,Oslo,Norway,0,85,391,79,427,6,-36,W,0,1,0
2017-09-01 00:00:00.000000,Romania,Armenia,1,0,FIFA World Cup qualification,Bucharest,Romania,0,42,713,72,480,-30,233,W,0,1,0
2017-09-01 00:00:00.000000,San Marino,Northern Ireland,0,3,FIFA World Cup qualification,Serravalle,San Marino,0,204,12,23,897,181,-885,L,2,1,0
2017-09-01 00:00:00.000000,Slovakia,Slovenia,1,0,FIFA World Cup qualification,Trnava,Slovakia,0,22,917,51,652,-29,265,W,0,1,0
2017-09-01 00:00:00.000000,Trinidad and Tobago,Honduras,1,2,FIFA World Cup qualification,Couva,Trinidad and Tobago,0,83,399,75,455,8,-56,L,2,1,0
2017-09-01 00:00:00.000000,Tunisia,Congo DR,2,1,FIFA World Cup qualification,Radès,Tunisia,0,34,776,28,822,6,-46,W,0,1,0
2017-09-01 00:00:00.000000,USA,Costa Rica,0,2,FIFA World Cup qualification,Harrison,USA,0,26,865,21,918,5,-53,L,2,1,0
2017-09-02 00:00:00.000000,Albania,Liechtenstein,2,0,FIFA World Cup qualification,Elbasan,Albania,0,63,583,190,56,-127,527,W,0,1,0
2017-09-02 00:00:00.000000,Canada,Jamaica,2,0,Friendly,Toronto,Canada,0,95,352,57,614,38,-262,W,0,1,0
2017-09-02 00:00:00.000000,Croatia,Kosovo,1,0,FIFA World Cup qualification,Zagreb,Croatia,0,16,1007,180,90,-164,917,W,0,1,0
2017-09-02 00:00:00.000000,Finland,Iceland,1,0,FIFA World Cup qualification,Tampere,Finland,0,110,293,20,927,90,-634,W,0,1,0
2017-09-02 00:00:00.000000,Indonesia,Fiji,0,0,Friendly,Bekasi,Indonesia,0,175,110,181,87,-6,23,D,1,1,0
2017-09-02 00:00:00.000000,Mozambique,Kenya,1,1,Friendly,Maputo,Mozambique,0,104,315,82,412,22,-97,D,1,1,0
2017-09-02 00:00:00.000000,Senegal,Burkina Faso,0,0,FIFA World Cup qualification,Dakar,Senegal,0,31,794,47,678,-16,116,D,1,1,0
2017-09-02 00:00:00.000000,Serbia,Moldova,3,0,FIFA World Cup qualification,Belgrade,Serbia,0,42,713,159,154,-117,559,W,0,1,0
2017-09-02 00:00:00.000000,Spain,Italy,3,0,FIFA World Cup qualification,Madrid,Spain,0,11,1114,12,1059,-1,55,W,0,1,0
2017-09-02 00:00:00.000000,Ukraine,Turkey,2,0,FIFA World Cup qualification,Kharkiv,Ukraine,0,27,843,33,779,-6,64,W,0,1,0
2017-09-02 00:00:00.000000,Wales,Austria,1,0,FIFA World Cup qualification,Cardiff,Wales,0,18,951,37,723,-19,228,W,0,1,0
2017-09-02 00:00:00.000000,Zambia,Algeria,3,1,FIFA World Cup qualification,Lusaka,Zambia,0,96,345,48,677,48,-332,W,0,1,0
2017-09-03 00:00:00.000000,Belarus,Sweden,0,4,FIFA World Cup qualification,Barysaw,Belarus,0,71,503,19,933,52,-430,L,2,1,0
2017-09-03 00:00:00.000000,Equatorial Guinea,Benin,1,2,Friendly,Malabo,Equatorial Guinea,0,116,272,91,369,25,-97,L,2,1,0
2017-09-03 00:00:00.000000,Estonia,Cyprus,1,0,FIFA World Cup qualification,Tallinn,Estonia,0,98,334,94,358,4,-24,W,0,1,0
2017-09-03 00:00:00.000000,Faroe Islands,Andorra,1,0,FIFA World Cup qualification,Tórshavn,Faroe Islands,0,89,376,129,246,-40,130,W,0,1,0
2017-09-03 00:00:00.000000,France,Luxembourg,0,0,FIFA World Cup qualification,Toulouse,France,0,10,1157,136,223,-126,934,D,1,1,0
2017-09-03 00:00:00.000000,Greece,Belgium,1,2,FIFA World Cup qualification,Piraeus,Greece,0,38,716,9,1194,29,-478,L,2,1,0
2017-09-03 00:00:00.000000,Hungary,Portugal,0,1,FIFA World Cup qualification,Budapest,Hungary,0,56,616,6,1267,50,-651,L,2,1,0
2017-09-03 00:00:00.000000,Latvia,Switzerland,0,3,FIFA World Cup qualification,Riga,Latvia,0,131,242,4,1329,127,-1087,L,2,1,0
2017-09-03 00:00:00.000000,Netherlands,Bulgaria,3,1,FIFA World Cup qualification,Amsterdam,Netherlands,0,36,734,52,643,-16,91,W,0,1,0
2017-09-04 00:00:00.000000,Armenia,Denmark,1,4,FIFA World Cup qualification,Yerevan,Armenia,0,72,480,46,683,26,-203,L,2,1,0
2017-09-04 00:00:00.000000,Azerbaijan,San Marino,5,1,FIFA World Cup qualification,Baku,Azerbaijan,0,79,427,204,12,-125,415,W,0,1,0
2017-09-04 00:00:00.000000,Cameroon,Nigeria,1,1,FIFA World Cup qualification,Yaoundé,Cameroon,0,35,737,38,716,-3,21,D,1,1,0
2017-09-04 00:00:00.000000,England,Slovakia,2,1,FIFA World Cup qualification,London,England,0,13,1051,22,917,-9,134,W,0,1,0
2017-09-04 00:00:00.000000,Germany,Norway,6,0,FIFA World Cup qualification,Stuttgart,Germany,0,2,1549,85,391,-83,1158,W,0,1,0
2017-09-04 00:00:00.000000,Libya,Guinea,1,0,FIFA World Cup qualification,Monastir,Tunisia,1,83,399,66,536,17,-137,W,0,0,0
2017-09-04 00:00:00.000000,Malawi,Togo,1,0,Friendly,Agadir,Morocco,1,106,306,113,289,-7,17,W,0,0,0
2017-09-04 00:00:00.000000,Montenegro,Romania,1,0,FIFA World Cup qualification,Podgorica,Montenegro,0,52,643,42,713,10,-70,W,0,1,0
2017-09-04 00:00:00.000000,Northern Ireland,Czech Republic,2,0,FIFA World Cup qualification,Belfast,Northern Ireland,0,23,897,40,714,-17,183,W,0,1,0
2017-09-04 00:00:00.000000,Poland,Kazakhstan,3,0,FIFA World Cup qualification,Warsaw,Poland,0,5,1319,105,308,-100,1011,W,0,1,0
2017-09-04 00:00:00.000000,Scotland,Malta,2,0,FIFA World Cup qualification,Glasgow,Scotland,0,58,612,190,56,-132,556,W,0,1,0
2017-09-04 00:00:00.000000,Slovenia,Lithuania,4,0,FIFA World Cup qualification,Ljubljana,Slovenia,0,51,652,99,333,-48,319,W,0,1,0
2017-09-05 00:00:00.000000,Algeria,Zambia,0,1,FIFA World Cup qualification,Constantine,Algeria,0,48,677,96,345,-48,332,L,2,1,0
2017-09-05 00:00:00.000000,Argentina,Venezuela,1,1,FIFA World Cup qualification,Buenos Aires,Argentina,0,3,1399,69,521,-66,878,D,1,1,0
2017-09-05 00:00:00.000000,Australia,Thailand,2,1,FIFA World Cup qualification,Melbourne,Australia,0,45,691,130,243,-85,448,W,0,1,0
2017-09-05 00:00:00.000000,Austria,Georgia,1,1,FIFA World Cup qualification,Vienna,Austria,0,37,723,112,290,-75,433,D,1,1,0
2017-09-05 00:00:00.000000,Bhutan,Palestine,0,2,AFC Asian Cup qualification,Thimphu,Bhutan,0,165,123,93,364,72,-241,L,2,1,0
2017-09-05 00:00:00.000000,Bolivia,Chile,1,0,FIFA World Cup qualification,La Paz,Bolivia,0,68,532,7,1250,61,-718,W,0,1,0
2017-09-05 00:00:00.000000,Burkina Faso,Senegal,2,2,FIFA World Cup qualification,Ouagadougou,Burkina Faso,0,47,678,31,794,16,-116,D,1,1,0
2017-09-05 00:00:00.000000,Cambodia,Vietnam,1,2,AFC Asian Cup qualification,Phnom Penh,Cambodia,0,176,109,134,231,42,-122,L,2,1,0
2017-09-05 00:00:00.000000,Colombia,Brazil,1,1,FIFA World Cup qualification,Barranquilla,Colombia,0,8,1208,1,1604,7,-396,D,1,1,0
2017-09-05 00:00:00.000000,Congo,Ghana,1,5,FIFA World Cup qualification,Brazzaville,Congo,0,81,413,50,665,31,-252,L,2,1,0
2017-09-05 00:00:00.000000,Congo DR,Tunisia,2,2,FIFA World Cup qualification,Kinshasa,Congo DR,0,28,822,34,776,-6,46,D,1,1,0
2017-09-05 00:00:00.000000,Costa Rica,Mexico,1,1,FIFA World Cup qualification,San José,Costa Rica,0,21,918,14,1046,7,-128,D,1,1,0
2017-09-05 00:00:00.000000,Ecuador,Peru,0,2,FIFA World Cup qualification,Quito,Ecuador,0,32,791,15,1023,17,-232,L,2,1,0
2017-09-05 00:00:00.000000,Egypt,Uganda,1,0,FIFA World Cup qualification,Alexandria,Egypt,0,25,866,73,464,-48,402,W,0,1,0
2017-09-05 00:00:00.000000,Honduras,USA,1,1,FIFA World Cup qualification,San Pedro Sula,Honduras,0,75,455,26,865,49,-410,D,1,1,0
2017-09-05 00:00:00.000000,Iceland,Ukraine,2,0,FIFA World Cup qualification,Reykjavík,Iceland,0,20,927,27,843,-7,84,W,0,1,0
2017-09-05 00:00:00.000000,Iran,Syria,2,2,FIFA World Cup qualification,Teheran,Iran,0,24,893,80,423,-56,470,D,1,1,0
2017-09-05 00:00:00.000000,Iraq,United Arab Emirates,1,0,FIFA World Cup qualification,Amman,Jordan,1,102,324,74,459,28,-135,W,0,0,0
2017-09-05 00:00:00.000000,Italy,Israel,1,0,FIFA World Cup qualification,Reggio Emilia,Italy,0,12,1059,70,512,-58,547,W,0,1,0
2017-09-05 00:00:00.000000,Jordan,Afghanistan,4,1,AFC Asian Cup qualification,Amman,Jordan,0,108,299,156,160,-48,139,W,0,1,0
2017-09-05 00:00:00.000000,Korea DPR,Lebanon,2,2,AFC Asian Cup qualification,P'yŏngyang,Korea DPR,0,110,293,125,255,-15,38,D,1,1,0
2017-09-05 00:00:00.000000,Kosovo,Finland,0,1,FIFA World Cup qualification,Shkodër,Albania,1,180,90,110,293,70,-203,L,2,0,0
2017-09-05 00:00:00.000000,Liechtenstein,Spain,0,8,FIFA World Cup qualification,Vaduz,Liechtenstein,0,190,56,11,1114,179,-1058,L,2,1,0
2017-09-05 00:00:00.000000,Macau,India,0,2,AFC Asian Cup qualification,Macau,Macau,0,183,79,97,341,86,-262,L,2,1,0
2017-09-05 00:00:00.000000,Malaysia,Hong Kong,1,1,AFC Asian Cup qualification,Paya Rumput,Malaysia,0,166,119,146,192,20,-73,D,1,1,0
2017-09-05 00:00:00.000000,Mali,Morocco,0,0,FIFA World Cup qualification,Bamako,Mali,0,65,545,60,600,5,-55,D,1,1,0
2017-09-05 00:00:00.000000,Mauritania,Niger,0,2,Friendly,Agadir,Morocco,1,86,384,116,272,-30,112,L,2,0,0
2017-09-05 00:00:00.000000,Moldova,Wales,0,2,FIFA World Cup qualification,Chișinău,Moldova,0,159,154,18,951,141,-797,L,2,1,0
2017-09-05 00:00:00.000000,Nepal,Tajikistan,1,2,AFC Asian Cup qualification,Lalitpur,Nepal,0,169,117,151,180,18,-63,L,2,1,0
2017-09-05 00:00:00.000000,Oman,Maldives,5,0,AFC Asian Cup qualification,Muscat,Oman,0,120,259,142,199,-22,60,W,0,1,0
2017-09-05 00:00:00.000000,Panama,Trinidad and Tobago,3,0,FIFA World Cup qualification,Panama City,Panama,0,61,592,83,399,-22,193,W,0,1,0
2017-09-05 00:00:00.000000,Paraguay,Uruguay,1,2,FIFA World Cup qualification,Asunción,Paraguay,0,40,714,17,995,23,-281,L,2,1,0
2017-09-05 00:00:00.000000,Philippines,Yemen,2,2,AFC Asian Cup qualification,Bacolod,Philippines,0,127,249,146,192,-19,57,D,1,1,0
2017-09-05 00:00:00.000000,Saudi Arabia,Japan,1,0,FIFA World Cup qualification,Jeddah,Saudi Arabia,0,59,601,44,696,15,-95,W,0,1,0
2017-09-05 00:00:00.000000,Singapore,Turkmenistan,1,1,AFC Asian Cup qualification,Kallang,Singapore,0,171,116,141,200,30,-84,D,1,1,0
2017-09-05 00:00:00.000000,Solomon Islands,New Zealand,2,2,FIFA World Cup qualification,Honiara,Solomon Islands,0,155,162,123,258,32,-96,D,1,1,0
2017-09-05 00:00:00.000000,Turkey,Croatia,1,0,FIFA World Cup qualification,Eskişehir,Turkey,0,33,779,16,1007,17,-228,W,0,1,0
2017-09-05 00:00:00.000000,Uzbekistan,Korea Republic,0,0,FIFA World Cup qualification,Tashkent,Uzbekistan,0,64,579,49,674,15,-95,D,1,1,0
2017-10-02 00:00:00.000000,Macau,Laos,3,1,Friendly,Macau,Macau,0,182,72,166,126,16,-54,W,0,1,0
2017-10-05 00:00:00.000000,Argentina,Peru,0,0,FIFA World Cup qualification,Buenos Aires,Argentina,0,4,1325,12,1103,-8,222,D,1,1,0
2017-10-05 00:00:00.000000,Armenia,Poland,1,6,FIFA World Cup qualification,Yerevan,Armenia,0,83,414,6,1250,77,-836,L,2,1,0
2017-10-05 00:00:00.000000,Azerbaijan,Czech Republic,1,2,FIFA World Cup qualification,Baku,Azerbaijan,0,92,388,58,630,34,-242,L,2,1,0
2017-10-05 00:00:00.000000,Bolivia,Brazil,0,0,FIFA World Cup qualification,La Paz,Bolivia,0,46,666,2,1590,44,-924,D,1,1,0
2017-10-05 00:00:00.000000,Chile,Ecuador,2,1,FIFA World Cup qualification,Santiago,Chile,0,9,1195,35,767,-26,428,W,0,1,0
2017-10-05 00:00:00.000000,Colombia,Paraguay,1,2,FIFA World Cup qualification,Barranquilla,Colombia,0,10,1191,39,738,-29,453,L,2,1,0
2017-10-05 00:00:00.000000,England,Slovenia,1,0,FIFA World Cup qualification,London,England,0,15,1056,55,636,-40,420,W,0,1,0
2017-10-05 00:00:00.000000,Hong Kong,Laos,4,0,Friendly,Kowloon,Hong Kong,0,147,188,166,126,-19,62,W,0,1,0
2017-10-05 00:00:00.000000,Iran,Togo,2,0,Friendly,Teheran,Iran,0,25,865,121,263,-96,602,W,0,1,0
2017-10-05 00:00:00.000000,Iraq,Kenya,2,1,Friendly,Basra,Iraq,0,88,400,88,400,0,0,W,0,1,0
2017-10-05 00:00:00.000000,Malta,Lithuania,1,1,FIFA World Cup qualification,Attard,Malta,0,191,44,120,266,71,-222,D,1,1,0
2017-10-05 00:00:00.000000,Montenegro,Denmark,0,1,FIFA World Cup qualification,Podgorica,Montenegro,0,37,749,26,848,11,-99,L,2,1,0
2017-10-05 00:00:00.000000,Northern Ireland,Germany,1,3,FIFA World Cup qualification,Belfast,Northern Ireland,0,20,945,1,1606,19,-661,L,2,1,0
2017-10-05 00:00:00.000000,Qatar,Singapore,3,1,Friendly,Doha,Qatar,0,85,406,162,134,-77,272,W,0,1,0
2017-10-05 00:00:00.000000,Romania,Kazakhstan,3,1,FIFA World Cup qualification,Ploieşti,Romania,0,41,714,126,254,-85,460,W,0,1,0
2017-10-05 00:00:00.000000,San Marino,Norway,0,8,FIFA World Cup qualification,Serravalle,San Marino,0,204,10,73,472,131,-462,L,2,1,0
2017-10-05 00:00:00.000000,Scotland,Slovakia,1,0,FIFA World Cup qualification,Glasgow,Scotland,0,43,702,19,967,24,-265,W,0,1,0
2017-10-05 00:00:00.000000,Syria,Australia,1,1,FIFA World Cup qualification,Paya Rumput,Malaysia,1,75,465,50,662,25,-197,D,1,0,0
2017-10-05 00:00:00.000000,Venezuela,Uruguay,0,0,FIFA World Cup qualification,San Cristóbal,Venezuela,0,68,525,16,1043,52,-518,D,1,1,0
2017-10-06 00:00:00.000000,Austria,Serbia,3,2,FIFA World Cup qualification,Vienna,Austria,0,57,632,32,789,25,-157,W,0,1,0
2017-10-06 00:00:00.000000,Croatia,Finland,1,1,FIFA World Cup qualification,Rijeka,Croatia,0,18,977,87,404,-69,573,D,1,1,0
2017-10-06 00:00:00.000000,Georgia,Wales,0,1,FIFA World Cup qualification,Tbilisi,Georgia,0,103,328,13,1089,90,-761,L,2,1,0
2017-10-06 00:00:00.000000,Japan,New Zealand,2,1,Friendly,Toyota,Japan,0,40,737,113,289,-73,448,W,0,1,0
2017-10-06 00:00:00.000000,Kosovo,Ukraine,0,2,FIFA World Cup qualification,Shkodër,Albania,1,184,67,24,888,160,-821,L,2,0,0
2017-10-06 00:00:00.000000,Liechtenstein,Israel,0,1,FIFA World Cup qualification,Vaduz,Liechtenstein,0,187,56,82,420,105,-364,L,2,1,0
2017-10-06 00:00:00.000000,Mauritania,Comoros,0,1,Friendly,La Marsa,Tunisia,1,98,365,141,204,-43,161,L,2,0,0
2017-10-06 00:00:00.000000,Mexico,Trinidad and Tobago,3,1,FIFA World Cup qualification,San Luis Potosí,Mexico,0,14,1085,99,361,-85,724,W,0,1,0
2017-10-06 00:00:00.000000,Spain,Albania,3,0,FIFA World Cup qualification,Alicante,Spain,0,11,1184,66,551,-55,633,W,0,1,0
2017-10-06 00:00:00.000000,Turkey,Iceland,0,3,FIFA World Cup qualification,Eskişehir,Turkey,0,27,842,22,931,5,-89,L,2,1,0
2017-10-06 00:00:00.000000,USA,Panama,4,0,FIFA World Cup qualification,Orlando,USA,0,28,828,60,618,-32,210,W,0,1,0
2017-10-07 00:00:00.000000,Andorra,Portugal,0,2,FIFA World Cup qualification,Sant Julià de Lòria,Andorra,0,144,191,3,1386,141,-1195,L,2,1,0
2017-10-07 00:00:00.000000,Belarus,Netherlands,1,3,FIFA World Cup qualification,Barysaw,Belarus,0,77,454,29,819,48,-365,L,2,1,0
2017-10-07 00:00:00.000000,Bulgaria,France,0,1,FIFA World Cup qualification,Sofia,Bulgaria,0,38,739,8,1208,30,-469,L,2,1,0
2017-10-07 00:00:00.000000,Cameroon,Algeria,2,0,FIFA World Cup qualification,Yaoundé,Cameroon,0,45,689,62,564,-17,125,W,0,1,0
2017-10-07 00:00:00.000000,Costa Rica,Honduras,1,1,FIFA World Cup qualification,San José,Costa Rica,0,21,936,74,467,-53,469,D,1,1,0
2017-10-07 00:00:00.000000,Cyprus,Greece,1,2,FIFA World Cup qualification,Nicosia,Cyprus,0,70,487,47,665,23,-178,L,2,1,0
2017-10-07 00:00:00.000000,Faroe Islands,Latvia,0,0,FIFA World Cup qualification,Tórshavn,Faroe Islands,0,93,384,148,182,-55,202,D,1,1,0
2017-10-07 00:00:00.000000,Gibraltar,Estonia,0,6,FIFA World Cup qualification,Faro,Portugal,1,206,0,84,413,122,-413,L,2,0,0
2017-10-07 00:00:00.000000,Grenada,Guyana,1,0,Friendly,St. George's,Grenada,0,159,141,156,148,3,-7,W,0,1,0
2017-10-07 00:00:00.000000,Guinea,Tunisia,1,4,FIFA World Cup qualification,Conakry,Guinea,0,65,554,31,810,34,-256,L,2,1,0
2017-10-07 00:00:00.000000,Libya,Congo DR,1,2,FIFA World Cup qualification,Monastir,Tunisia,1,81,422,42,709,39,-287,L,2,0,0
2017-10-07 00:00:00.000000,Morocco,Gabon,3,0,FIFA World Cup qualification,Casablanca,Morocco,0,56,635,79,430,-23,205,W,0,1,0
2017-10-07 00:00:00.000000,Nigeria,Zambia,1,0,FIFA World Cup qualification,Uyo,Nigeria,0,44,696,78,448,-34,248,W,0,1,0
2017-10-07 00:00:00.000000,Russia,Korea Republic,4,2,Friendly,Moscow,Russia,0,64,558,51,659,13,-101,W,0,1,0
2017-10-07 00:00:00.000000,Saudi Arabia,Jamaica,5,2,Friendly,Jeddah,Saudi Arabia,0,53,641,61,607,-8,34,W,0,1,0
2017-10-07 00:00:00.000000,South Africa,Burkina Faso,3,1,FIFA World Cup qualification,Johannesburg,South Africa,0,80,423,49,663,31,-240,W,0,1,0
2017-10-07 00:00:00.000000,Sweden,Luxembourg,8,0,FIFA World Cup qualification,Solna,Sweden,0,23,918,101,343,-78,575,W,0,1,0
2017-10-07 00:00:00.000000,Switzerland,Hungary,5,2,FIFA World Cup qualification,Basel,Switzerland,0,7,1210,59,629,-52,581,W,0,1,0
2017-10-07 00:00:00.000000,Tanzania,Malawi,1,1,Friendly,Dar es Salaam,Tanzania,0,125,256,116,278,9,-22,D,1,1,0
2017-10-07 00:00:00.000000,Uganda,Ghana,0,0,FIFA World Cup qualification,Kampala,Uganda,0,71,486,52,646,19,-160,D,1,1,0
2017-10-08 00:00:00.000000,Czech Republic,San Marino,5,0,FIFA World Cup qualification,Plzeň,Czech Republic,0,58,630,204,10,-146,620,W,0,1,0
2017-10-08 00:00:00.000000,Denmark,Romania,1,1,FIFA World Cup qualification,Copenhagen,Denmark,0,26,848,41,714,-15,134,D,1,1,0
2017-10-08 00:00:00.000000,Egypt,Congo,2,1,FIFA World Cup qualification,Alexandria,Egypt,0,30,815,95,378,-65,437,W,0,1,0
2017-10-08 00:00:00.000000,El Salvador,Canada,1,0,Friendly,Houston,USA,1,99,361,96,368,3,-7,W,0,0,0
2017-10-08 00:00:00.000000,Germany,Azerbaijan,5,1,FIFA World Cup qualification,Kaiserslautern,Germany,0,1,1606,92,388,-91,1218,W,0,1,0
2017-10-08 00:00:00.000000,Kazakhstan,Armenia,1,1,FIFA World Cup qualification,Astana,Kazakhstan,0,126,254,83,414,43,-160,D,1,1,0
2017-10-08 00:00:00.000000,Lithuania,England,0,1,FIFA World Cup qualification,Vilnius,Lithuania,0,120,266,15,1056,105,-790,L,2,1,0
2017-10-08 00:00:00.000000,Norway,Northern Ireland,1,0,FIFA World Cup qualification,Oslo,Norway,0,73,472,20,945,53,-473,W,0,1,0
2017-10-08 00:00:00.000000,Poland,Montenegro,4,2,FIFA World Cup qualification,Warsaw,Poland,0,6,1250,37,749,-31,501,W,0,1,0
2017-10-08 00:00:00.000000,Slovakia,Malta,3,0,FIFA World Cup qualification,Trnava,Slovakia,0,19,967,191,44,-172,923,W,0,1,0
2017-10-08 00:00:00.000000,Slovenia,Scotland,2,2,FIFA World Cup qualification,Ljubljana,Slovenia,0,55,636,43,702,12,-66,D,1,1,0
2017-10-08 00:00:00.000000,Thailand,Kenya,1,0,Friendly,Pak Kret,Thailand,0,137,219,88,400,49,-181,W,0,1,0
2017-10-09 00:00:00.000000,Albania,Italy,0,1,FIFA World Cup qualification,Shkodër,Albania,0,66,551,17,1035,49,-484,L,2,1,0
2017-10-09 00:00:00.000000,Equatorial Guinea,Mauritius,3,1,Friendly,Bata,Equatorial Guinea,0,135,224,161,136,-26,88,W,0,1,0
2017-10-09 00:00:00.000000,Finland,Turkey,2,2,FIFA World Cup qualification,Turku,Finland,0,87,404,27,842,60,-438,D,1,1,0
2017-10-09 00:00:00.000000,Iceland,Kosovo,2,0,FIFA World Cup qualification,Reykjavík,Iceland,0,22,931,184,67,-162,864,W,0,1,0
2017-10-09 00:00:00.000000,Israel,Spain,0,1,FIFA World Cup qualification,Jerusalem,Israel,0,82,420,11,1184,71,-764,L,2,1,0
2017-10-09 00:00:00.000000,Moldova,Austria,0,1,FIFA World Cup qualification,Chișinău,Moldova,0,156,148,57,632,99,-484,L,2,1,0
2017-10-09 00:00:00.000000,Serbia,Georgia,1,0,FIFA World Cup qualification,Belgrade,Serbia,0,32,789,103,328,-71,461,W,0,1,0
2017-10-09 00:00:00.000000,Ukraine,Croatia,0,2,FIFA World Cup qualification,Kyïv,Ukraine,0,24,888,18,977,6,-89,L,2,1,0
2017-10-10 00:00:00.000000,Afghanistan,Jordan,3,3,AFC Asian Cup qualification,Dushanbe,Tajikistan,1,158,147,110,305,48,-158,D,1,0,0
2017-10-10 00:00:00.000000,Australia,Syria,2,1,FIFA World Cup qualification,Sydney,Australia,0,50,662,75,465,-25,197,W,0,1,0
2017-10-10 00:00:00.000000,Belgium,Cyprus,4,0,FIFA World Cup qualification,Brussels,Belgium,0,5,1265,70,487,-65,778,W,0,1,0
2017-10-10 00:00:00.000000,Benin,Gabon,1,0,Friendly,Salon-de-Provence,France,1,88,400,79,430,9,-30,W,0,0,0
2017-10-10 00:00:00.000000,Brazil,Chile,3,0,FIFA World Cup qualification,São Paulo,Brazil,0,2,1590,9,1195,-7,395,W,0,1,0
2017-10-10 00:00:00.000000,Ecuador,Argentina,1,3,FIFA World Cup qualification,Quito,Ecuador,0,35,767,4,1325,31,-558,L,2,1,0
2017-10-10 00:00:00.000000,France,Belarus,2,1,FIFA World Cup qualification,Saint-Denis,France,0,8,1208,77,454,-69,754,W,0,1,0
2017-10-10 00:00:00.000000,Greece,Gibraltar,4,0,FIFA World Cup qualification,Piraeus,Greece,0,47,665,206,0,-159,665,W,0,1,0
2017-10-10 00:00:00.000000,Honduras,Mexico,3,2,FIFA World Cup qualification,San Pedro Sula,Honduras,0,74,467,14,1085,60,-618,W,0,1,0
2017-10-10 00:00:00.000000,Hong Kong,Malaysia,2,0,AFC Asian Cup qualification,So Kon Po,Hong Kong,0,147,188,166,126,-19,62,W,0,1,0
2017-10-10 00:00:00.000000,Hungary,Faroe Islands,1,0,FIFA World Cup qualification,Budapest,Hungary,0,59,629,93,384,-34,245,W,0,1,0
2017-10-10 00:00:00.000000,Japan,Haiti,3,3,Friendly,Yokohama,Japan,0,40,737,48,664,-8,73,D,1,1,0
2017-10-10 00:00:00.000000,Korea Republic,Morocco,1,3,Friendly,Biel,Switzerland,1,51,659,56,635,-5,24,L,2,0,0
2017-10-10 00:00:00.000000,Latvia,Andorra,4,0,FIFA World Cup qualification,Riga,Latvia,0,148,182,144,191,4,-9,W,0,1,0
2017-10-10 00:00:00.000000,Lebanon,Korea DPR,5,0,AFC Asian Cup qualification,Beirut,Lebanon,0,115,280,124,258,-9,22,W,0,1,0
2017-10-10 00:00:00.000000,Luxembourg,Bulgaria,1,1,FIFA World Cup qualification,Luxembourg,Luxembourg,0,101,343,38,739,63,-396,D,1,1,0
2017-10-10 00:00:00.000000,Maldives,Oman,1,3,AFC Asian Cup qualification,Malé,Maldives,0,154,156,112,292,42,-136,L,2,1,0
2017-10-10 00:00:00.000000,Netherlands,Sweden,2,0,FIFA World Cup qualification,Amsterdam,Netherlands,0,29,819,23,918,6,-99,W,0,1,0
2017-10-10 00:00:00.000000,Palestine,Bhutan,10,0,AFC Asian Cup qualification,Hebron,Palestine,0,91,389,174,102,-83,287,W,0,1,0
2017-10-10 00:00:00.000000,Panama,Costa Rica,2,1,FIFA World Cup qualification,Panama City,Panama,0,60,618,21,936,39,-318,W,0,1,0
2017-10-10 00:00:00.000000,Paraguay,Venezuela,0,1,FIFA World Cup qualification,Asunción,Paraguay,0,39,738,68,525,-29,213,L,2,1,0
2017-10-10 00:00:00.000000,Peru,Colombia,1,1,FIFA World Cup qualification,Lima,Peru,0,12,1103,10,1191,2,-88,D,1,1,0
2017-10-10 00:00:00.000000,Portugal,Switzerland,2,0,FIFA World Cup qualification,Lisbon,Portugal,0,3,1386,7,1210,-4,176,W,0,1,0
2017-10-10 00:00:00.000000,Qatar,Curaçao,1,2,Friendly,Doha,Qatar,0,85,406,86,405,-1,1,L,2,1,0
2017-10-10 00:00:00.000000,Russia,Iran,1,1,Friendly,Kazan,Russia,0,64,558,25,865,39,-307,D,1,1,0
2017-10-10 00:00:00.000000,Saudi Arabia,Ghana,0,3,Friendly,Jeddah,Saudi Arabia,0,53,641,52,646,1,-5,L,2,1,0
2017-10-10 00:00:00.000000,Tajikistan,Nepal,3,0,AFC Asian Cup qualification,Hisor,Tajikistan,0,140,213,175,101,-35,112,W,0,1,0
2017-10-10 00:00:00.000000,Trinidad and Tobago,USA,2,1,FIFA World Cup qualification,Couva,Trinidad and Tobago,0,99,361,28,828,71,-467,W,0,1,0
2017-10-10 00:00:00.000000,Turkmenistan,Singapore,2,1,AFC Asian Cup qualification,Ashgabat,Turkmenistan,0,136,221,162,134,-26,87,W,0,1,0
2017-10-10 00:00:00.000000,Uruguay,Bolivia,4,2,FIFA World Cup qualification,Montevideo,Uruguay,0,16,1043,46,666,-30,377,W,0,1,0
2017-10-10 00:00:00.000000,Vietnam,Cambodia,5,0,AFC Asian Cup qualification,Hanoi,Vietnam,0,130,241,172,110,-42,131,W,0,1,0
2017-10-10 00:00:00.000000,Yemen,Philippines,1,1,AFC Asian Cup qualification,al-Wakrah,Qatar,1,128,247,123,259,5,-12,D,1,0,0
2017-10-11 00:00:00.000000,India,Macau,4,1,AFC Asian Cup qualification,Bangalore,India,0,107,316,182,72,-75,244,W,0,1,0
2017-10-24 00:00:00.000000,Grenada,Panama,0,5,Friendly,St. George's,Grenada,0,157,141,49,670,108,-529,L,2,1,0
2017-10-28 00:00:00.000000,Bermuda,Barbados,2,3,Friendly,Hamilton,Bermuda,0,181,72,160,128,21,-56,L,2,1,0
2017-11-08 00:00:00.000000,Congo,Benin,1,1,Friendly,Brazzaville,Congo,0,94,367,79,438,15,-71,D,1,1,0
2017-11-08 00:00:00.000000,Iceland,Czech Republic,1,2,Friendly,Doha,Qatar,1,21,920,46,699,-25,221,L,2,0,0
2017-11-08 00:00:00.000000,Nicaragua,Dominican Republic,0,3,Friendly,Diriamba,Nicaragua,0,108,303,163,121,-55,182,L,2,1,0
2017-11-09 00:00:00.000000,Armenia,Belarus,4,1,Friendly,Yerevan,Armenia,0,90,392,91,391,-1,1,W,0,1,0
2017-11-09 00:00:00.000000,Croatia,Greece,4,1,FIFA World Cup qualification,Zagreb,Croatia,0,18,1013,47,682,-29,331,W,0,1,0
2017-11-09 00:00:00.000000,Finland,Estonia,3,0,Friendly,Helsinki,Finland,0,74,473,80,429,-6,44,W,0,1,0
2017-11-09 00:00:00.000000,Hong Kong,Bahrain,0,2,Friendly,Kowloon,Hong Kong,0,142,211,125,251,17,-40,L,2,1,0
2017-11-09 00:00:00.000000,Iran,Panama,2,1,Friendly,Graz,Austria,1,34,784,49,670,-15,114,W,0,0,0
2017-11-09 00:00:00.000000,Luxembourg,Hungary,2,1,Friendly,Luxembourg,Luxembourg,0,93,368,53,642,40,-274,W,0,1,0
2017-11-09 00:00:00.000000,Northern Ireland,Switzerland,0,1,FIFA World Cup qualification,Belfast,Northern Ireland,0,23,889,11,1134,12,-245,L,2,1,0
2017-11-09 00:00:00.000000,Romania,Turkey,2,0,Friendly,Cluj,Romania,0,45,705,33,807,12,-102,W,0,1,0
2017-11-09 00:00:00.000000,Scotland,Netherlands,0,1,Friendly,Aberdeen,Scotland,0,29,821,20,931,9,-110,L,2,1,0
2017-11-09 00:00:00.000000,Singapore,Lebanon,0,1,Friendly,Kallang,Singapore,0,173,100,100,352,73,-252,L,2,1,0
2017-11-10 00:00:00.000000,Algeria,Nigeria,3,0,FIFA World Cup qualification,Constantine,Algeria,0,67,540,41,721,26,-181,W,0,1,0
2017-11-10 00:00:00.000000,Belgium,Mexico,3,3,Friendly,Brussels,Belgium,0,5,1333,16,1060,-11,273,D,1,1,0
2017-11-10 00:00:00.000000,England,Germany,0,0,Friendly,London,England,0,12,1116,1,1631,11,-515,D,1,1,0
2017-11-10 00:00:00.000000,France,Wales,2,0,Friendly,Saint-Denis,France,0,7,1226,14,1072,-7,154,W,0,1,0
2017-11-10 00:00:00.000000,Georgia,Cyprus,1,0,Friendly,Gori,Georgia,0,107,306,86,409,21,-103,W,0,1,0
2017-11-10 00:00:00.000000,Honduras,Australia,0,0,FIFA World Cup qualification,San Pedro Sula,Honduras,0,69,510,43,714,26,-204,D,1,1,0
2017-11-10 00:00:00.000000,Japan,Brazil,1,3,Friendly,Villeneuve-d'Ascq,France,1,44,711,2,1619,42,-908,L,2,0,0
2017-11-10 00:00:00.000000,Korea DPR,Malaysia,4,1,AFC Asian Cup qualification,Buriram,Thailand,1,132,232,170,110,-38,122,W,0,0,0
2017-11-10 00:00:00.000000,Korea Republic,Colombia,2,1,Friendly,Suwon,Korea Republic,0,62,588,13,1095,49,-507,W,0,1,0
2017-11-10 00:00:00.000000,Poland,Uruguay,0,0,Friendly,Warsaw,Poland,0,6,1323,17,1034,-11,289,D,1,1,0
2017-11-10 00:00:00.000000,Portugal,Saudi Arabia,3,0,Friendly,Viseu,Portugal,0,3,1446,63,576,-60,870,W,0,1,0
2017-11-10 00:00:00.000000,South Africa,Senegal,0,2,FIFA World Cup qualification,Polokwane,South Africa,0,74,473,32,815,42,-342,L,2,1,0
2017-11-10 00:00:00.000000,Sweden,Italy,1,0,FIFA World Cup qualification,Solna,Sweden,0,25,872,15,1066,10,-194,W,0,1,0
2017-11-10 00:00:00.000000,Ukraine,Slovakia,2,1,Friendly,L'viv,Ukraine,0,30,818,24,885,6,-67,W,0,1,0
2017-11-11 00:00:00.000000,Comoros,Madagascar,1,1,Friendly,Saint-Leu-la-Forêt,France,1,127,237,103,332,24,-95,D,1,0,0
2017-11-11 00:00:00.000000,Congo DR,Guinea,3,1,FIFA World Cup qualification,Kinshasa,Congo DR,0,35,751,66,552,-31,199,W,0,1,0
2017-11-11 00:00:00.000000,Dominican Republic,Nicaragua,1,0,Friendly,San Cristóbal,Dominican Republic,0,163,121,108,303,55,-182,W,0,1,0
2017-11-11 00:00:00.000000,Gabon,Mali,0,0,FIFA World Cup qualification,Franceville,Gabon,0,92,384,72,488,20,-104,D,1,1,0
2017-11-11 00:00:00.000000,Malawi,Lesotho,1,1,Friendly,Lilongwe,Malawi,0,117,271,146,189,-29,82,D,1,1,0
2017-11-11 00:00:00.000000,Namibia,Zimbabwe,3,1,Friendly,Windhoek,Namibia,0,129,233,104,329,25,-96,W,0,1,0
2017-11-11 00:00:00.000000,New Zealand,Peru,0,0,FIFA World Cup qualification,Wellington,New Zealand,0,122,256,10,1160,112,-904,D,1,1,0
2017-11-11 00:00:00.000000,Qatar,Czech Republic,0,1,Friendly,Doha,Qatar,0,97,360,46,699,51,-339,L,2,1,0
2017-11-11 00:00:00.000000,Russia,Argentina,0,1,Friendly,Moscow,Russia,0,65,563,4,1445,61,-882,L,2,1,0
2017-11-11 00:00:00.000000,Spain,Costa Rica,5,0,Friendly,Málaga,Spain,0,8,1218,22,914,-14,304,W,0,1,0
2017-11-11 00:00:00.000000,Trinidad and Tobago,Grenada,2,2,Friendly,Couva,Trinidad and Tobago,0,83,419,157,141,-74,278,D,1,1,0
2017-11-11 00:00:00.000000,Tunisia,Libya,0,0,FIFA World Cup qualification,Radès,Tunisia,0,28,834,87,407,-59,427,D,1,1,0
2017-11-11 00:00:00.000000,Zambia,Cameroon,2,2,FIFA World Cup qualification,Ndola,Zambia,0,77,450,42,718,35,-268,D,1,1,0
2017-11-12 00:00:00.000000,Benin,Tanzania,1,1,Friendly,Cotonou,Benin,0,79,438,136,227,-57,211,D,1,1,0
2017-11-12 00:00:00.000000,Congo,Uganda,1,1,FIFA World Cup qualification,Brazzaville,Congo,0,94,367,70,503,24,-136,D,1,1,0
2017-11-12 00:00:00.000000,Ghana,Egypt,1,1,FIFA World Cup qualification,Kumasi,Ghana,0,52,651,30,818,22,-167,D,1,1,0
2017-11-12 00:00:00.000000,Greece,Croatia,0,0,FIFA World Cup qualification,Piraeus,Greece,0,47,682,18,1013,29,-331,D,1,1,0
2017-11-12 00:00:00.000000,Malta,Estonia,0,3,Friendly,Attard,Malta,0,182,69,80,429,102,-360,L,2,1,0
2017-11-12 00:00:00.000000,Switzerland,Northern Ireland,0,0,FIFA World Cup qualification,Basel,Switzerland,0,11,1134,23,889,-12,245,D,1,1,0
2017-11-12 00:00:00.000000,Togo,Mauritius,6,0,Friendly,Lomé,Togo,0,124,253,158,137,-34,116,W,0,1,0
2017-11-13 00:00:00.000000,Armenia,Cyprus,3,2,Friendly,Yerevan,Armenia,0,90,392,86,409,4,-17,W,0,1,0
2017-11-13 00:00:00.000000,Bulgaria,Saudi Arabia,1,0,Friendly,Lisbon,Portugal,1,36,750,63,576,-27,174,W,0,0,0
2017-11-13 00:00:00.000000,Georgia,Belarus,2,2,Friendly,Kutaisi,Georgia,0,107,306,91,391,16,-85,D,1,1,0
2017-11-13 00:00:00.000000,Iran,Venezuela,1,0,Friendly,Arnhem,Netherlands,1,34,784,51,663,-17,121,W,0,0,0
2017-11-13 00:00:00.000000,Iraq,Syria,1,1,Friendly,Karbala,Iraq,0,80,429,77,450,3,-21,D,1,1,0
2017-11-13 00:00:00.000000,Italy,Sweden,0,0,FIFA World Cup qualification,Milan,Italy,0,15,1066,25,872,-10,194,D,1,1,0
2017-11-13 00:00:00.000000,Kosovo,Latvia,4,3,Friendly,Mitrovica,Kosovo,0,183,67,129,233,54,-166,W,0,1,0
2017-11-13 00:00:00.000000,Malaysia,Korea DPR,1,4,AFC Asian Cup qualification,Buriram,Thailand,1,170,110,132,232,38,-122,L,2,0,0
2017-11-13 00:00:00.000000,Poland,Mexico,0,1,Friendly,Gdańsk,Poland,0,6,1323,16,1060,-10,263,L,2,1,0
2017-11-13 00:00:00.000000,Turkey,Albania,2,3,Friendly,Antalya,Turkey,0,33,807,71,498,-38,309,L,2,1,0
2017-11-14 00:00:00.000000,Algeria,Central African Republic,3,0,Friendly,Algiers,Algeria,0,67,540,119,266,-52,274,W,0,1,0
2017-11-14 00:00:00.000000,Argentina,Nigeria,2,4,Friendly,Krasnodar,Russia,1,4,1445,41,721,-37,724,L,2,0,0
2017-11-14 00:00:00.000000,Austria,Uruguay,2,1,Friendly,Vienna,Austria,0,39,745,17,1034,22,-289,W,0,1,0
2017-11-14 00:00:00.000000,Belgium,Japan,1,0,Friendly,Bruges,Belgium,0,5,1333,44,711,-39,622,W,0,1,0
2017-11-14 00:00:00.000000,Bhutan,Oman,2,4,AFC Asian Cup qualification,Thimphu,Bhutan,0,190,50,110,300,80,-250,L,2,1,0
2017-11-14 00:00:00.000000,Cambodia,Jordan,0,1,AFC Asian Cup qualification,Phnom Penh,Cambodia,0,170,110,113,281,57,-171,L,2,1,0
2017-11-14 00:00:00.000000,England,Brazil,0,0,Friendly,London,England,0,12,1116,2,1619,10,-503,D,1,1,0
2017-11-14 00:00:00.000000,Gabon,Botswana,0,0,Friendly,Franceville,Gabon,0,92,384,147,185,-55,199,D,1,1,0
2017-11-14 00:00:00.000000,Germany,France,2,2,Friendly,Cologne,Germany,0,1,1631,7,1226,-6,405,D,1,1,0
2017-11-14 00:00:00.000000,Hong Kong,Lebanon,0,1,AFC Asian Cup qualification,So Kon Po,Hong Kong,0,142,211,100,352,42,-141,L,2,1,0
2017-11-14 00:00:00.000000,Hungary,Costa Rica,1,0,Friendly,Budapest,Hungary,0,53,642,22,914,31,-272,W,0,1,0
2017-11-14 00:00:00.000000,Korea Republic,Serbia,1,1,Friendly,Ulsan,Korea Republic,0,62,588,38,748,24,-160,D,1,1,0
2017-11-14 00:00:00.000000,Nepal,Philippines,0,0,AFC Asian Cup qualification,Lalitpur,Nepal,0,176,94,116,272,60,-178,D,1,1,0
2017-11-14 00:00:00.000000,Palestine,Maldives,8,1,AFC Asian Cup qualification,Jenin,Palestine,0,84,418,156,144,-72,274,W,0,1,0
2017-11-14 00:00:00.000000,Portugal,USA,1,1,Friendly,Leiria,Portugal,0,3,1446,27,843,-24,603,D,1,1,0
2017-11-14 00:00:00.000000,Qatar,Iceland,1,1,Friendly,Doha,Qatar,0,97,360,21,920,76,-560,D,1,1,0
2017-11-14 00:00:00.000000,Romania,Netherlands,0,3,Friendly,Bucharest,Romania,0,45,705,20,931,25,-226,L,2,1,0
2017-11-14 00:00:00.000000,Russia,Spain,3,3,Friendly,St. Petersburg,Russia,0,65,563,8,1218,57,-655,D,1,1,0
2017-11-14 00:00:00.000000,Senegal,South Africa,2,1,FIFA World Cup qualification,Dakar,Senegal,0,32,815,74,473,-42,342,W,0,1,0
2017-11-14 00:00:00.000000,Singapore,Bahrain,0,3,AFC Asian Cup qualification,Kallang,Singapore,0,173,100,125,251,48,-151,L,2,1,0
2017-11-14 00:00:00.000000,Slovakia,Norway,1,0,Friendly,Trnava,Slovakia,0,24,885,58,620,-34,265,W,0,1,0
2017-11-14 00:00:00.000000,Tajikistan,Yemen,0,0,AFC Asian Cup qualification,Hisor,Tajikistan,0,123,255,112,297,11,-42,D,1,1,0
2017-11-14 00:00:00.000000,Trinidad and Tobago,Guyana,1,1,Friendly,Couva,Trinidad and Tobago,0,83,419,165,117,-82,302,D,1,1,0
2017-11-14 00:00:00.000000,United Arab Emirates,Uzbekistan,1,0,Friendly,al-Ain,United Arab Emirates,0,72,488,76,470,-4,18,W,0,1,0
2017-11-14 00:00:00.000000,Vietnam,Afghanistan,0,0,AFC Asian Cup qualification,Hanoi,Vietnam,0,121,261,154,168,-33,93,D,1,1,0
2017-11-14 00:00:00.000000,Wales,Panama,1,1,Friendly,Cardiff,Wales,0,14,1072,49,670,-35,402,D,1,1,0
2017-11-15 00:00:00.000000,Australia,Honduras,3,1,FIFA World Cup qualification,Sydney,Australia,0,43,714,69,510,-26,204,W,0,1,0
2017-11-15 00:00:00.000000,Peru,New Zealand,2,0,FIFA World Cup qualification,Lima,Peru,0,10,1160,122,256,-112,904,W,0,1,0
2017-11-18 00:00:00.000000,Fiji,Estonia,0,2,Friendly,Suva,Fiji,0,175,95,80,429,95,-334,L,2,1,0
2017-11-25 00:00:00.000000,Indonesia,Guyana,2,1,Friendly,Cikarang,Indonesia,0,154,144,164,117,-10,27,W,0,1,0
2017-11-26 00:00:00.000000,New Caledonia,Estonia,1,1,Friendly,Nouméa,New Caledonia,0,156,139,84,407,72,-268,D,1,1,0
2017-12-01 00:00:00.000000,Laos,Philippines,1,3,Friendly,Taipei,Taiwan,1,184,62,118,280,66,-218,L,2,0,0
2017-12-02 00:00:00.000000,Tonga,Solomon Islands,0,8,Friendly,Port Vila,Vanuatu,1,206,0,148,179,58,-179,L,2,0,0
2017-12-03 00:00:00.000000,Kenya,Rwanda,2,0,CECAFA Cup,Kakamega,Kenya,0,111,300,120,269,-9,31,W,0,1,0
2017-12-03 00:00:00.000000,Libya,Tanzania,0,0,CECAFA Cup,Machakos,Kenya,1,77,442,142,193,-65,249,D,1,0,0
2017-12-03 00:00:00.000000,St. Kitts and Nevis,Grenada,1,0,Friendly,Basseterre,St. Kitts and Nevis,0,113,291,160,132,-47,159,W,0,1,0
2017-12-04 00:00:00.000000,Indonesia,Mongolia,3,2,Friendly,Banda Aceh,Indonesia,0,154,144,199,17,-45,127,W,0,1,0
2017-12-04 00:00:00.000000,Uganda,Burundi,0,0,CECAFA Cup,Kakamega,Kenya,1,74,471,138,216,-64,255,D,1,0,0
2017-12-05 00:00:00.000000,Kenya,Libya,0,0,CECAFA Cup,Machakos,Kenya,0,111,300,77,442,34,-142,D,1,1,0
2017-12-05 00:00:00.000000,South Sudan,Ethiopia,0,3,CECAFA Cup,Kakamega,Kenya,1,152,172,145,187,7,-15,L,2,0,0
2017-12-06 00:00:00.000000,Solomon Islands,Fiji,0,0,Friendly,Port Vila,Vanuatu,1,148,179,178,93,-30,86,D,1,0,0
2017-12-06 00:00:00.000000,Vanuatu,Tonga,5,0,Friendly,Port Vila,Vanuatu,0,185,55,206,0,-21,55,W,0,1,0
2017-12-07 00:00:00.000000,Burundi,Ethiopia,4,1,CECAFA Cup,Kakamega,Kenya,1,138,216,145,187,-7,29,W,0,0,0
2017-12-07 00:00:00.000000,Rwanda,Libya,0,0,CECAFA Cup,Machakos,Kenya,1,120,269,77,442,43,-173,D,1,0,0
2017-12-08 00:00:00.000000,Uganda,South Sudan,5,1,CECAFA Cup,Kakamega,Kenya,1,74,471,152,172,-78,299,W,0,0,0
2017-12-09 00:00:00.000000,Japan,Korea DPR,1,0,EAFF Championship,Chōfu,Japan,0,55,623,114,283,-59,340,W,0,1,0
2017-12-09 00:00:00.000000,Rwanda,Tanzania,2,1,CECAFA Cup,Machakos,Kenya,1,120,269,142,193,-22,76,W,0,0,0
2017-12-09 00:00:00.000000,Vanuatu,Fiji,1,1,Friendly,Port Vila,Vanuatu,0,185,55,178,93,7,-38,D,1,1,0
2017-12-10 00:00:00.000000,Ethiopia,Uganda,1,1,CECAFA Cup,Kakamega,Kenya,1,145,187,74,471,71,-284,D,1,0,0
2017-12-11 00:00:00.000000,Kenya,Tanzania,1,0,CECAFA Cup,Machakos,Kenya,0,111,300,142,193,-31,107,W,0,1,0
2017-12-11 00:00:00.000000,South Sudan,Burundi,0,0,CECAFA Cup,Kakamega,Kenya,1,152,172,138,216,14,-44,D,1,0,0
2017-12-12 00:00:00.000000,Fiji,Tonga,4,0,Friendly,Port Vila,Vanuatu,1,178,93,206,0,-28,93,W,0,0,0
2017-12-12 00:00:00.000000,Korea DPR,Korea Republic,0,1,EAFF Championship,Chōfu,Japan,1,114,283,59,563,55,-280,L,2,0,0
2017-12-14 00:00:00.000000,Kenya,Burundi,1,0,CECAFA Cup,Kisumu,Kenya,0,111,300,138,216,-27,84,W,0,1,0
2017-12-14 00:00:00.000000,Qatar,Liechtenstein,1,2,Friendly,Doha,Qatar,0,102,336,187,54,-85,282,L,2,1,0
2017-12-15 00:00:00.000000,Vanuatu,Solomon Islands,3,2,Friendly,Port Vila,Vanuatu,0,185,55,148,179,37,-124,W,0,1,0
2017-12-16 00:00:00.000000,Japan,Korea Republic,1,4,EAFF Championship,Chōfu,Japan,0,55,623,59,563,-4,60,L,2,1,0
2017-12-17 00:00:00.000000,Burundi,Uganda,1,2,CECAFA Cup,Machakos,Kenya,1,138,216,74,471,64,-255,L,2,0,0
2017-12-18 00:00:00.000000,Bahrain,Kuwait,0,0,Friendly,Riffa,Bahrain,0,115,282,188,52,-73,230,D,1,1,0
2017-12-22 00:00:00.000000,Kuwait,Saudi Arabia,1,2,Friendly,Kuwait City,Kuwait,0,189,52,63,543,126,-491,L,2,1,0
2017-12-22 00:00:00.000000,Oman,United Arab Emirates,0,1,Friendly,Kuwait City,Kuwait,1,101,351,73,476,28,-125,L,2,0,0
2017-12-23 00:00:00.000000,Bahrain,Iraq,1,1,Friendly,Kuwait City,Kuwait,1,115,282,79,438,36,-156,D,1,0,0
2017-12-23 00:00:00.000000,Qatar,Yemen,4,0,Friendly,Kuwait City,Kuwait,1,102,329,120,268,-18,61,W,0,0,0
2017-12-25 00:00:00.000000,Jordan,Libya,1,1,Friendly,Amman,Jordan,0,107,313,88,399,19,-86,D,1,1,0
2017-12-25 00:00:00.000000,Kuwait,Oman,0,1,Friendly,Kuwait City,Kuwait,0,189,52,101,351,88,-299,L,2,1,0
2017-12-25 00:00:00.000000,United Arab Emirates,Saudi Arabia,0,0,Friendly,Kuwait City,Kuwait,1,73,476,63,543,10,-67,D,1,0,0
2017-12-26 00:00:00.000000,Iraq,Qatar,2,1,Friendly,Kuwait City,Kuwait,1,79,438,102,329,-23,109,W,0,0,0
2017-12-26 00:00:00.000000,Yemen,Bahrain,0,1,Friendly,Kuwait City,Kuwait,1,120,268,115,282,5,-14,L,2,0,0
2017-12-28 00:00:00.000000,Kuwait,United Arab Emirates,0,0,Friendly,Kuwait City,Kuwait,0,189,52,73,476,116,-424,D,1,1,0
2017-12-28 00:00:00.000000,Saudi Arabia,Oman,0,2,Friendly,Kuwait City,Kuwait,1,63,543,101,351,-38,192,L,2,0,0
2017-12-29 00:00:00.000000,Iraq,Yemen,3,0,Friendly,Kuwait City,Kuwait,1,79,438,120,268,-41,170,W,0,0,0
2017-12-29 00:00:00.000000,Qatar,Bahrain,1,1,Friendly,Kuwait City,Kuwait,1,102,329,115,282,-13,47,D,1,0,0
2018-01-02 00:00:00.000000,Iraq,United Arab Emirates,0,0,Friendly,Kuwait City,Kuwait,1,79,438,73,476,6,-38,D,1,0,0
2018-01-02 00:00:00.000000,Oman,Bahrain,1,0,Friendly,Kuwait City,Kuwait,1,101,351,115,282,-14,69,W,0,0,0
2018-01-05 00:00:00.000000,Oman,United Arab Emirates,0,0,Friendly,Kuwait City,Kuwait,1,101,351,73,476,28,-125,D,1,0,0
2018-01-07 00:00:00.000000,Estonia,Sweden,1,1,Friendly,Abu Dhabi,United Arab Emirates,1,89,397,18,998,71,-601,D,1,0,0
2018-01-11 00:00:00.000000,Denmark,Sweden,0,1,Friendly,Abu Dhabi,United Arab Emirates,1,12,1099,18,998,-6,101,L,2,0,0
2018-01-11 00:00:00.000000,Indonesia,Iceland,0,6,Friendly,Sleman,Indonesia,0,162,121,22,910,140,-789,L,2,1,0
2018-01-11 00:00:00.000000,Jordan,Finland,1,2,Friendly,Abu Dhabi,United Arab Emirates,1,107,313,66,531,41,-218,L,2,0,0
2018-01-14 00:00:00.000000,Indonesia,Iceland,1,4,Friendly,Jakarta,Indonesia,0,162,121,22,910,140,-789,L,2,1,0
2018-01-27 00:00:00.000000,Moldova,Korea Republic,0,1,Friendly,Antalya,Turkey,1,166,112,59,569,107,-457,L,2,0,0
2018-01-30 00:00:00.000000,Azerbaijan,Moldova,0,0,Friendly,Antalya,Turkey,1,118,281,166,112,-48,169,D,1,0,0
2018-01-30 00:00:00.000000,Jamaica,Korea Republic,2,2,Friendly,Antalya,Turkey,1,55,625,59,569,-4,56,D,1,0,0
2018-02-03 00:00:00.000000,Latvia,Korea Republic,0,1,Friendly,Antalya,Turkey,1,131,233,59,569,72,-336,L,2,0,0
2018-02-26 00:00:00.000000,Saudi Arabia,Moldova,3,0,Friendly,Jeddah,Saudi Arabia,0,64,522,166,112,-102,410,W,0,1,0
2018-02-28 00:00:00.000000,Iraq,Saudi Arabia,4,1,Friendly,Basra,Iraq,0,85,406,64,522,21,-116,W,0,1,0
2018-03-17 00:00:00.000000,Iran,Sierra Leone,4,0,Friendly,Teheran,Iran,0,33,792,98,360,-65,432,W,0,1,0
2018-03-21 00:00:00.000000,Andorra,Liechtenstein,1,0,Friendly,La Línea de la Concepción,Spain,1,130,232,181,91,-51,141,W,0,0,0
2018-03-21 00:00:00.000000,Antigua and Barbuda,Bermuda,3,2,Friendly,St. John's,Antigua and Barbuda,0,139,212,184,78,-45,134,W,0,1,0
2018-03-21 00:00:00.000000,Iraq,Qatar,2,3,Friendly,Basra,Iraq,0,83,405,101,332,-18,73,L,2,1,0
2018-03-21 00:00:00.000000,Jordan,Kuwait,1,0,Friendly,Amman,Jordan,0,117,276,173,101,-56,175,W,0,1,0
2018-03-21 00:00:00.000000,Laos,Cambodia,0,1,Friendly,Vientiane,Laos,0,183,82,171,103,12,-21,L,2,1,0
2018-03-21 00:00:00.000000,Madagascar,Togo,0,0,Friendly,Saint-Leu-la-Forêt,France,1,109,309,128,241,-19,68,D,1,0,0
2018-03-21 00:00:00.000000,South Africa,Angola,1,1,Friendly,Ndola,Zambia,1,76,440,141,210,-65,230,D,1,0,0
2018-03-21 00:00:00.000000,Tahiti,New Caledonia,0,0,Friendly,Pirae,Tahiti,0,153,149,155,146,-2,3,D,1,1,0
2018-03-21 00:00:00.000000,Zambia,Zimbabwe,2,2,Friendly,Ndola,Zambia,0,77,438,108,312,-31,126,D,1,1,0
2018-03-22 00:00:00.000000,Algeria,Tanzania,4,1,Friendly,Algiers,Algeria,0,60,553,146,186,-86,367,W,0,1,0
2018-03-22 00:00:00.000000,Bahrain,Palestine,0,0,Friendly,Riffa,Bahrain,0,125,253,73,449,52,-196,D,1,1,0
2018-03-22 00:00:00.000000,Belize,Grenada,4,2,Friendly,Belmopan,Belize,0,177,96,159,126,18,-30,W,0,1,0
2018-03-22 00:00:00.000000,Burkina Faso,Guinea-Bissau,2,0,Friendly,Limeil-Brévannes,France,1,56,587,96,368,-40,219,W,0,0,0
2018-03-22 00:00:00.000000,Denmark,Panama,1,0,Friendly,Brøndby,Denmark,0,12,1108,53,605,-41,503,W,0,1,0
2018-03-22 00:00:00.000000,Dominican Republic,Turks and Caicos Islands,4,0,Friendly,Santo Domingo,Dominican Republic,0,163,121,201,13,-38,108,W,0,1,0
2018-03-22 00:00:00.000000,Faroe Islands,Latvia,1,1,Friendly,San Pedro de Alcántara,Spain,1,97,364,131,231,-34,133,D,1,0,0
2018-03-22 00:00:00.000000,Macau,Mauritius,0,1,Friendly,Macau,Macau,0,186,65,158,134,28,-69,L,2,1,0
2018-03-22 00:00:00.000000,Malaysia,Mongolia,2,2,Friendly,Kuala Lumpur,Malaysia,0,178,95,189,49,-11,46,D,1,1,0
2018-03-22 00:00:00.000000,Malta,Luxembourg,0,1,Friendly,Attard,Malta,0,185,68,83,405,102,-337,L,2,1,0
2018-03-22 00:00:00.000000,Nicaragua,Cuba,3,1,Friendly,Managua,Nicaragua,0,116,277,182,88,-66,189,W,0,1,0
2018-03-22 00:00:00.000000,Philippines,Fiji,3,2,Friendly,Manila,Philippines,0,122,265,168,110,-46,155,W,0,1,0
2018-03-22 00:00:00.000000,Slovakia,United Arab Emirates,2,1,Friendly,Bangkok,Thailand,1,29,822,79,430,-50,392,W,0,0,0
2018-03-22 00:00:00.000000,Thailand,Gabon,0,0,Friendly,Bangkok,Thailand,0,129,238,95,371,34,-133,D,1,1,0
2018-03-23 00:00:00.000000,Austria,Slovenia,3,0,Friendly,Klagenfurt,Austria,0,28,826,62,537,-34,289,W,0,1,0
2018-03-23 00:00:00.000000,Azerbaijan,Belarus,0,1,Friendly,Baku,Azerbaijan,0,127,243,93,376,34,-133,L,2,1,0
2018-03-23 00:00:00.000000,Curaçao,Bolivia,1,1,Friendly,Willemstad,Curaçao,0,82,407,47,674,35,-267,D,1,1,0
2018-03-23 00:00:00.000000,Cyprus,Montenegro,0,0,Friendly,Nicosia,Cyprus,0,92,378,46,675,46,-297,D,1,1,0
2018-03-23 00:00:00.000000,France,Colombia,2,3,Friendly,Saint-Denis,France,0,9,1185,13,1106,-4,79,L,2,1,0
2018-03-23 00:00:00.000000,Gambia,Central African Republic,1,1,Friendly,Bakau,Gambia,0,164,120,121,266,43,-146,D,1,1,0
2018-03-23 00:00:00.000000,Germany,Spain,1,1,Friendly,Düsseldorf,Germany,0,1,1609,6,1228,-5,381,D,1,1,0
2018-03-23 00:00:00.000000,Greece,Switzerland,0,1,Friendly,Athens,Greece,0,45,685,8,1197,37,-512,L,2,1,0
2018-03-23 00:00:00.000000,Hungary,Kazakhstan,2,3,Friendly,Budapest,Hungary,0,50,637,136,223,-86,414,L,2,1,0
2018-03-23 00:00:00.000000,Italy,Argentina,0,2,Friendly,Manchester,England,1,14,1062,4,1359,10,-297,L,2,0,0
2018-03-23 00:00:00.000000,Japan,Mali,1,1,Friendly,Liège,Belgium,1,55,593,67,506,-12,87,D,1,0,0
2018-03-23 00:00:00.000000,Mexico,Iceland,3,0,Friendly,Santa Clara,USA,1,17,1038,18,1026,-1,12,W,0,0,0
2018-03-23 00:00:00.000000,Netherlands,England,0,1,Friendly,Amsterdam,Netherlands,0,21,964,16,1047,5,-83,L,2,1,0
2018-03-23 00:00:00.000000,Norway,Australia,4,1,Friendly,Oslo,Norway,0,57,578,37,740,20,-162,W,0,1,0
2018-03-23 00:00:00.000000,Peru,Croatia,2,0,Friendly,Miami Gardens,USA,1,11,1128,15,1053,-4,75,W,0,0,0
2018-03-23 00:00:00.000000,Poland,Nigeria,0,1,Friendly,Wrocław,Poland,0,6,1228,52,609,-46,619,L,2,1,0
2018-03-23 00:00:00.000000,Portugal,Egypt,2,1,Friendly,Zürich,Switzerland,1,3,1360,44,687,-41,673,W,0,0,0
2018-03-23 00:00:00.000000,Russia,Brazil,0,3,Friendly,Moscow,Russia,0,63,531,2,1489,61,-958,L,2,1,0
2018-03-23 00:00:00.000000,Scotland,Costa Rica,0,1,Friendly,Glasgow,Scotland,0,32,797,26,872,6,-75,L,2,1,0
2018-03-23 00:00:00.000000,Senegal,Uzbekistan,1,1,Friendly,Casablanca,Morocco,1,27,862,72,451,-45,411,D,1,0,0
2018-03-23 00:00:00.000000,Serbia,Morocco,1,2,Friendly,Turin,Italy,1,34,780,42,694,-8,86,L,2,0,0
2018-03-23 00:00:00.000000,Singapore,Maldives,3,2,Friendly,Kallang,Singapore,0,171,103,150,161,21,-58,W,0,1,0
2018-03-23 00:00:00.000000,Tunisia,Iran,1,0,Friendly,Radès,Tunisia,0,23,920,33,792,-10,128,W,0,1,0
2018-03-23 00:00:00.000000,Ukraine,Saudi Arabia,1,1,Friendly,Marbella,Spain,1,35,778,69,494,-34,284,D,1,0,0
2018-03-23 00:00:00.000000,Uruguay,Czech Republic,2,0,Friendly,Nanning,China,1,22,931,43,690,-21,241,W,0,0,0
2018-03-24 00:00:00.000000,Angola,Zimbabwe,2,2,Friendly,Ndola,Zambia,1,141,210,108,312,33,-102,D,1,0,0
2018-03-24 00:00:00.000000,Armenia,Estonia,0,0,Friendly,Yerevan,Armenia,0,91,385,86,399,5,-14,D,1,1,0
2018-03-24 00:00:00.000000,Botswana,Lesotho,1,0,Friendly,Gaborone,Botswana,0,149,173,144,193,5,-20,W,0,1,0
2018-03-24 00:00:00.000000,Canada,New Zealand,1,0,Friendly,San Pedro del Pinatar,Spain,1,90,388,120,267,-30,121,W,0,0,0
2018-03-24 00:00:00.000000,Comoros,Kenya,2,2,Friendly,Marrakech,Morocco,1,132,230,105,317,27,-87,D,1,0,0
2018-03-24 00:00:00.000000,Georgia,Lithuania,4,0,Friendly,Tbilisi,Georgia,0,101,332,147,182,-46,150,W,0,1,0
2018-03-24 00:00:00.000000,Israel,Romania,1,2,Friendly,Netanya,Israel,0,94,375,36,749,58,-374,L,2,1,0
2018-03-24 00:00:00.000000,Kosovo,Madagascar,1,0,Friendly,Franconville,France,1,176,97,109,309,67,-212,W,0,0,0
2018-03-24 00:00:00.000000,Mauritania,Guinea,2,0,Friendly,Nouakchott,Mauritania,0,104,322,70,484,34,-162,W,0,1,0
2018-03-24 00:00:00.000000,Northern Ireland,Korea Republic,2,1,Friendly,Belfast,Northern Ireland,0,24,879,59,554,-35,325,W,0,1,0
2018-03-24 00:00:00.000000,Qatar,Syria,2,2,Friendly,Basra,Iraq,1,101,332,74,442,27,-110,D,1,0,0
2018-03-24 00:00:00.000000,Sweden,Chile,1,2,Friendly,Solna,Sweden,0,19,1002,10,1161,9,-159,L,2,1,0
2018-03-24 00:00:00.000000,Tahiti,New Caledonia,4,3,Friendly,Pirae,Tahiti,0,153,149,155,146,-2,3,W,0,1,0
2018-03-24 00:00:00.000000,Zambia,South Africa,0,2,Friendly,Ndola,Zambia,0,77,438,76,440,1,-2,L,2,1,0
2018-03-25 00:00:00.000000,Barbados,Bermuda,0,0,Friendly,Bridgetown,Barbados,0,152,151,184,78,-32,73,D,1,1,0
2018-03-25 00:00:00.000000,Dominican Republic,St. Kitts and Nevis,2,1,Friendly,Santiago,Dominican Republic,0,163,121,107,316,56,-195,W,0,1,0
2018-03-25 00:00:00.000000,Faroe Islands,Liechtenstein,3,0,Friendly,Marbella,Spain,1,97,364,181,91,-84,273,W,0,0,0
2018-03-25 00:00:00.000000,Gibraltar,Latvia,1,0,Friendly,Gibraltar,Gibraltar,0,206,0,131,231,75,-231,W,0,1,0
2018-03-25 00:00:00.000000,Jamaica,Antigua and Barbuda,1,1,Friendly,Kingston,Jamaica,0,49,643,139,212,-90,431,D,1,1,0
2018-03-25 00:00:00.000000,Kuwait,Cameroon,1,3,Friendly,Kuwait City,Kuwait,0,173,101,51,611,122,-510,L,2,1,0
2018-03-25 00:00:00.000000,Nicaragua,Cuba,3,3,Friendly,Managua,Nicaragua,0,116,277,182,88,-66,189,D,1,1,0
2018-03-25 00:00:00.000000,Thailand,Slovakia,2,3,Friendly,Bangkok,Thailand,0,129,238,29,822,100,-584,L,2,1,0
2018-03-26 00:00:00.000000,Albania,Norway,0,1,Friendly,Elbasan,Albania,0,58,557,57,578,1,-21,L,2,1,0
2018-03-26 00:00:00.000000,Bulgaria,Kazakhstan,2,1,Friendly,Felcsút,Hungary,1,40,715,136,223,-96,492,W,0,0,0
2018-03-26 00:00:00.000000,Curaçao,Bolivia,1,0,Friendly,Willemstad,Curaçao,0,82,407,47,674,35,-267,W,0,1,0
2018-03-26 00:00:00.000000,Finland,Malta,5,0,Friendly,Belek,Turkey,1,68,503,185,68,-117,435,W,0,0,0
2018-03-26 00:00:00.000000,Portugal,Netherlands,0,3,Friendly,Geneva,Switzerland,1,3,1360,21,964,-18,396,L,2,0,0
2018-03-26 00:00:00.000000,Wales,Uruguay,0,1,Friendly,Nanning,China,1,20,984,22,931,-2,53,L,2,0,0
2018-03-27 00:00:00.000000,Afghanistan,Cambodia,2,1,AFC Asian Cup qualification,Dushanbe,Tajikistan,1,148,176,171,103,-23,73,W,0,0,0
2018-03-27 00:00:00.000000,Algeria,Iran,1,2,Friendly,Graz,Austria,1,60,553,33,792,27,-239,L,2,0,0
2018-03-27 00:00:00.000000,Armenia,Lithuania,0,1,Friendly,Yerevan,Armenia,0,91,385,147,182,-56,203,L,2,1,0
2018-03-27 00:00:00.000000,Australia,Colombia,0,0,Friendly,London,England,1,37,740,13,1106,24,-366,D,1,0,0
2018-03-27 00:00:00.000000,Bahrain,Turkmenistan,4,0,AFC Asian Cup qualification,Riffa,Bahrain,0,125,253,114,292,11,-39,W,0,1,0
2018-03-27 00:00:00.000000,Belgium,Saudi Arabia,4,0,Friendly,Brussels,Belgium,0,5,1337,69,494,-64,843,W,0,1,0
2018-03-27 00:00:00.000000,Central African Republic,Kenya,3,2,Friendly,Marrakech,Morocco,1,121,266,105,317,16,-51,W,0,0,0
2018-03-27 00:00:00.000000,Denmark,Chile,0,0,Friendly,Aalborg,Denmark,0,12,1108,10,1161,2,-53,D,1,1,0
2018-03-27 00:00:00.000000,England,Italy,1,1,Friendly,London,England,0,16,1047,14,1062,2,-15,D,1,1,0
2018-03-27 00:00:00.000000,Georgia,Estonia,2,0,Friendly,Tbilisi,Georgia,0,101,332,86,399,15,-67,W,0,1,0
2018-03-27 00:00:00.000000,Germany,Brazil,0,1,Friendly,Berlin,Germany,0,1,1609,2,1489,-1,120,L,2,1,0
2018-03-27 00:00:00.000000,Greece,Egypt,1,0,Friendly,Zürich,Switzerland,1,45,685,44,687,1,-2,W,0,0,0
2018-03-27 00:00:00.000000,Hungary,Scotland,0,1,Friendly,Budapest,Hungary,0,50,637,32,797,18,-160,L,2,1,0
2018-03-27 00:00:00.000000,Iraq,Syria,1,1,Friendly,Basra,Iraq,0,83,405,74,442,9,-37,D,1,1,0
2018-03-27 00:00:00.000000,Jordan,Vietnam,1,1,AFC Asian Cup qualification,Amman,Jordan,0,117,276,113,293,4,-17,D,1,1,0
2018-03-27 00:00:00.000000,Korea DPR,Hong Kong,2,0,AFC Asian Cup qualification,P'yŏngyang,Korea DPR,0,119,270,145,190,-26,80,W,0,1,0
2018-03-27 00:00:00.000000,Kosovo,Burkina Faso,2,0,Friendly,Franconville,France,1,176,97,56,587,120,-490,W,0,0,0
2018-03-27 00:00:00.000000,Laos,Bangladesh,2,2,Friendly,Vientiane,Laos,0,183,82,197,31,-14,51,D,1,1,0
2018-03-27 00:00:00.000000,Lebanon,Malaysia,2,1,AFC Asian Cup qualification,Beirut,Lebanon,0,87,390,178,95,-91,295,W,0,1,0
2018-03-27 00:00:00.000000,Luxembourg,Austria,0,4,Friendly,Luxembourg,Luxembourg,0,83,405,28,826,55,-421,L,2,1,0
2018-03-27 00:00:00.000000,Maldives,Bhutan,7,0,AFC Asian Cup qualification,Malé,Maldives,0,150,161,188,63,-38,98,W,0,1,0
2018-03-27 00:00:00.000000,Mexico,Croatia,0,1,Friendly,Arlington,USA,1,17,1038,15,1053,2,-15,L,2,0,0
2018-03-27 00:00:00.000000,Mongolia,Mauritius,0,2,Friendly,Ulan Bator,Mongolia,0,189,49,158,134,31,-85,L,2,1,0
2018-03-27 00:00:00.000000,Montenegro,Turkey,2,2,Friendly,Podgorica,Montenegro,0,46,675,38,730,8,-55,D,1,1,0
2018-03-27 00:00:00.000000,Morocco,Uzbekistan,2,0,Friendly,Casablanca,Morocco,0,42,694,72,451,-30,243,W,0,1,0
2018-03-27 00:00:00.000000,Namibia,Lesotho,2,1,Friendly,Windhoek,Namibia,0,111,302,144,193,-33,109,W,0,1,0
2018-03-27 00:00:00.000000,Oman,Palestine,1,0,AFC Asian Cup qualification,Muscat,Oman,0,103,331,73,449,30,-118,W,0,1,0
2018-03-27 00:00:00.000000,Peru,Iceland,3,1,Friendly,Harrison,USA,1,11,1128,18,1026,-7,102,W,0,0,0
2018-03-27 00:00:00.000000,Philippines,Tajikistan,2,1,AFC Asian Cup qualification,Manila,Philippines,0,122,265,124,255,-2,10,W,0,1,0
2018-03-27 00:00:00.000000,Poland,Korea Republic,3,2,Friendly,Chorzów,Poland,0,6,1228,59,554,-53,674,W,0,1,0
2018-03-27 00:00:00.000000,Romania,Sweden,1,0,Friendly,Craiova,Romania,0,36,749,19,1002,17,-253,W,0,1,0
2018-03-27 00:00:00.000000,Russia,France,1,3,Friendly,St. Petersburg,Russia,0,63,531,9,1185,54,-654,L,2,1,0
2018-03-27 00:00:00.000000,Serbia,Nigeria,2,0,Friendly,London,England,1,34,780,52,609,-18,171,W,0,0,0
2018-03-27 00:00:00.000000,Seychelles,Swaziland,0,0,Friendly,Victoria,Seychelles,0,191,43,133,227,58,-184,D,1,1,0
2018-03-27 00:00:00.000000,Slovenia,Belarus,0,2,Friendly,Ljubljana,Slovenia,0,62,537,93,376,-31,161,L,2,1,0
2018-03-27 00:00:00.000000,Spain,Argentina,6,1,Friendly,Madrid,Spain,0,6,1228,4,1359,2,-131,W,0,1,0
2018-03-27 00:00:00.000000,Switzerland,Panama,6,0,Friendly,Lucerne,Switzerland,0,8,1197,53,605,-45,592,W,0,1,0
2018-03-27 00:00:00.000000,Tanzania,Congo DR,2,0,Friendly,Dar es Salaam,Tanzania,0,146,186,39,728,107,-542,W,0,1,0
2018-03-27 00:00:00.000000,Tunisia,Costa Rica,1,0,Friendly,Nice,France,1,23,920,26,872,-3,48,W,0,0,0
2018-03-27 00:00:00.000000,Uganda,Malawi,0,0,Friendly,Kampala,Uganda,0,78,435,123,264,-45,171,D,1,1,0
2018-03-27 00:00:00.000000,Ukraine,Japan,2,1,Friendly,Liège,Belgium,1,35,778,55,593,-20,185,W,0,0,0
2018-03-27 00:00:00.000000,USA,Paraguay,1,0,Friendly,Cary,USA,0,25,876,30,816,-5,60,W,0,1,0
2018-03-27 00:00:00.000000,Yemen,Nepal,2,1,AFC Asian Cup qualification,Doha,Qatar,1,140,211,165,116,-25,95,W,0,0,0
2018-04-01 00:00:00.000000,Malaysia,Bhutan,7,0,Friendly,Kuala Lumpur,Malaysia,0,178,95,188,63,-10,32,W,0,1,0
2018-04-18 00:00:00.000000,Trinidad and Tobago,Panama,0,1,Friendly,Couva,Trinidad and Tobago,0,92,374,55,575,37,-201,L,2,1,0
2018-04-18 00:00:00.000000,Zimbabwe,Botswana,0,1,Friendly,Harare,Zimbabwe,0,110,295,148,176,-38,119,L,2,1,0
2018-04-26 00:00:00.000000,St. Kitts and Nevis,Jamaica,1,3,Friendly,Basseterre,St. Kitts and Nevis,0,126,245,48,612,78,-367,L,2,1,0
2018-04-30 00:00:00.000000,Antigua and Barbuda,Jamaica,0,2,Friendly,St. John's,Antigua and Barbuda,0,124,251,48,612,76,-361,L,2,1,0
2018-05-08 00:00:00.000000,Iraq,Palestine,0,0,Friendly,Basra,Iraq,0,88,381,83,401,5,-20,D,1,1,0
2018-05-09 00:00:00.000000,Algeria,Saudi Arabia,0,2,Friendly,Cádiz,Spain,1,62,516,70,445,-8,71,L,2,0,0
2018-05-11 00:00:00.000000,Kuwait,Palestine,2,0,Friendly,Kuwait City,Kuwait,0,176,88,83,401,93,-313,W,0,1,0
2018-05-15 00:00:00.000000,Saudi Arabia,Greece,2,0,Friendly,Seville,Spain,1,70,445,44,657,26,-212,W,0,0,0
2018-05-20 00:00:00.000000,Jordan,Cyprus,3,0,Friendly,Amman,Jordan,0,118,272,86,386,32,-114,W,0,1,0
2018-05-25 00:00:00.000000,Kuwait,Egypt,1,1,Friendly,Kuwait,Kuwait,0,160,126,46,636,114,-510,D,1,1,0
2018-05-25 00:00:00.000000,Kenya,Swaziland,0,1,Friendly,Machakos,Kenya,0,111,289,131,240,-20,49,L,2,1,0
2018-05-27 00:00:00.000000,Cameroon,Burkina Faso,0,1,Friendly,Beauvais,France,1,50,603,54,582,-4,21,L,2,0,0
2018-05-27 00:00:00.000000,Niger,Central African Republic,3,3,Friendly,Niamey,Niger,0,109,299,115,283,-6,16,D,1,1,0
2018-05-27 00:00:00.000000,Madagascar,Mozambique,2,1,COSAFA Cup,Polokwane,South Africa,1,114,284,106,311,8,-27,W,0,0,0
2018-05-27 00:00:00.000000,Comoros,Seychelles,1,1,COSAFA Cup,Polokwane,South Africa,1,142,195,194,37,-52,158,D,1,0,0
2018-05-28 00:00:00.000000,USA,Bolivia,3,0,Friendly,Chester,USA,0,24,880,57,548,-33,332,W,0,1,0
2018-05-28 00:00:00.000000,Nigeria,Congo DR,1,1,Friendly,Port Harcourt,Nigeria,0,47,635,38,711,9,-76,D,1,1,0
2018-05-28 00:00:00.000000,Kenya,Equatorial Guinea,1,0,Friendly,Machakos,Kenya,0,111,289,145,190,-34,99,W,0,1,0
2018-05-28 00:00:00.000000,Portugal,Tunisia,2,2,Friendly,Braga,Portugal,0,4,1306,14,1012,-10,294,D,1,1,0
2018-05-28 00:00:00.000000,Italy,Saudi Arabia,2,1,Friendly,St. Gallen,Switzerland,1,20,947,67,462,-47,485,W,0,0,0
2018-05-28 00:00:00.000000,Mexico,Wales,0,0,Friendly,Pasadena,USA,1,15,1008,21,931,-6,77,D,1,0,0
2018-05-28 00:00:00.000000,Korea Republic,Honduras,2,0,Friendly,Daegu,Korea Republic,0,61,520,59,530,2,-10,W,0,1,0
2018-05-28 00:00:00.000000,Malawi,Mauritius,0,1,COSAFA Cup,Polokwane,South Africa,1,119,269,161,124,-42,145,L,2,0,0
2018-05-28 00:00:00.000000,Angola,Botswana,1,2,COSAFA Cup,Polokwane,South Africa,1,138,221,142,195,-4,26,L,2,0,0
2018-05-29 00:00:00.000000,Argentina,Haiti,4,0,Friendly,Buenos Aires,Argentina,0,5,1254,108,302,-103,952,W,0,1,0
2018-05-29 00:00:00.000000,Albania,Kosovo,0,3,Friendly,Zürich,Switzerland,1,56,549,152,164,-96,385,L,2,0,0
2018-05-29 00:00:00.000000,Armenia,Malta,1,1,Friendly,Wattens,Austria,1,98,347,185,62,-87,285,D,1,0,0
2018-05-29 00:00:00.000000,Peru,Scotland,2,0,Friendly,Lima,Peru,0,11,1106,34,735,-23,371,W,0,1,0
2018-05-29 00:00:00.000000,Panama,Northern Ireland,0,0,Friendly,Panama City,Panama,0,55,574,27,837,28,-263,D,1,1,0
2018-05-29 00:00:00.000000,Madagascar,Seychelles,1,1,COSAFA Cup,Polokwane,South Africa,1,114,284,194,37,-80,247,D,1,0,0
2018-05-29 00:00:00.000000,Comoros,Mozambique,0,3,COSAFA Cup,Polokwane,South Africa,1,142,195,106,311,36,-116,L,2,0,0
2018-05-30 00:00:00.000000,Japan,Ghana,0,2,Friendly,Yokohama,Japan,0,60,528,50,603,10,-75,L,2,1,0
2018-05-30 00:00:00.000000,Central African Republic,Uganda,1,0,Friendly,Niamey,Niger,1,115,283,74,426,41,-143,W,0,0,0
2018-05-30 00:00:00.000000,Austria,Russia,1,0,Friendly,Innsbruck,Austria,0,26,841,66,493,-40,348,W,0,1,0
2018-05-30 00:00:00.000000,Malawi,Botswana,1,1,COSAFA Cup,Polokwane,South Africa,1,119,269,142,195,-23,74,D,1,0,0
2018-05-30 00:00:00.000000,Angola,Mauritius,1,0,COSAFA Cup,Polokwane,South Africa,1,138,221,161,124,-23,97,W,0,0,0
2018-05-30 00:00:00.000000,Estonia,Lithuania,2,0,Baltic Cup,Rakvere,Estonia,0,93,364,133,229,-40,135,W,0,1,0
2018-05-31 00:00:00.000000,Ukraine,Morocco,0,0,Friendly,Geneva,Switzerland,1,30,777,42,681,-12,96,D,1,0,0
2018-05-31 00:00:00.000000,Romania,Chile,3,2,Friendly,Graz,Austria,1,32,737,9,1146,23,-409,W,0,0,0
2018-05-31 00:00:00.000000,Luxembourg,Senegal,0,0,Friendly,Luxembourg,Luxembourg,0,83,401,28,825,55,-424,D,1,1,0
2018-05-31 00:00:00.000000,Mozambique,Seychelles,2,1,COSAFA Cup,Polokwane,South Africa,1,106,311,194,37,-88,274,W,0,0,0
2018-05-31 00:00:00.000000,Comoros,Madagascar,0,1,COSAFA Cup,Polokwane,South Africa,1,142,195,114,284,28,-89,L,2,0,0
2018-05-31 00:00:00.000000,Slovakia,Netherlands,1,1,Friendly,Trnava,Slovakia,0,29,786,19,969,10,-183,D,1,1,0
2018-06-01 00:00:00.000000,France,Italy,3,1,Friendly,Nice,France,0,7,1166,20,947,-13,219,W,0,1,0
2018-06-01 00:00:00.000000,Turkey,Tunisia,2,2,Friendly,Geneva,Switzerland,1,37,714,14,1012,23,-298,D,1,0,0
2018-06-01 00:00:00.000000,Czech Republic,Australia,0,4,Friendly,Sankt Pölten,Austria,1,45,647,40,700,5,-53,L,2,0,0
2018-06-01 00:00:00.000000,Colombia,Egypt,0,0,Friendly,Bergamo,Italy,1,16,989,46,636,-30,353,D,1,0,0
2018-06-01 00:00:00.000000,Malta,Georgia,0,1,Friendly,Schwaz,Austria,1,185,62,95,362,90,-300,L,2,0,0
2018-06-01 00:00:00.000000,Botswana,Mauritius,6,0,COSAFA Cup,Polokwane,South Africa,1,142,195,161,124,-19,71,W,0,0,0
2018-06-01 00:00:00.000000,Angola,Malawi,0,0,COSAFA Cup,Polokwane,South Africa,1,138,221,119,269,19,-48,D,1,0,0
2018-06-02 00:00:00.000000,El Salvador,Honduras,1,0,Friendly,Houston,USA,1,85,392,59,530,26,-138,W,0,0,0
2018-06-02 00:00:00.000000,England,Nigeria,2,1,Friendly,London,England,0,13,1040,47,635,-34,405,W,0,1,0
2018-06-02 00:00:00.000000,Montenegro,Slovenia,0,2,Friendly,Podgorica,Montenegro,0,43,671,65,495,-22,176,L,2,1,0
2018-06-02 00:00:00.000000,Mexico,Scotland,1,0,Friendly,Mexico City,Mexico,0,15,1008,34,735,-19,273,W,0,1,0
2018-06-02 00:00:00.000000,Sweden,Denmark,0,0,Friendly,Solna,Sweden,0,23,889,12,1054,11,-165,D,1,1,0
2018-06-02 00:00:00.000000,Belgium,Portugal,0,0,Friendly,Brussels,Belgium,0,3,1346,4,1306,-1,40,D,1,1,0
2018-06-02 00:00:00.000000,Austria,Germany,2,1,Friendly,Klagenfurt,Austria,0,26,841,1,1544,25,-703,W,0,1,0
2018-06-02 00:00:00.000000,Niger,Uganda,2,1,Friendly,Niamey,Niger,0,109,299,74,426,35,-127,W,0,1,0
2018-06-02 00:00:00.000000,Iceland,Norway,2,3,Friendly,Reykjavík,Iceland,0,22,930,48,608,-26,322,L,2,1,0
2018-06-02 00:00:00.000000,Zambia,Namibia,0,0,COSAFA Cup,Polokwane,South Africa,1,78,412,107,308,-29,104,D,1,0,0
2018-06-02 00:00:00.000000,Lesotho,Swaziland,1,0,COSAFA Cup,Polokwane,South Africa,1,150,172,131,240,19,-68,W,0,0,0
2018-06-02 00:00:00.000000,Latvia,Estonia,1,0,Baltic Cup,Riga,Latvia,0,139,217,93,364,46,-147,W,0,1,0
2018-06-02 00:00:00.000000,Kenya,New Zealand,2,1,Friendly,Mumbai,India,1,111,289,133,229,-22,60,W,0,0,0
2018-06-03 00:00:00.000000,Albania,Ukraine,1,4,Friendly,Évian-les-Bains,France,1,56,549,30,777,26,-228,L,2,0,0
2018-06-03 00:00:00.000000,Saudi Arabia,Peru,0,3,Friendly,St. Gallen,Switzerland,1,67,462,11,1106,56,-644,L,2,0,0
2018-06-03 00:00:00.000000,Spain,Switzerland,1,1,Friendly,Vila-real,Spain,0,8,1162,6,1179,2,-17,D,1,1,0
2018-06-03 00:00:00.000000,Croatia,Brazil,0,2,Friendly,Liverpool,England,1,18,975,2,1384,16,-409,L,2,0,0
2018-06-03 00:00:00.000000,Costa Rica,Northern Ireland,3,0,Friendly,San José,Costa Rica,0,25,858,27,837,-2,21,W,0,1,0
2018-06-03 00:00:00.000000,Barbados,Belize,0,0,Friendly,Bridgetown,Barbados,0,158,129,169,107,-11,22,D,1,1,0
2018-06-03 00:00:00.000000,South Africa,Madagascar,0,0,COSAFA Cup,Polokwane,South Africa,0,72,432,114,284,-42,148,D,1,1,0
2018-06-03 00:00:00.000000,Zimbabwe,Botswana,1,1,COSAFA Cup,Polokwane,South Africa,1,113,287,142,195,-29,92,D,1,0,0
2018-06-04 00:00:00.000000,Italy,Netherlands,1,1,Friendly,Turin,Italy,0,20,947,19,969,1,-22,D,1,1,0
2018-06-04 00:00:00.000000,Serbia,Chile,0,1,Friendly,Graz,Austria,1,35,732,9,1146,26,-414,L,2,0,0
2018-06-04 00:00:00.000000,Slovakia,Morocco,1,2,Friendly,Geneva,Switzerland,1,29,786,42,681,-13,105,L,2,0,0
2018-06-04 00:00:00.000000,Armenia,Moldova,0,0,Friendly,Kematen,Austria,1,98,347,173,98,-75,249,D,1,0,0
2018-06-04 00:00:00.000000,India,Kenya,3,0,Friendly,Mumbai,India,0,97,354,111,289,-14,65,W,0,1,0
2018-06-05 00:00:00.000000,Russia,Turkey,1,1,Friendly,Moscow,Russia,0,66,493,37,714,29,-221,D,1,1,0
2018-06-05 00:00:00.000000,Romania,Finland,2,0,Friendly,Ploiești,Romania,0,32,737,62,507,-30,230,W,0,1,0
2018-06-05 00:00:00.000000,Luxembourg,Georgia,1,0,Friendly,Luxembourg,Luxembourg,0,83,401,95,362,-12,39,W,0,1,0
2018-06-05 00:00:00.000000,Kazakhstan,Azerbaijan,3,0,Friendly,Astana,Kazakhstan,0,117,273,126,245,-9,28,W,0,1,0
2018-06-05 00:00:00.000000,Lithuania,Latvia,1,1,Friendly,Vilnius,Lithuania,0,133,229,139,217,-6,12,D,1,1,0
2018-06-05 00:00:00.000000,South Africa,Namibia,4,1,COSAFA Cup,Polokwane,South Africa,0,72,432,107,308,-35,124,W,0,1,0
2018-06-05 00:00:00.000000,Swaziland,Botswana,0,2,COSAFA Cup,Polokwane,South Africa,1,131,240,142,195,-11,45,L,2,0,0
2018-06-07 00:00:00.000000,England,Costa Rica,2,0,Friendly,Leeds,England,0,12,1051,23,884,-11,167,W,0,1,0
2018-06-07 00:00:00.000000,Uruguay,Uzbekistan,3,0,Friendly,Montevideo,Uruguay,0,14,1018,95,354,-81,664,W,0,1,0
2018-06-07 00:00:00.000000,Portugal,Algeria,3,0,Friendly,Lisbon,Portugal,0,4,1274,66,474,-62,800,W,0,1,0
2018-06-07 00:00:00.000000,Korea Republic,Bolivia,0,0,Friendly,Innsbruck,Austria,1,57,544,59,536,-2,8,D,1,0,0
2018-06-07 00:00:00.000000,Iceland,Ghana,2,2,Friendly,Reykjavík,Iceland,0,22,908,47,624,-25,284,D,1,1,0
2018-06-07 00:00:00.000000,India,New Zealand,1,2,Friendly,Mumbai,India,0,97,350,120,256,-23,94,L,2,1,0
2018-06-08 00:00:00.000000,Germany,Saudi Arabia,2,1,Friendly,Leverkusen,Germany,0,1,1558,67,465,-66,1093,W,0,1,0
2018-06-08 00:00:00.000000,Croatia,Senegal,2,1,Friendly,Osijek,Croatia,0,20,945,27,838,-7,107,W,0,1,0
2018-06-08 00:00:00.000000,Switzerland,Japan,2,0,Friendly,Lugano,Switzerland,0,6,1199,61,521,-55,678,W,0,1,0
2018-06-08 00:00:00.000000,Poland,Chile,2,2,Friendly,Poznań,Poland,0,8,1183,9,1135,-1,48,D,1,1,0
2018-06-09 00:00:00.000000,Serbia,Bolivia,5,1,Friendly,Graz,Austria,1,34,751,59,536,-25,215,W,0,0,0
2018-06-09 00:00:00.000000,Denmark,Mexico,2,0,Friendly,Brøndby,Denmark,0,12,1051,15,989,-3,62,W,0,1,0
2018-06-09 00:00:00.000000,Sweden,Peru,0,0,Friendly,Gothenburg,Sweden,0,24,880,11,1125,13,-245,D,1,1,0
2018-06-09 00:00:00.000000,Hungary,Australia,1,2,Friendly,Budapest,Hungary,0,51,612,36,718,15,-106,L,2,1,0
2018-06-09 00:00:00.000000,Estonia,Morocco,1,3,Friendly,Tallinn,Estonia,0,94,359,41,686,53,-327,L,2,1,0
2018-06-09 00:00:00.000000,Latvia,Azerbaijan,1,3,Friendly,Riga,Latvia,0,129,230,105,321,24,-91,L,2,1,0
2018-06-09 00:00:00.000000,Finland,Belarus,2,0,Friendly,Tampere,Finland,0,63,486,78,417,-15,69,W,0,1,0
2018-06-09 00:00:00.000000,Tunisia,Spain,0,1,Friendly,Krasnodar,Russia,1,21,910,10,1126,11,-216,L,2,0,0
2018-06-09 00:00:00.000000,France,USA,1,1,Friendly,Lyon,France,0,7,1198,25,873,-18,325,D,1,1,0
2018-06-10 00:00:00.000000,Austria,Brazil,0,3,Friendly,Vienna,Austria,0,26,845,2,1431,24,-586,L,2,1,0
2018-06-11 00:00:00.000000,Korea Republic,Senegal,0,2,Friendly,Grödig,Austria,1,57,544,27,838,30,-294,L,2,0,0
2018-06-11 00:00:00.000000,Belgium,Costa Rica,4,1,Friendly,Brussels,Belgium,0,3,1298,23,884,-20,414,W,0,1,0
2018-06-12 00:00:00.000000,Japan,Paraguay,4,2,Friendly,Innsbruck,Austria,1,61,521,32,773,29,-252,W,0,0,0
2018-06-12 00:00:00.000000,Poland,Lithuania,4,0,Friendly,Warsaw,Poland,0,8,1183,126,239,-118,944,W,0,1,0
2018-06-14 00:00:00.000000,Russia,Saudi Arabia,5,0,FIFA World Cup,Moscow,Russia,0,70,457,67,465,3,-8,W,0,1,0
2018-06-15 00:00:00.000000,Egypt,Uruguay,0,1,FIFA World Cup,Ekaterinburg,Russia,1,45,649,14,1018,31,-369,L,2,0,0
2018-06-15 00:00:00.000000,Morocco,IR Iran,0,1,FIFA World Cup,St. Petersburg,Russia,1,41,686,37,708,4,-22,L,2,0,0
2018-06-15 00:00:00.000000,Portugal,Spain,3,3,FIFA World Cup,Sochi,Russia,1,4,1274,10,1126,-6,148,D,1,0,0
2018-06-16 00:00:00.000000,France,Australia,2,1,FIFA World Cup,Kazan,Russia,1,7,1198,36,718,-29,480,W,0,0,0
2018-06-16 00:00:00.000000,Argentina,Iceland,1,1,FIFA World Cup,Moscow,Russia,1,5,1241,22,908,-17,333,D,1,0,0
2018-06-16 00:00:00.000000,Peru,Denmark,0,1,FIFA World Cup,Saransk,Russia,1,11,1125,12,1051,-1,74,L,2,0,0
2018-06-16 00:00:00.000000,Croatia,Nigeria,2,0,FIFA World Cup,Kaliningrad,Russia,1,20,945,48,618,-28,327,W,0,0,0
2018-06-17 00:00:00.000000,Costa Rica,Serbia,0,1,FIFA World Cup,Samara,Russia,1,23,884,34,751,-11,133,L,2,0,0
2018-06-17 00:00:00.000000,Germany,Mexico,0,1,FIFA World Cup,Moscow,Russia,1,1,1558,15,989,-14,569,L,2,0,0
2018-06-17 00:00:00.000000,Brazil,Switzerland,1,1,FIFA World Cup,Rostov-On-Don,Russia,1,2,1431,6,1199,-4,232,D,1,0,0
2018-06-18 00:00:00.000000,Sweden,Korea Republic,1,0,FIFA World Cup,Nizhny Novgorod,Russia,1,24,880,57,544,-33,336,W,0,0,0
2018-06-18 00:00:00.000000,Belgium,Panama,3,0,FIFA World Cup,Sochi,Russia,1,3,1298,55,571,-52,727,W,0,0,0
2018-06-18 00:00:00.000000,Tunisia,England,1,2,FIFA World Cup,Volgograd,Russia,1,21,910,12,1051,9,-141,L,2,0,0
2018-06-19 00:00:00.000000,Colombia,Japan,1,2,FIFA World Cup,Saransk,Russia,1,16,986,61,521,-45,465,L,2,0,0
2018-06-19 00:00:00.000000,Poland,Senegal,1,2,FIFA World Cup,Moscow,Russia,1,8,1183,27,838,-19,345,L,2,0,0
2018-06-19 00:00:00.000000,Russia,Egypt,3,1,FIFA World Cup,St. Petersburg,Russia,0,70,457,45,649,25,-192,W,0,1,0
2018-06-20 00:00:00.000000,Portugal,Morocco,1,0,FIFA World Cup,Moscow,Russia,1,4,1274,41,686,-37,588,W,0,0,0
2018-06-20 00:00:00.000000,Uruguay,Saudi Arabia,1,0,FIFA World Cup,Rostov-On-Don,Russia,1,14,1018,67,465,-53,553,W,0,0,0
2018-06-20 00:00:00.000000,IR Iran,Spain,0,1,FIFA World Cup,Kazan,Russia,1,37,708,10,1126,27,-418,L,2,0,0
2018-06-21 00:00:00.000000,Denmark,Australia,1,1,FIFA World Cup,Samara,Russia,1,12,1051,36,718,-24,333,D,1,0,0
2018-06-21 00:00:00.000000,France,Peru,1,0,FIFA World Cup,Ekaterinburg,Russia,1,7,1198,11,1125,-4,73,W,0,0,0
2018-06-21 00:00:00.000000,Argentina,Croatia,0,3,FIFA World Cup,Nizhny Novgorod,Russia,1,5,1241,20,945,-15,296,L,2,0,0
2018-06-22 00:00:00.000000,Brazil,Costa Rica,2,0,FIFA World Cup,St. Petersburg,Russia,1,2,1431,23,884,-21,547,W,0,0,0
2018-06-22 00:00:00.000000,Nigeria,Iceland,2,0,FIFA World Cup,Volgograd,Russia,1,48,618,22,908,26,-290,W,0,0,0
2018-06-22 00:00:00.000000,Serbia,Switzerland,1,2,FIFA World Cup,Kaliningrad,Russia,1,34,751,6,1199,28,-448,L,2,0,0
2018-06-23 00:00:00.000000,Belgium,Tunisia,5,2,FIFA World Cup,Moscow,Russia,1,3,1298,21,910,-18,388,W,0,0,0
2018-06-23 00:00:00.000000,Korea Republic,Mexico,1,2,FIFA World Cup,Rostov-On-Don,Russia,1,57,544,15,989,42,-445,L,2,0,0
2018-06-23 00:00:00.000000,Germany,Sweden,2,1,FIFA World Cup,Sochi,Russia,1,1,1558,24,880,-23,678,W,0,0,0
2018-06-24 00:00:00.000000,England,Panama,6,1,FIFA World Cup,Nizhny Novgorod,Russia,1,12,1051,55,571,-43,480,W,0,0,0
2018-06-24 00:00:00.000000,Japan,Senegal,2,2,FIFA World Cup,Ekaterinburg,Russia,1,61,521,27,838,34,-317,D,1,0,0
2018-06-24 00:00:00.000000,Poland,Colombia,0,3,FIFA World Cup,Kazan,Russia,1,8,1183,16,986,-8,197,L,2,0,0
2018-06-25 00:00:00.000000,Uruguay,Russia,3,0,FIFA World Cup,Samara,Russia,1,14,1018,70,457,-56,561,W,0,0,1
2018-06-25 00:00:00.000000,Saudi Arabia,Egypt,2,1,FIFA World Cup,Volgograd,Russia,1,67,465,45,649,22,-184,W,0,0,0
2018-06-25 00:00:00.000000,Spain,Morocco,2,2,FIFA World Cup,Kaliningrad,Russia,1,10,1126,41,686,-31,440,D,1,0,0
2018-06-25 00:00:00.000000,IR Iran,Portugal,1,1,FIFA World Cup,Saransk,Russia,1,37,708,4,1274,33,-566,D,1,0,0
2018-06-26 00:00:00.000000,Australia,Peru,0,2,FIFA World Cup,Sochi,Russia,1,36,718,11,1125,25,-407,L,2,0,0
2018-06-26 00:00:00.000000,Denmark,France,0,0,FIFA World Cup,Moscow,Russia,1,12,1051,7,1198,5,-147,D,1,0,0
2018-06-26 00:00:00.000000,Nigeria,Argentina,1,2,FIFA World Cup,St. Petersburg,Russia,1,48,618,5,1241,43,-623,L,2,0,0
2018-06-26 00:00:00.000000,Iceland,Croatia,1,2,FIFA World Cup,Rostov-On-Don,Russia,1,22,908,20,945,2,-37,L,2,0,0
2018-06-27 00:00:00.000000,Korea Republic,Germany,2,0,FIFA World Cup,Kazan,Russia,1,57,544,1,1558,56,-1014,W,0,0,0
2018-06-27 00:00:00.000000,Mexico,Sweden,0,3,FIFA World Cup,Ekaterinburg,Russia,1,15,989,24,880,-9,109,L,2,0,0
2018-06-27 00:00:00.000000,Serbia,Brazil,0,2,FIFA World Cup,Moscow,Russia,1,34,751,2,1431,32,-680,L,2,0,0
2018-06-27 00:00:00.000000,Switzerland,Costa Rica,2,2,FIFA World Cup,Nizhny Novgorod,Russia,1,6,1199,23,884,-17,315,D,1,0,0
2018-06-28 00:00:00.000000,Japan,Poland,0,1,FIFA World Cup,Volgograd,Russia,1,61,521,8,1183,53,-662,L,2,0,0
2018-06-28 00:00:00.000000,Senegal,Colombia,0,1,FIFA World Cup,Samara,Russia,1,27,838,16,986,11,-148,L,2,0,0
2018-06-28 00:00:00.000000,Panama,Tunisia,1,2,FIFA World Cup,Saransk,Russia,1,55,571,21,910,34,-339,L,2,0,0
2018-06-28 00:00:00.000000,England,Belgium,0,1,FIFA World Cup,Kaliningrad,Russia,1,12,1051,3,1298,9,-247,L,2,0,0
2018-06-30 00:00:00.000000,France,Argentina,4,3,FIFA World Cup,Kazan,Russia,1,7,1198,5,1241,2,-43,W,0,0,0
2018-06-30 00:00:00.000000,Uruguay,Portugal,2,1,FIFA World Cup,Sochi,Russia,1,14,1018,4,1274,10,-256,W,0,0,0
2018-07-01 00:00:00.000000,Spain,Russia,1,1,FIFA World Cup,Moscow,Russia,1,10,1126,70,457,-60,669,D,1,0,1
2018-07-01 00:00:00.000000,Croatia,Denmark,1,1,FIFA World Cup,Nizhny Novgorod,Russia,1,20,945,12,1051,8,-106,D,1,0,0
2018-07-02 00:00:00.000000,Brazil,Mexico,2,0,FIFA World Cup,Samara,Russia,1,2,1431,15,989,-13,442,W,0,0,0
2018-07-02 00:00:00.000000,Belgium,Japan,3,2,FIFA World Cup,Rostov-On-Don,Russia,1,3,1298,61,521,-58,777,W,0,0,0
2018-07-03 00:00:00.000000,Sweden,Switzerland,1,0,FIFA World Cup,St. Petersburg,Russia,1,24,880,6,1199,18,-319,W,0,0,0
2018-07-03 00:00:00.000000,Colombia,England,1,1,FIFA World Cup,Moscow,Russia,1,16,986,12,1051,4,-65,D,1,0,0
2018-07-06 00:00:00.000000,Uruguay,France,0,2,FIFA World Cup,Nizhny Novgorod,Russia,1,14,1018,7,1198,7,-180,L,2,0,0
2018-07-06 00:00:00.000000,Brazil,Belgium,1,2,FIFA World Cup,Kazan,Russia,1,2,1431,3,1298,-1,133,L,2,0,0
2018-07-07 00:00:00.000000,Sweden,England,0,2,FIFA World Cup,Samara,Russia,1,24,880,12,1051,12,-171,L,2,0,0
2018-07-07 00:00:00.000000,Russia,Croatia,2,2,FIFA World Cup,Sochi,Russia,0,70,457,20,945,50,-488,D,1,1,0
2018-07-10 00:00:00.000000,France,Belgium,1,0,FIFA World Cup,St. Petersburg,Russia,1,7,1198,3,1298,4,-100,W,0,0,0
2018-07-11 00:00:00.000000,Croatia,England,2,1,FIFA World Cup,Moscow,Russia,1,20,945,12,1051,8,-106,W,0,0,0
2018-07-14 00:00:00.000000,Belgium,England,2,0,FIFA World Cup,St. Petersburg,Russia,1,3,1298,12,1051,-9,247,W,0,0,0
2018-07-15 00:00:00.000000,France,Croatia,4,2,FIFA World Cup,Moscow,Russia,1,7,1198,20,945,-13,253,W,0,0,0
